player,season,team,TOI,G,A1,A2,A,P,P1,FOW,FOT,FOL,SOG,iCF,HITS,BLK,PEND,PENT,CF,CA,CF_5v5,CA_5v5,GF_5v5,GA_5v5,FO.,GS
AARON.DOWNEY,20072008,DET,255.79999999999998,0,2,0,2,2,2,0,0,0,15,22,78,3,18,34,195,188,193,183,6,6,0,30108035.58
AARON.JOHNSON,20072008,NYI,415.85,0,0,2,2,2,0,0,0,0,16,45,40,23,4,15,370,350,287,304,15,11,0,30108040.79
AARON.MILLER,20072008,VAN,987.6166666666666,1,1,5,6,7,2,0,0,0,27,68,36,23,4,11,634,951,565,678,29,33,0,30108082.314999998
AARON.ROME,20072008,CBJ,309.0333333333333,1,0,1,1,2,1,0,0,0,15,33,33,9,5,8,223,240,186,194,6,9,0,30108032.325
AARON.VOROS,20072008,MIN,550.9333333333334,8,6,1,7,15,14,4,17,13,60,104,NA,22,27,44,476,470,326,430,17,22,0.23529411764705882,30108073.805
AARON.WARD,20072008,BOS,1473.1166666666668,5,3,6,9,14,8,0,0,0,75,168,153,52,12,NA,1220,1304,349,317,16,17,0,NA
ADAM.BERTI,20072008,CHI,20.233333333333334,0,0,0,0,0,0,0,0,0,1,2,1,0,0,0,12,13,12,13,0,0,0,30108013.4
ADAM.BURISH,20072008,CHI,938.3833333333333,4,3,1,4,8,7,111,262,151,66,88,86,11,46,51,480,918,406,527,15,27,0.42366412213740456,30108089.225
ADAM.FOOTE,20072008,CBJ,1514.0666666666666,1,3,9,12,13,4,0,0,0,56,114,78,29,24,33,1041,1406,848,837,34,38,0,30108096.715
ADAM.FOOTE,20072008,COL,452.58333333333337,0,0,1,1,1,0,0,0,0,14,36,26,16,4,9,234,478,204,299,6,12,0,30108045.515
ADAM.HALL,20072008,PIT,732.7833333333333,5,1,4,5,10,6,201,401,200,53,81,62,9,13,13,327,844,269,494,9,12,0.5012468827930174,30108087.020000003
ADAM.MAIR,20072008,BUF,630.3166666666666,5,6,6,12,17,11,161,354,193,61,99,108,20,19,24,426,536,371,479,21,21,0.4548022598870056,30108081.28
ADAM.PINEAULT,20072008,CBJ,33.13333333333333,0,0,0,0,0,0,0,1,1,5,8,1,2,0,0,26,27,26,27,0,2,0,30108014.75
ADRIAN.AUCOIN,20072008,CGY,1718.2666666666667,10,12,16,28,38,22,0,0,0,127,315,74,108,15,19,1657,1195,999,872,52,27,0,30108093
ALAIN.NASREDDINE,20072008,PIT,77.30000000000001,0,0,0,0,0,0,0,0,0,3,6,5,2,1,2,46,77,42,64,2,6,0,30108019.36
ALES.HEMSKY,20072008,EDM,1374.4833333333333,20,36,15,51,71,56,1,5,4,183,338,24,92,36,19,1360,1081,877,915,42,40,0.2,30108132.775
ALES.KOTALIK,20072008,BUF,1188.0166666666667,22,7,12,19,41,29,96,218,122,203,327,134,65,11,26,1181,811,695,652,23,24,0.44036697247706424,30108101.3
ALEX.BURROWS,20072008,VAN,1238.0833333333333,12,13,6,19,31,25,13,37,24,126,216,80,39,60,49,859,1218,753,769,30,28,0.35135135135135137,30108110.67
ALEX.EDLER,20072008,VAN,1599.1166666666668,8,6,7,13,21,14,1,1,0,124,253,58,73,9,21,1429,1240,917,867,43,41,1,30108097.655
ALEX.FOSTER,20072008,TOR,10.600000000000001,0,0,0,0,0,0,0,1,1,1,2,1,1,0,0,11,7,11,7,0,0,0,15054006.45
ALEX.FROLOV,20072008,L.A,1334.6833333333334,23,26,18,44,67,49,2,11,9,160,285,22,61,10,11,1437,1109,936,982,50,45,0.18181818181818182,30108137.78
ALEX.GOLIGOSKI,20072008,PIT,41.81666666666666,0,1,1,2,2,1,0,0,0,2,3,1,1,0,1,49,37,24,28,2,0,0,30108015.425
ALEX.KOVALEV,20072008,MTL,1861.1833333333334,40,29,25,54,94,69,32,58,26,267,468,96,127,51,38,1954,1597,1021,1086,49,42,0.5517241379310345,30108163.814999998
ALEX.NIKULIN,20072008,OTT,9.85,0,0,0,0,0,0,1,1,0,0,0,0,0,0,0,4,7,3,7,0,2,1,15054006.89
ALEX.OVECHKIN,20072008,WSH,2062.7166666666667,69,39,13,52,121,108,7,19,12,482,984,251,282,56,21,2587,1392,1570,1146,79,52,0.3684210526315789,30108150.314999998
ALEX.PICARD,20072008,CBJ,20.299999999999997,0,0,0,0,0,0,0,0,0,1,2,10,1,2,1,20,10,13,10,0,0,0,30108012.92
ALEX.PICARD,20072008,PHI,52.11666666666666,0,0,0,0,0,0,0,0,0,3,6,2,1,0,1,48,49,30,37,2,4,0,30108015.9
ALEX.PICARD,20072008,T.B,437.91666666666663,3,0,3,3,6,3,0,0,0,21,43,33,13,7,4,319,392,236,268,8,17,0,30108041.295
ALEX.RADULOV,20072008,NSH,1423.65,28,23,11,34,62,51,0,1,1,197,300,22,50,22,28,1460,1063,988,935,62,48,0,30108133.445
ALEX.SEMIN,20072008,WSH,1203.6666666666665,29,14,7,21,50,43,4,11,7,213,429,24,109,29,30,1441,793,847,672,33,35,0.36363636363636365,30108093.425
ALEX.STEEN,20072008,TOR,1373.9166666666665,15,16,10,26,41,31,59,179,120,168,319,62,71,23,15,1219,1279,850,801,43,38,0.329608938547486,30108108.89
ALEX.TANGUAY,20072008,CGY,1591,18,34,10,44,62,52,7,20,13,126,223,NA,44,17,26,1512,1234,1048,902,57,42,0.35,30108122.75
ALEXEI.PONIKAROVSKY,20072008,TOR,1049.1833333333334,18,9,8,17,35,27,1,4,3,149,281,77,60,18,18,1170,836,814,618,38,26,0.25,30108077.92
ALEXEI.SEMENOV,20072008,S.J,357.8666666666667,1,1,1,2,3,2,0,0,0,26,52,25,13,5,12,297,268,237,221,6,13,0,30108034.924999997
ALEXEI.ZHITNIK,20072008,ATL,1236.2833333333333,3,1,4,5,8,4,0,0,0,79,173,67,49,6,29,960,1215,781,931,35,45,0,30108111.31
ALLAN.ROURKE,20072008,EDM,142.1,0,0,0,0,0,0,0,0,0,4,12,3,5,2,1,88,149,85,138,5,5,0,30108027.32
ANDERS.ERIKSSON,20072008,CGY,1322.6833333333334,1,5,13,18,19,6,0,0,0,50,128,66,42,9,19,1208,1068,933,791,42,50,0,30108081.265
ANDRE.ROY,20072008,T.B,343.85,4,3,0,3,7,7,0,0,0,38,70,90,20,16,22,264,270,249,259,11,11,0,30108043.560000002
ANDREAS.KARLSSON,20072008,T.B,560.15,2,1,1,2,4,3,182,333,151,31,61,34,14,2,5,352,500,292,305,10,14,0.5465465465465466,30108049.625
ANDREAS.LILJA,20072008,DET,1609.4499999999998,2,7,4,11,13,9,0,1,1,79,148,162,37,14,50,1271,1220,1144,827,44,47,0,30108083.89
ANDREI.KASTSITSYN,20072008,MTL,1124.2,23,16,8,24,47,39,4,6,2,143,254,92,50,23,9,1156,921,707,746,36,30,0.6666666666666666,30108109.94
ANDREI.KOSTITSYN,20072008,MTL,287.0333333333333,8,1,3,4,12,9,0,1,1,37,77,31,19,7,4,340,206,212,170,11,8,0,30108031.345
ANDREI.MARKOV,20072008,MTL,2341.383333333333,17,24,20,44,61,41,0,0,0,165,395,NA,138,28,28,2377,2242,1215,1383,52,55,0,30108169.53
ANDREI.ZYUZIN,20072008,CHI,479,2,1,2,3,5,3,0,0,0,34,68,28,22,4,19,361,413,255,299,11,19,0,30108045.840000004
ANDREJ.MESZAROS,20072008,OTT,1782.7666666666667,9,14,12,26,35,23,0,1,1,161,366,103,123,16,27,1757,1500,1108,1036,59,50,0,30108111.91
ANDREJ.SEKERA,20072008,BUF,713.6500000000001,1,3,2,5,6,4,0,0,0,27,71,19,28,3,7,555,583,413,409,26,23,0,30108049.53
ANDREW.ALBERTS,20072008,BOS,743.9333333333334,0,1,1,2,2,1,1,2,1,27,66,54,24,6,16,520,690,177,144,5,7,0.5,30108024.875
ANDREW.BRUNETTE,20072008,COL,1444.8166666666666,24,26,17,43,67,50,3,8,5,143,221,17,41,25,9,1313,1122,876,1023,58,48,0.375,30108148.145
ANDREW.COGLIANO,20072008,EDM,1120.2833333333333,18,14,13,27,45,32,214,542,328,98,156,25,26,23,12,890,1059,628,834,41,40,0.3948339483394834,30108138.115000002
ANDREW.EBBETT,20072008,ANA,39.916666666666664,0,0,0,0,0,0,17,29,12,3,6,0,1,1,1,20,21,9,17,2,0,0.5862068965517241,15054008.39
ANDREW.FERENCE,20072008,BOS,1463.95,1,9,7,16,17,10,1,1,0,81,202,NA,81,19,24,1211,1346,380,400,6,18,1,30108053.955
ANDREW.GREENE,20072008,N.J,1082.5,2,6,1,7,9,8,0,0,0,50,116,28,43,6,11,908,878,625,618,21,21,0,30108072.835
ANDREW.LADD,20072008,CAR,505.0166666666667,9,4,5,9,18,13,3,5,2,76,125,96,23,7,10,539,428,396,384,22,14,0.6,30108057.365000002
ANDREW.LADD,20072008,CHI,299.4166666666667,5,4,3,7,12,9,1,3,2,53,67,42,5,4,2,266,201,204,193,12,10,0.3333333333333333,30108037.205
ANDREW.MURRAY,20072008,CBJ,456.51666666666665,6,0,3,3,9,6,15,32,17,45,69,46,8,7,6,317,338,286,283,16,16,0.46875,30108044.895
ANDREW.PETERS,20072008,BUF,138.38333333333333,1,0,1,1,2,1,0,1,1,17,27,22,7,15,18,95,129,75,104,2,5,0,30108027.025
ANDREW.WOZNIEWSKI,20072008,TOR,679.5833333333333,2,2,5,7,9,4,0,0,0,34,70,42,18,3,26,539,712,462,479,29,21,0,30108062.205
ANDY.GREENE,20072008,N.J,97.53333333333333,0,0,0,0,0,0,0,0,0,2,11,6,4,0,0,85,55,63,41,0,1,0,30108014.5
ANDY.HILBERT,20072008,NYI,926.6,7,5,3,8,15,12,99,220,121,124,198,39,34,16,9,708,940,586,569,21,24,0.45,30108080.445
ANDY.MCDONALD,20072008,ANA,550.6333333333334,4,7,5,12,16,11,217,390,173,78,125,10,22,12,11,522,333,313,266,14,14,0.5564102564102564,30108050.025
ANDY.MCDONALD,20072008,STL,913.6333333333334,14,10,12,22,36,24,310,555,245,102,161,36,23,16,12,809,633,522,495,27,26,0.5585585585585585,30108085.06
ANDY.SUTTON,20072008,NYI,1031.3333333333333,1,2,4,6,7,3,0,0,0,56,120,84,35,17,37,842,1025,652,634,23,31,0,30108076.42
ANTHONY.STEWART,20072008,FLA,159.64999999999998,0,1,0,1,1,1,0,0,0,21,29,14,4,0,0,128,144,122,144,4,6,0,30108027.9
ANTOINE.VERMETTE,20072008,OTT,1487.0833333333335,24,17,12,29,53,41,726,1284,558,183,298,50,47,29,24,1224,1393,780,797,41,41,0.5654205607476636,30108140.08
ANTON.STRALMAN,20072008,TOR,640.5833333333334,3,3,2,5,8,6,0,0,0,40,83,32,27,4,9,575,476,408,395,16,22,0,30108051.689999998
ANTON.VOLCHENKOV,20072008,OTT,1422.8000000000002,1,4,9,13,14,5,0,0,0,66,163,163,60,17,23,997,1568,763,903,36,28,0,30108105.395
ANTTI.MIETTINEN,20072008,DAL,1126.1166666666668,16,10,10,20,36,26,14,23,9,147,272,93,61,15,NA,1017,804,726,739,37,29,0.6086956521739131,NA
ANTTI.PIHLSTROM,20072008,NSH,9.133333333333333,0,0,0,0,0,0,0,0,0,1,2,1,0,0,0,10,3,10,3,0,1,0,15054006
ANZE.KOPITAR,20072008,L.A,1696.8000000000002,32,23,22,45,77,55,561,1143,582,200,343,47,62,41,11,1740,1453,1033,1169,45,60,0.49081364829396323,30108191.9
ARRON.ASHAM,20072008,N.J,684.1833333333334,6,4,1,5,11,10,0,3,3,71,105,94,20,24,26,546,456,424,416,9,16,0,30108063.165
B.J..CROMBEEN,20072008,DAL,74.4,0,1,1,2,2,1,1,2,1,12,13,11,1,6,8,52,54,51,54,4,4,0.5,30108019.325000003
BARRET.JACKMAN,20072008,STL,1747.2333333333331,2,6,8,14,16,8,0,0,0,80,164,NA,52,36,39,1263,1565,955,1035,46,54,0,30108120.310000002
BARRY.TALLACKSON,20072008,N.J,21.15,0,0,0,0,0,0,0,0,0,0,1,2,1,0,0,12,18,12,18,0,0,0,30108013.95
BATES (JON).BATTAGLIA,20072008,TOR,61.900000000000006,0,0,0,0,0,0,0,1,1,6,8,1,1,2,2,39,49,35,45,0,6,0,30108017.52
BEN.EAGER,20072008,CHI,59.583333333333336,0,2,0,2,2,2,0,0,0,5,9,7,0,5,4,32,42,30,41,3,4,0,30108018.2
BEN.EAGER,20072008,PHI,126.13333333333334,0,0,0,0,0,0,1,5,4,11,19,25,5,13,18,71,118,65,103,0,6,0.2,30108027.02
BEN.GUITE,20072008,COL,1153.5666666666666,12,8,3,11,23,20,435,903,468,112,183,133,32,18,25,658,1229,597,771,23,29,0.48172757475083056,30108131.155
BEN.WALTER,20072008,NYI,48.666666666666664,1,0,0,0,1,1,10,33,23,6,10,2,2,0,0,36,42,35,30,0,1,0.30303030303030304,30108016.5
BENJAMIN.ONDRUS,20072008,TOR,15.366666666666667,0,0,0,0,0,0,1,3,2,4,5,2,1,1,1,10,16,10,13,0,1,0.3333333333333333,30108013.75
BENOIT.POULIOT,20072008,MIN,107.30000000000001,2,1,0,1,3,3,26,65,39,12,19,7,1,4,0,92,92,76,89,3,4,0.4,30108025.23
BILL.GUERIN,20072008,NYI,1390.7666666666667,22,13,7,20,42,35,12,18,6,225,392,61,88,22,29,1373,1128,829,936,36,34,0.6666666666666666,30108131.424999997
BLAIR.BETTS,20072008,NYR,947.6,2,4,1,5,7,6,412,813,401,92,143,103,26,12,NA,558,870,462,465,11,15,0.5067650676506765,NA
BLAIR.JONES,20072008,T.B,7.666666666666667,0,0,0,0,0,0,1,8,7,1,3,1,1,0,0,15,4,15,4,0,0,0.125,30108012.09
BLAKE.COMEAU,20072008,NYI,584.3166666666666,8,6,1,7,15,14,8,27,19,66,117,58,30,15,11,525,497,462,455,20,16,0.2962962962962963,30108064.595
BOBBY.ALLEN,20072008,BOS,187.93333333333334,0,0,0,0,0,0,0,0,0,10,18,15,5,2,1,145,132,46,38,0,1,0,30108015.32
BOBBY.HOLIK,20072008,ATL,73.71666666666667,3,1,0,1,4,4,46,77,31,11,15,4,4,1,3,67,68,39,56,3,2,0.5974025974025974,30108022.15
BOBBY.RYAN,20072008,ANA,281.3333333333333,5,3,2,5,10,8,2,2,0,39,59,20,8,6,4,263,158,174,139,6,7,1,30108029.939999998
BORIS.VALABIK,20072008,ATL,116.85,0,0,0,0,0,0,0,0,0,5,13,10,4,5,10,74,126,70,97,3,6,0,30108023.8
BOYD.DEVEREAUX,20072008,TOR,866.4166666666667,7,7,4,11,18,14,2,6,4,81,142,NA,30,9,12,655,805,550,560,25,31,0.3333333333333333,30108075.42
BOYD.GORDON,20072008,WSH,1147.8,7,4,5,9,16,11,540,979,439,105,174,23,30,12,6,790,1143,683,570,20,20,0.5515832482124617,30108086.145
BRAD.BOYES,20072008,STL,1470.35,43,12,10,22,65,55,105,236,131,207,378,55,71,20,10,1387,1077,871,896,54,42,0.4449152542372881,30108139.1
BRAD.ISBISTER,20072008,VAN,595.2666666666667,6,3,2,5,11,9,8,17,9,71,107,26,17,18,13,447,492,402,448,12,17,0.47058823529411764,30108066.799999997
BRAD.LARSEN,20072008,ATL,559.6166666666667,1,2,1,3,4,3,34,81,47,35,47,44,4,7,5,354,550,328,450,9,24,0.41975308641975306,30108067.604999997
BRAD.LUKOWICH,20072008,T.B,979.7333333333333,1,2,4,6,7,3,0,0,0,28,70,152,29,10,10,718,926,623,657,21,33,0,30108077
BRAD.MAY,20072008,ANA,445.48333333333335,3,0,1,1,4,3,0,3,3,40,67,51,13,13,18,289,313,270,296,9,9,0,30108046.755
BRAD.RICHARDS,20072008,DAL,610.6500000000001,5,13,8,21,26,18,196,402,206,75,157,9,54,5,3,566,415,367,316,16,14,0.48756218905472637,30108054.39
BRAD.RICHARDS,20072008,T.B,1505.4833333333333,18,19,14,33,51,37,454,944,490,228,434,13,117,16,NA,1529,1157,839,754,29,43,0.4809322033898305,NA
BRAD.RICHARDSON,20072008,COL,296.54999999999995,2,2,1,3,5,4,26,60,34,32,52,13,10,9,4,188,273,175,199,7,12,0.43333333333333335,30108036.854999997
BRAD.STUART,20072008,DET,641.5666666666666,2,2,5,7,9,4,0,0,0,46,86,89,22,4,8,554,523,467,390,29,10,0,30108045.915
BRAD.STUART,20072008,L.A,1335.9333333333334,5,9,7,16,21,14,0,4,4,110,230,88,78,12,24,1168,1324,785,903,32,47,0,30108110.095
BRAD.WINCHESTER,20072008,DAL,416.0333333333333,1,0,2,2,3,1,0,2,2,40,67,67,17,18,18,291,279,236,255,6,18,0,30108040.83
BRADY.MURRAY,20072008,L.A,45.21666666666667,1,0,0,0,1,1,16,31,15,2,3,6,0,0,1,25,39,24,34,1,2,0.5161290322580645,30108017.29
BRANDON.BOCHENSKI,20072008,ANA,149.65,2,1,1,2,4,3,0,1,1,17,30,3,7,1,3,162,96,95,84,2,1,0,30108021.884999998
BRANDON.BOCHENSKI,20072008,BOS,255.95,0,4,2,6,6,4,2,6,4,30,53,8,11,4,3,265,208,72,51,4,2,0.3333333333333333,30108018.32
BRANDON.BOCHENSKI,20072008,NSH,91.86666666666667,1,0,2,2,3,1,0,0,0,13,21,3,4,2,0,82,65,78,65,4,3,0,30108018.17
BRANDON.DUBINSKY,20072008,NYR,1378.25,18,14,16,30,48,32,603,1181,578,183,281,222,38,40,31,1410,863,984,738,47,39,0.5105842506350551,30108119.32
BRANDON.NOLAN,20072008,CAR,43.53333333333333,0,0,1,1,1,0,0,0,0,2,5,8,1,0,0,30,46,30,45,1,3,0,30108017.125
BRANISLAV.MEZEI,20072008,FLA,824.2333333333333,2,0,2,2,4,2,0,0,0,38,88,115,35,12,NA,645,889,578,680,16,28,0,NA
BRANKO.RADIVOJEVIC,20072008,MIN,1085.6666666666665,7,6,4,10,17,13,15,39,24,91,176,93,40,18,17,815,907,715,689,22,34,0.38461538461538464,30108087.13
BRAYDON.COBURN,20072008,PHI,1970.0833333333333,9,9,20,29,38,18,0,0,0,137,282,103,79,24,38,1781,1727,1203,1208,62,45,0,30108137.439999998
BRENDAN.BELL,20072008,ARI,29.633333333333333,0,0,0,0,0,0,0,0,0,0,2,0,1,0,0,16,25,14,23,0,2,0,30108014.6
BRENDAN.MORRISON,20072008,VAN,599.8166666666666,9,7,9,16,25,16,167,369,202,54,99,17,23,6,9,523,498,283,381,15,15,0.45257452574525747,30108072.665
BRENDAN.SHANAHAN,20072008,NYR,1521.9333333333334,24,11,16,27,51,35,7,10,3,295,459,50,84,16,19,1537,1259,819,775,35,31,0.7,30108111.34
BRENDAN.WITT,20072008,NYI,1258,2,3,2,5,7,5,0,0,0,57,116,135,39,12,24,972,1391,800,850,25,36,0,30108099.67
BRENDEN.MORROW,20072008,DAL,2058.45,41,28,20,48,89,69,17,50,33,249,437,349,81,68,NA,1918,1364,1160,1016,71,38,0.34,NA
BRENT.BURNS,20072008,MIN,2011.5666666666666,14,14,14,28,42,28,1,2,1,174,375,121,120,15,33,1807,1646,1170,1133,54,45,0.5,30108129.740000002
BRENT.SEABROOK,20072008,CHI,1740.75,9,8,15,23,32,17,0,1,1,151,247,162,61,16,34,1314,1399,919,927,49,42,0,30108113.285
BRENT.SOPEL,20072008,CHI,1156.5166666666667,1,6,9,15,16,7,0,0,0,53,106,35,33,7,10,749,1077,590,630,29,30,0,30108076.595
BRET.HEDICAN,20072008,CAR,1272.4833333333333,2,5,10,15,17,7,0,0,0,79,152,65,50,14,NA,1229,1310,1044,967,58,45,0,NA
BRETT.CLARK,20072008,COL,1319.95,5,6,8,14,19,11,0,0,0,87,165,70,53,10,15,1030,1186,692,805,40,34,0,30108098.299999997
BRETT.LEBDA,20072008,DET,1523.7,3,8,5,13,16,11,0,1,1,122,254,63,72,17,27,1508,934,1236,833,37,39,0,30108076.045
BRETT.MCLEAN,20072008,FLA,1087.6333333333332,14,13,9,22,36,27,295,623,328,140,215,22,41,11,NA,985,1049,679,690,25,31,0.47351524879614765,NA
BRETT.STERLING,20072008,ATL,161.11666666666667,1,0,2,2,3,1,2,3,1,14,31,6,8,2,NA,127,136,105,127,5,5,0.6666666666666666,NA
BRIAN.BOYLE,20072008,L.A,109,4,1,0,1,5,5,37,80,43,19,22,10,2,2,2,77,104,54,96,8,4,0.4625,30108028.6
BRIAN.CAMPBELL,20072008,BUF,1556.4666666666667,5,17,18,35,40,22,0,0,0,100,222,55,64,9,6,1452,1263,847,825,49,46,0,30108096.64
BRIAN.CAMPBELL,20072008,S.J,883.4333333333334,4,11,11,22,26,15,0,0,0,62,128,17,38,8,6,865,584,547,445,26,13,0,30108055.555
BRIAN.GIONTA,20072008,N.J,1586.3,23,22,9,31,54,45,30,56,26,271,459,58,74,24,NA,1678,1072,978,828,31,29,0.5357142857142857,NA
BRIAN.LEE,20072008,OTT,158.96666666666667,0,0,1,1,1,0,0,0,0,9,21,7,7,2,3,143,147,94,103,3,3,0,30108022.244999997
BRIAN.MCGRATTAN,20072008,OTT,109.1,0,1,2,3,3,1,0,0,0,11,15,18,0,11,11,77,100,66,97,3,3,0,30108025.810000002
BRIAN.POTHIER,20072008,WSH,710.4833333333333,5,7,1,8,13,12,0,0,0,65,123,25,42,8,NA,668,530,532,408,22,19,0,NA
BRIAN.RAFALSKI,20072008,DET,2303.833333333333,17,14,31,45,62,31,0,0,0,232,467,52,163,13,22,2676,1457,1644,1063,63,38,0,30108092.305
BRIAN.ROLSTON,20072008,MIN,1720.9,31,16,15,31,62,47,70,174,104,308,551,64,123,17,27,1719,1326,1035,944,34,37,0.40229885057471265,30108134.045
BRIAN.SUTHERBY,20072008,ANA,422.2,0,1,0,1,1,1,119,262,143,49,75,60,14,14,15,256,346,226,251,4,6,0.4541984732824427,30108047
BRIAN.SUTHERBY,20072008,WSH,34.1,1,0,0,0,1,1,12,23,11,3,8,9,1,1,2,32,28,32,28,1,3,0.5217391304347826,30108015.89
BRIAN.WILLSIE,20072008,L.A,563.2166666666667,4,4,4,8,12,8,14,24,10,62,111,42,25,4,16,486,493,451,470,19,25,0.5833333333333334,30108064.55
BROOKS.LAICH,20072008,WSH,1282.0333333333333,22,14,6,20,42,36,314,659,345,142,221,93,40,24,NA,1081,1178,779,707,27,32,0.4764795144157815,NA
BROOKS.ORPIK,20072008,PIT,1738.2333333333336,1,4,7,11,12,5,0,0,0,62,154,341,49,21,33,1303,1780,1120,1422,51,48,0,30108165.985
BRUNO.GERVAIS,20072008,NYI,1190.9833333333333,0,8,5,13,13,8,0,0,0,59,139,35,55,10,17,986,1083,691,684,28,27,0,30108077.975
BRYAN.ALLEN,20072008,FLA,1554.0833333333335,2,4,10,14,16,6,0,0,0,67,164,112,62,16,28,1224,1623,1013,1069,46,42,0,30108117.560000002
BRYAN.BERARD,20072008,NYI,952.6500000000001,5,5,12,17,22,10,0,0,0,87,206,36,82,6,20,1000,752,590,581,22,23,0,30108068.61
BRYAN.BICKELL,20072008,CHI,36.53333333333334,0,0,0,0,0,0,0,0,0,3,5,7,0,0,1,33,16,32,16,0,1,0,30108013.1
BRYAN.LITTLE,20072008,ATL,749.25,6,9,1,10,16,15,228,505,277,76,120,15,25,12,8,668,598,420,499,19,20,0.4514851485148515,30108085.165
BRYAN.MCCABE,20072008,TOR,1396,5,8,9,17,22,13,0,0,0,107,235,109,84,17,35,1322,1214,711,708,28,26,0,30108085.195
BRYAN.SMOLINSKI,20072008,MTL,1014.8833333333334,9,10,9,19,28,19,470,925,455,106,199,NA,46,6,10,883,1100,680,707,23,25,0.5081081081081081,30108111.085
BRYAN.YOUNG,20072008,EDM,4.266666666666667,0,0,0,0,0,0,0,0,0,0,0,1,0,0,0,2,9,2,9,0,1,0,15054007.25
BRYCE.SALVADOR,20072008,N.J,256.85,1,0,0,0,1,1,0,0,0,1,15,29,8,4,5,171,238,159,186,7,7,0,30108031.240000002
BRYCE.SALVADOR,20072008,STL,1099.9166666666665,1,4,6,10,11,5,0,1,1,29,60,61,13,12,NA,646,1084,547,686,36,29,0,NA
BYRON.RITCHIE,20072008,VAN,875.4666666666667,3,7,1,8,11,10,261,512,251,73,105,88,15,28,21,496,880,356,577,12,24,0.509765625,30108099.744999997
CAL.CLUTTERBUCK,20072008,MIN,14.166666666666666,0,0,0,0,0,0,1,1,0,0,3,4,1,0,0,11,12,11,11,0,0,1,30108012.939999998
CAM.BARKER,20072008,CHI,773.95,6,5,7,12,18,11,0,0,0,41,94,45,34,10,19,583,580,414,462,26,23,0,30108064.075000003
CAM.JANSSEN,20072008,STL,85.43333333333334,0,1,0,1,1,1,0,0,0,9,12,26,0,2,6,66,63,66,61,3,4,0,30108019.32
CARLO.COLAIACOVO,20072008,TOR,488.15,2,2,2,4,6,4,0,0,0,30,56,57,18,7,5,430,462,354,301,11,19,0,30108040.07
CASEY.BORER,20072008,CAR,168.13333333333333,1,1,1,2,3,2,0,0,0,5,13,17,7,0,2,166,133,121,94,5,10,0,30108020.125
CHAD.KILGER,20072008,TOR,615.7666666666667,10,5,2,7,17,15,34,70,36,74,132,NA,19,10,8,466,629,418,487,22,22,0.4857142857142857,30108074.36
CHAD.LAROSE,20072008,CAR,814.9166666666666,11,10,1,11,22,21,6,19,13,117,189,73,39,28,23,696,803,631,580,30,24,0.3157894736842105,30108080.545
CHRIS.BOURQUE,20072008,WSH,34.766666666666666,0,0,0,0,0,0,0,1,1,4,7,4,2,0,1,47,26,34,25,0,0,0,30108014.15
CHRIS.CAMPOLI,20072008,NYI,879.6833333333334,4,7,5,12,16,11,0,0,0,68,129,51,37,9,8,872,658,480,451,25,16,0,30108058.064999998
CHRIS.CHELIOS,20072008,DET,1350.85,3,4,4,8,11,7,0,0,0,71,182,72,57,13,22,1052,1039,901,628,36,30,0,30108058.78
CHRIS.CLARK,20072008,WSH,304.2,5,3,1,4,9,8,6,13,7,29,59,24,11,4,17,309,239,204,193,9,6,0.46153846153846156,30108037.305
CHRIS.CONNER,20072008,DAL,268.15,3,1,1,2,5,4,1,1,0,27,38,20,4,0,3,207,210,180,202,8,9,1,30108036.015
CHRIS.DRURY,20072008,NYR,1807.7,28,18,17,35,63,46,833,1539,706,238,378,58,62,23,23,1731,1520,905,882,37,30,0.5412605588044185,30108157.525
CHRIS.GRATTON,20072008,T.B,762.25,10,3,8,11,21,13,335,613,278,92,146,88,25,9,29,661,605,466,506,21,28,0.5464926590538336,30108086.54
CHRIS.HIGGINS,20072008,MTL,1692.8666666666668,30,19,8,27,57,49,38,109,71,275,459,99,87,38,11,1703,1595,958,1121,39,34,0.3486238532110092,30108164.35
CHRIS.KELLY,20072008,OTT,1227.5833333333333,11,12,7,19,30,23,85,161,76,123,210,63,45,11,13,868,1156,675,718,34,32,0.5279503105590062,30108100.085
CHRIS.KUNITZ,20072008,ANA,1497.1333333333332,21,22,8,30,51,43,18,52,34,210,336,188,56,28,31,1499,984,914,709,38,33,0.34615384615384615,30108102.9
CHRIS.MINARD,20072008,PIT,58.150000000000006,1,0,1,1,2,1,0,0,0,9,13,16,1,2,1,42,51,33,49,1,2,0,30108018.795
CHRIS.NEIL,20072008,OTT,899.15,6,12,3,15,21,18,0,0,0,81,150,208,27,48,75,864,698,622,615,36,31,0,30108090.505000003
CHRIS.PHILLIPS,20072008,OTT,1888.3166666666666,5,3,9,12,17,8,0,1,1,84,172,129,67,16,29,1327,1992,1070,1183,55,48,0,30108132.235
CHRIS.PRONGER,20072008,ANA,2015.4,14,16,17,33,47,30,4,7,3,189,372,89,115,17,53,1660,1506,880,864,32,31,0.5714285714285714,30108113.105
CHRIS.SIMON,20072008,MIN,91.06666666666666,0,0,0,0,0,0,1,1,0,9,14,7,3,4,4,86,70,55,65,2,3,1,30108019.33
CHRIS.SIMON,20072008,NYI,195.48333333333335,1,2,0,2,3,3,1,1,0,18,31,12,9,7,13,164,146,131,119,4,4,1,30108026.06
CHRIS.THORBURN,20072008,ATL,652.45,5,6,7,13,18,11,12,20,8,72,106,89,13,17,23,454,623,413,586,21,26,0.6,30108088.975
CHRISTIAN.BACKMAN,20072008,NYR,484.73333333333335,2,3,2,5,7,5,0,0,0,28,61,21,20,2,14,454,343,335,276,14,9,0,30108038.270000003
CHRISTIAN.BACKMAN,20072008,STL,871.55,1,2,7,9,10,3,0,0,0,30,75,NA,26,9,15,707,678,492,521,22,26,0,30108064.515
CHRISTIAN.EHRHOFF,20072008,S.J,1903.55,1,6,17,23,24,7,0,0,0,105,289,NA,91,17,42,1622,1487,1177,998,51,39,0,30108098.545
CHRISTOPH.SCHUBERT,20072008,OTT,1151.9833333333331,8,8,6,14,22,16,1,4,3,143,256,202,65,19,35,1037,961,626,616,31,22,0.25,30108081.880000003
CHUCK.KOBASEW,20072008,BOS,1290.3333333333335,22,12,5,17,39,34,28,70,42,147,207,86,30,24,NA,979,1119,235,256,4,12,0.4,NA
CLARKE.MACARTHUR,20072008,BUF,527.0666666666666,7,5,1,6,13,12,4,14,10,48,78,34,17,5,9,438,493,335,421,20,18,0.2857142857142857,30108064.835
CLAUDE.GIROUX,20072008,PHI,19.15,0,0,0,0,0,0,0,0,0,2,3,0,0,0,0,20,17,16,16,0,0,0,30108013.700000003
CLAY.WILSON,20072008,CBJ,118.43333333333334,1,1,0,1,2,2,0,0,0,12,25,2,9,2,1,154,62,100,55,4,1,0,30108015.32
CODY.BASS,20072008,OTT,144.86666666666667,3,2,0,2,5,5,40,97,57,17,23,20,3,8,11,90,143,68,96,4,5,0.41237113402061853,30108030.18
CODY.MCCORMICK,20072008,COL,486.35,2,2,1,3,5,4,6,17,11,50,88,87,21,13,18,313,393,305,337,9,10,0.35294117647058826,30108051.195
CODY.MCLEOD,20072008,COL,619.8333333333333,5,3,3,6,11,8,1,5,4,76,104,120,5,32,36,401,564,388,486,13,21,0.2,30108077.885
COLBY.ARMSTRONG,20072008,ATL,324.5833333333333,4,5,2,7,11,9,0,3,3,29,46,16,8,6,3,244,342,164,211,8,10,0,30108040.86
COLBY.ARMSTRONG,20072008,PIT,831.45,9,6,9,15,24,15,3,12,9,84,136,66,20,22,18,647,847,526,553,25,23,0.25,30108079.715
COLIN (JOHN).WHITE,20072008,N.J,1221.75,2,2,4,6,8,4,0,0,0,28,79,125,30,9,16,799,1138,659,720,25,31,0,30108085.490000002
COLIN.FRASER,20072008,CHI,51.55,0,0,0,0,0,0,14,37,23,4,5,4,1,3,2,27,56,24,30,1,3,0.3783783783783784,30108016.54
COLIN.STUART,20072008,ATL,221.91666666666669,3,1,1,2,5,4,4,7,3,19,27,25,3,1,3,134,214,119,178,6,6,0.5714285714285714,30108035.645000003
COLTON.ORR,20072008,NYR,587.8333333333334,1,1,0,1,2,2,1,2,1,25,53,149,14,31,39,392,435,368,419,5,17,0.5,30108062.3
CONNOR.JAMES,20072008,PIT,96.55,1,0,0,0,1,1,0,0,0,9,15,3,5,1,1,55,92,50,90,0,2,0,30108023.560000002
COREY.LOCKE,20072008,MTL,5.983333333333333,0,0,0,0,0,0,2,5,3,1,2,0,1,0,0,5,6,5,6,0,1,0.4,15054006.68
COREY.PERRY,20072008,ANA,1301.25,31,16,9,25,56,47,3,16,13,206,336,99,42,46,51,1294,767,838,657,49,35,0.1875,30108105.205
CORY.MURPHY,20072008,FLA,723.4000000000001,2,7,8,15,17,9,0,0,0,65,135,11,41,5,11,840,529,434,430,14,15,0,30108057.35
CORY.SARICH,20072008,CGY,1642.5666666666666,2,1,4,5,7,3,0,0,0,61,145,NA,40,17,54,1101,1440,950,952,42,45,0,30108108.57
CORY.STILLMAN,20072008,CAR,1093.1666666666665,21,12,12,24,45,33,6,11,5,124,220,43,45,18,6,1163,910,678,686,26,32,0.5454545454545454,30108100.02
CORY.STILLMAN,20072008,OTT,465.23333333333335,5,7,8,15,20,12,2,7,5,56,100,28,20,5,6,484,380,271,253,8,10,0.2857142857142857,30108044.130000003
CRAIG.ADAMS,20072008,CAR,391.9166666666667,2,1,2,3,5,3,3,11,8,31,64,67,16,10,11,298,411,242,248,8,17,0.2727272727272727,30108039.270000003
CRAIG.ADAMS,20072008,CHI,417.73333333333335,2,2,2,4,6,4,16,30,14,31,45,49,5,9,6,194,391,169,265,2,13,0.5333333333333333,30108047.979999997
CRAIG.CONROY,20072008,CGY,1472.45,12,8,16,24,36,20,771,1498,727,128,214,NA,37,23,38,1218,1246,870,798,44,37,0.5146862483311081,30108131.02
CRAIG.MACDONALD,20072008,T.B,706.5,2,5,3,8,10,7,200,404,204,84,135,53,24,11,7,438,695,392,467,15,25,0.49504950495049505,30108074.535
CRAIG.RIVET,20072008,S.J,1867.5833333333335,5,14,22,36,41,19,0,0,0,122,265,NA,98,18,42,1686,1368,1106,918,41,37,0,30108098.98
CRAIG.WELLER,20072008,ARI,612.5833333333333,3,3,5,8,11,6,0,2,2,72,111,122,16,13,22,506,492,463,475,17,22,0,30108066.405
CURTIS.BROWN,20072008,S.J,421.1,5,2,1,3,8,7,134,226,92,43,68,NA,12,3,6,281,387,237,244,13,9,0.5929203539823009,30108044.015
CURTIS.GLENCROSS,20072008,CBJ,435.76666666666665,6,4,2,6,12,10,8,14,6,63,99,NA,18,11,11,425,290,322,263,11,10,0.5714285714285714,30108042.68
CURTIS.GLENCROSS,20072008,EDM,268.1333333333333,9,1,3,4,13,10,5,11,6,41,70,43,15,11,7,230,235,227,227,16,10,0.45454545454545453,30108040.585
DAINIUS.ZUBRUS,20072008,N.J,1368.3666666666668,13,14,12,26,39,27,86,157,71,133,248,94,59,29,24,1301,906,873,765,39,34,0.5477707006369427,30108099.33
DALLAS.DRAKE,20072008,DET,945.6333333333334,4,5,1,6,10,9,32,79,47,71,123,138,28,30,19,669,753,620,564,14,27,0.4050632911392405,30108073.655
DAN.BOYLE,20072008,T.B,1013.95,4,11,10,21,25,15,0,0,0,74,159,49,49,11,22,999,838,619,561,22,35,0,30108071.26
DAN.CARCILLO,20072008,ARI,724.3166666666667,13,7,4,11,24,20,4,5,1,106,178,109,29,50,NA,676,609,490,559,17,15,0.8,NA
DAN.CLEARY,20072008,DET,1487.6166666666668,21,12,12,24,45,33,90,177,87,230,367,111,53,26,17,1506,1029,954,712,44,27,0.5084745762711864,30108096.509999998
DAN.FRITSCHE,20072008,CBJ,851.8333333333334,10,9,3,12,22,19,59,118,59,107,151,65,20,8,9,723,682,631,588,28,27,0.5,30108082.765
DAN.GIRARDI,20072008,NYR,1945.0166666666664,10,11,10,21,31,21,0,1,1,161,337,229,115,22,10,1778,1533,1187,1024,49,47,0,30108105.27
DAN.HAMHUIS,20072008,NSH,1955.0833333333333,5,8,15,23,28,13,0,0,0,134,283,178,100,26,31,1514,1734,1069,1100,44,56,0,30108122.585
DAN.HINOTE,20072008,STL,609.8833333333332,5,3,2,5,10,8,14,33,19,42,62,114,10,14,15,306,581,278,434,11,14,0.42424242424242425,30108070.65
DAN.JANCEVSKI,20072008,DAL,18.616666666666667,0,0,0,0,0,0,0,0,0,3,3,0,0,0,0,13,18,13,17,0,0,0,30108014.049999997
DAN.JANCEVSKI,20072008,T.B,4.75,0,0,0,0,0,0,0,0,0,0,0,0,0,0,1,3,8,3,7,0,1,0,15054007.05
DANE.BYERS,20072008,NYR,5.083333333333333,0,0,0,0,0,0,0,0,0,0,0,3,0,0,0,2,9,2,9,0,1,0,15054007.25
DANIEL.ALFREDSSON,20072008,OTT,1574.1666666666665,40,27,20,47,87,67,21,39,18,217,371,56,83,29,17,1666,1310,945,827,57,48,0.5384615384615384,30108126.53
DANIEL.BRIERE,20072008,PHI,1801.8666666666666,40,29,19,48,88,69,727,1431,704,225,375,42,92,43,42,1913,1502,1017,1224,43,58,0.5080363382250175,30108215.785
DANIEL.PAILLE,20072008,BUF,996.0166666666667,19,11,5,16,35,30,15,41,26,110,172,61,30,26,7,700,921,599,635,34,28,0.36585365853658536,30108095.385
DANIEL.SEDIN,20072008,VAN,1559.9166666666665,29,26,19,45,74,55,17,38,21,247,403,11,69,31,25,1693,1008,993,791,41,38,0.4473684210526316,30108117.814999998
DANIEL.WINNIK,20072008,ARI,1113.9333333333334,11,5,10,15,26,16,65,154,89,122,181,75,29,23,9,880,1088,740,760,28,27,0.42207792207792205,30108103.130000003
DANNY.RICHMOND,20072008,CHI,65.81666666666666,0,0,0,0,0,0,0,0,0,2,5,7,2,1,1,56,54,52,45,1,5,0,30108015.96
DANY.HEATLEY,20072008,OTT,1608.2166666666667,41,23,18,41,82,64,15,26,11,231,411,65,97,27,33,1847,1272,1113,974,74,44,0.5769230769230769,30108136.67
DARCY.HORDICHUK,20072008,NSH,249.4,1,2,0,2,3,3,0,0,0,19,30,74,2,19,13,159,200,155,189,6,6,0,30108036.29
DARCY.TUCKER,20072008,TOR,1216.1166666666668,18,10,6,16,34,28,13,25,12,151,275,NA,54,32,NA,1292,959,749,725,26,31,0.52,NA
DARREN.HAYDAR,20072008,ATL,188.13333333333335,1,4,2,6,7,5,0,2,2,14,25,1,10,3,1,180,140,129,127,7,4,0,30108026.08
DARREN.HELM,20072008,DET,184.06666666666666,2,2,0,2,4,4,44,115,71,28,50,31,11,3,3,165,117,163,113,6,5,0.3826086956521739,30108025.740000002
DARREN.MCCARTY,20072008,DET,131.81666666666666,1,1,1,2,3,2,1,4,3,17,26,24,4,4,8,121,98,117,97,7,3,0.25,30108022.605
DARRYL.BOOTLAND,20072008,NYI,18.8,0,1,0,1,1,1,0,0,0,3,4,1,1,0,1,20,18,19,16,1,1,0,30108014
DARRYL.BOYCE,20072008,TOR,3.3333333333333335,0,0,0,0,0,0,2,2,0,0,0,1,0,0,0,0,5,0,5,0,0,1,15054006.73
DARRYL.SYDOR,20072008,PIT,1364.25,1,5,6,11,12,6,0,0,0,61,134,40,35,12,11,1152,1294,824,1007,37,31,0,30108119.770000003
DAVE.BOLLAND,20072008,CHI,534.9666666666667,4,9,4,13,17,13,174,378,204,48,73,55,12,13,14,397,462,312,331,21,15,0.4603174603174603,30108062.24
DAVID.BACKES,20072008,STL,1056.7166666666667,13,7,11,18,31,20,30,67,37,129,205,240,31,30,34,921,771,675,657,34,42,0.44776119402985076,30108094.225
DAVID.BOOTH,20072008,FLA,1180.5666666666666,22,11,7,18,40,33,13,38,25,228,370,113,71,31,13,1183,1023,889,808,43,30,0.34210526315789475,30108108.405
DAVID.BRINE,20072008,FLA,54.35,0,0,1,1,1,0,17,44,27,3,8,3,4,3,2,35,56,34,50,1,1,0.38636363636363635,30108018.785
DAVID.CLARKSON,20072008,N.J,1035.65,9,8,5,13,22,17,6,16,10,154,256,165,35,57,56,795,743,686,676,36,36,0.375,30108096.634999998
DAVID.HALE,20072008,CGY,882.0166666666667,0,0,2,2,2,0,0,0,0,40,100,92,33,10,21,696,696,652,611,23,24,0,30108068.049999997
DAVID.JONES,20072008,COL,425.1333333333333,2,5,0,5,7,7,3,8,5,55,86,51,15,6,7,341,336,296,321,7,13,0.375,30108050.28
DAVID.KOCI,20072008,CHI,58.9,0,0,0,0,0,0,0,0,0,2,3,16,1,8,13,38,40,36,37,0,4,0,30108017.729999997
DAVID.KREJCI,20072008,BOS,959.0166666666667,7,18,7,25,32,25,353,741,388,88,127,53,23,12,NA,944,690,268,207,7,7,0.47638326585695007,NA
DAVID.LEGWAND,20072008,NSH,1225.3666666666668,16,16,13,29,45,32,326,745,419,148,214,8,34,15,19,1107,1007,669,715,34,37,0.4375838926174497,30108124.665
DAVID.MOSS,20072008,CGY,559.8666666666667,5,6,2,8,13,11,8,18,10,66,118,50,23,12,7,487,380,401,316,16,18,0.4444444444444444,30108045.34
DAVID.PERRON,20072008,STL,778.1166666666667,13,11,3,14,27,24,5,14,9,68,120,65,22,27,20,659,519,476,467,33,15,0.35714285714285715,30108072.445
DAVID.STECKEL,20072008,WSH,1009.45,6,4,2,6,12,10,538,978,440,75,143,103,35,18,16,681,1037,591,535,18,24,0.5501022494887525,30108084.25
DAVID.TANABE,20072008,CAR,215.56666666666666,1,1,1,2,3,2,0,0,0,12,28,8,12,0,4,203,192,157,161,7,6,0,30108027.975
DAVID.VYBORNY,20072008,CBJ,1021.0999999999999,7,8,11,19,26,15,20,56,36,104,148,36,23,14,16,905,687,538,468,17,25,0.35714285714285715,30108068.765
DAYMOND.LANGKOW,20072008,CGY,1634.7333333333333,33,25,12,37,70,58,390,900,510,217,343,84,49,18,7,1751,1017,1152,860,63,44,0.43333333333333335,30108138.03
DEAN.MCAMMOND,20072008,OTT,826.9333333333333,9,7,5,12,21,16,132,300,168,71,131,49,35,6,7,648,725,518,517,25,26,0.44,30108076.915
DENIS.GREBESHKOV,20072008,EDM,1198.3,3,6,8,14,17,9,0,0,0,34,102,41,42,10,11,1017,1028,776,839,44,41,0,30108095.6
DENIS.TOLPEKO,20072008,PHI,215.26666666666665,1,3,2,5,6,4,0,0,0,24,49,15,10,8,8,193,189,176,181,5,9,0,30108033.08
DENNIS.SEIDENBERG,20072008,CAR,885.2,0,7,8,15,15,7,1,1,0,80,178,110,68,11,9,916,800,628,589,25,22,1,30108064.9
DENNIS.WIDEMAN,20072008,BOS,2170.9666666666667,13,10,13,23,36,23,0,0,0,177,402,66,117,28,34,1960,1715,500,413,18,14,0,30108058.505000003
DEREK.ARMSTRONG,20072008,L.A,1022.7333333333333,8,18,9,27,35,26,379,747,368,118,190,105,32,21,23,1062,814,817,748,41,35,0.5073627844712182,30108112.745
DEREK.BOOGAARD,20072008,MIN,159.33333333333331,0,0,0,0,0,0,0,0,0,4,11,40,1,16,19,111,135,101,133,1,7,0,30108029.810000002
DEREK.MACKENZIE,20072008,CBJ,132.23333333333332,2,0,0,0,2,2,25,73,48,19,29,12,3,5,3,110,95,109,91,2,4,0.3424657534246575,30108024.45
DEREK.MEECH,20072008,DET,388.48333333333335,0,1,2,3,3,1,0,0,0,44,82,22,24,2,3,379,239,291,212,7,10,0,30108027.97
DEREK.MORRIS,20072008,ARI,1780.4666666666667,8,11,5,16,24,19,0,1,1,135,280,81,89,13,32,1472,1754,1033,1155,46,42,0,30108137.105
DEREK.ROY,20072008,BUF,1600.6,32,30,18,48,80,62,693,1352,659,209,356,35,75,48,23,1581,1232,902,779,63,48,0.5125739644970414,30108143.7
DERIAN.HATCHER,20072008,PHI,1245.4666666666667,3,3,3,6,9,6,0,0,0,33,77,143,30,20,28,940,1445,791,972,33,35,0,30108118.825
DERICK.BRASSARD,20072008,CBJ,153.9,1,0,1,1,2,1,34,80,46,13,29,11,12,5,3,150,91,105,88,3,7,0.425,30108021.585
DEVIN.SETOGUCHI,20072008,S.J,718.7,12,6,1,7,19,18,12,20,8,116,191,82,37,8,5,672,520,506,471,25,14,0.6,30108066.735
DICK.TARNSTROM,20072008,CBJ,362.03333333333336,2,0,7,7,9,2,0,0,0,22,57,10,22,2,6,396,206,231,171,6,11,0,30108025.845
DICK.TARNSTROM,20072008,EDM,567.8499999999999,1,2,2,4,5,3,0,0,0,22,60,12,21,2,19,446,532,308,378,13,20,0,30108054.12
DION.PHANEUF,20072008,CGY,2354.05,20,21,25,46,66,41,0,0,0,285,575,229,174,64,70,2332,1791,1452,1228,69,60,0,30108139.965
DJ.KING,20072008,STL,341.95000000000005,3,2,1,3,6,5,2,7,5,36,45,NA,6,21,28,219,254,212,248,9,13,0.2857142857142857,30108046.064999998
DMITRI.KALININ,20072008,BUF,783.05,1,3,4,7,8,4,0,0,0,55,108,24,28,1,16,613,670,462,513,19,20,0,30108066.61
DOMINIC.MOORE,20072008,MIN,347.98333333333335,1,1,1,2,3,2,161,304,143,25,54,15,17,9,5,222,328,197,264,5,14,0.5296052631578947,30108047.405
DOMINIC.MOORE,20072008,TOR,545.55,4,5,5,10,14,9,199,393,194,71,119,NA,23,14,7,428,482,341,326,15,12,0.5063613231552163,30108056.525
DONALD.BRASHEAR,20072008,WSH,681.2166666666667,6,3,1,4,10,9,1,3,2,64,113,144,18,20,35,570,528,528,507,16,23,0.3333333333333333,30108071.215
DOUG.JANIK,20072008,T.B,568.9333333333334,1,2,1,3,4,3,0,0,0,23,61,33,25,6,13,443,481,416,428,15,19,0,30108054.435000002
DOUG.WEIGHT,20072008,ANA,548.1666666666666,6,5,4,9,15,11,167,357,190,51,92,31,23,5,12,514,377,299,323,9,9,0.4677871148459384,30108060.18
DOUG.WEIGHT,20072008,STL,469.20000000000005,4,5,2,7,11,9,142,286,144,46,81,20,12,7,6,422,331,282,284,15,6,0.4965034965034965,30108051.200000003
DOUGLAS.MURRAY,20072008,S.J,1388.9833333333333,2,5,5,10,12,7,1,2,1,66,152,NA,51,22,23,988,1164,867,845,48,27,0.5,30108092.085
DREW.FATA,20072008,NYI,87.53333333333333,0,0,1,1,1,0,0,0,0,4,10,3,3,1,2,59,109,53,82,1,2,0,30108021.634999998
DREW.LARMAN,20072008,FLA,35.95,0,0,1,1,1,0,10,26,16,1,4,5,1,0,1,13,23,10,17,1,0,0.38461538461538464,30108014.725
DREW.MILLER,20072008,ANA,290.93333333333334,2,1,2,3,5,3,3,9,6,29,44,12,4,4,3,206,230,182,178,6,7,0.3333333333333333,30108032.41
DREW.STAFFORD,20072008,BUF,859.4333333333334,16,13,8,21,37,29,7,20,13,103,162,62,28,17,24,779,682,550,565,36,28,0.35,30108088.1
DUNCAN.KEITH,20072008,CHI,2072.9166666666665,12,14,5,19,31,26,0,0,0,146,262,67,79,11,23,1486,1775,1105,1079,59,42,0,30108125.235
DUSTIN.BOYD,20072008,CGY,470.71666666666664,7,4,1,5,12,11,65,129,64,45,78,39,18,13,3,394,396,339,364,14,25,0.5038759689922481,30108057.405
DUSTIN.BROWN,20072008,L.A,1582.9833333333333,33,17,10,27,60,50,20,39,19,219,379,311,81,61,22,1551,1415,935,1022,38,53,0.5128205128205128,30108149.509999998
DUSTIN.BYFUGLIEN,20072008,CHI,1140.95,19,7,9,16,35,26,0,1,1,163,279,131,53,20,27,1036,658,656,562,29,28,0,30108081.475
DUSTIN.PENNER,20072008,EDM,1410.6833333333334,23,9,15,24,47,32,104,189,85,201,342,99,61,23,16,1398,1060,933,940,43,43,0.5502645502645502,30108128.814999998
DUVIE.WESTCOTT,20072008,CBJ,376.3333333333333,1,2,1,3,4,3,0,0,0,27,60,18,22,3,11,365,246,209,189,5,11,0,30108030.755
ED.JOVANOVSKI,20072008,ARI,1801.6833333333334,12,14,23,37,49,26,0,0,0,238,454,114,139,14,NA,1898,1344,1227,1083,42,43,0,NA
ENVER.LISIN,20072008,ARI,187.91666666666669,4,0,1,1,5,4,1,2,1,27,62,8,11,6,3,214,170,150,147,4,5,0.5,30108029.075000003
ERIC.BELANGER,20072008,MIN,1367.9499999999998,13,17,5,22,35,30,615,1255,640,117,240,NA,52,19,17,1155,1173,792,808,26,35,0.4900398406374502,30108135.165
ERIC.BOULTON,20072008,ATL,551.2666666666667,4,3,2,5,9,7,1,4,3,64,92,56,8,23,33,351,578,334,548,12,22,0.25,30108087.62
ERIC.BREWER,20072008,STL,1896.3333333333335,1,10,11,21,22,11,0,0,0,101,230,92,79,20,NA,1328,1704,901,1083,42,50,0,NA
ERIC.FEHR,20072008,WSH,290.2833333333333,2,2,3,5,7,4,0,2,2,45,86,14,17,8,3,320,195,260,182,10,6,0,30108027.855
ERIC.GODARD,20072008,CGY,366.2166666666667,1,1,0,1,2,2,0,1,1,15,32,40,6,23,33,223,305,216,301,6,15,0,30108051.78
ERIC.NYSTROM,20072008,CGY,559.25,3,5,1,6,9,8,9,19,10,45,87,76,27,23,13,389,490,346,389,11,17,0.47368421052631576,30108057.115000002
ERIC.PERRIN,20072008,ATL,1443.9666666666667,12,22,11,33,45,34,379,716,337,121,225,52,62,13,13,1093,1364,737,900,33,44,0.5293296089385475,30108138.415
ERIC.STAAL,20072008,CAR,1773.5666666666666,37,26,19,45,82,63,763,1702,939,309,549,99,132,50,25,2064,1439,1167,1064,58,57,0.4482961222091657,30108185.395000003
ERIK.CHRISTENSEN,20072008,ATL,169.53333333333333,2,0,2,2,4,2,93,160,67,23,43,7,12,0,1,140,144,75,107,4,10,0.58125,30108027.17
ERIK.CHRISTENSEN,20072008,PIT,617.65,9,4,7,11,20,13,182,311,129,109,190,28,38,9,13,538,515,343,437,18,19,0.5852090032154341,30108073.145
ERIK.COLE,20072008,CAR,1412.9833333333333,23,23,6,29,52,46,9,38,29,215,370,186,71,52,23,1589,1086,914,828,50,42,0.23684210526315788,30108117.630000003
ERIK.JOHNSON,20072008,STL,1252.9833333333331,5,13,14,27,32,18,0,1,1,104,221,87,70,8,14,1130,866,724,714,37,38,0,30108085.98
ERIK.REITZ,20072008,MIN,12.583333333333334,0,0,0,0,0,0,0,0,0,0,1,3,1,0,0,8,9,8,9,0,1,0,30108012.799999997
ETHAN.MOREAU,20072008,EDM,397.93333333333334,5,4,0,4,9,9,10,23,13,54,96,49,25,9,15,268,462,206,330,8,11,0.43478260869565216,30108057.54
EVGENI.MALKIN,20072008,PIT,2163.866666666667,57,46,24,70,127,103,433,1098,665,347,590,75,129,75,43,2316,1800,1248,1378,75,53,0.39435336976320584,30108246.17
FEDOR.TYUTIN,20072008,NYR,1874.9,5,3,15,18,23,8,0,0,0,139,278,234,81,6,22,1676,1480,1191,1025,47,47,0,30108103.585
FERNANDO.PISANI,20072008,EDM,925.7833333333333,13,4,5,9,22,17,2,6,4,95,164,41,40,13,13,706,914,512,655,24,28,0.3333333333333333,30108093.735
FILIP.KUBA,20072008,T.B,1871.8166666666666,6,9,16,25,31,15,0,2,2,113,234,69,62,7,18,1624,1552,1026,1044,53,65,0,30108118.92
FRANCIS.BOUILLON,20072008,MTL,1394.4333333333334,3,0,8,8,11,3,0,0,0,70,151,176,55,21,NA,1019,1544,847,994,41,34,0,NA
FRANCOIS.BEAUCHEMIN,20072008,ANA,2218.5666666666666,2,13,6,19,21,15,0,1,1,147,309,108,79,22,33,1695,1854,1143,1117,41,54,0,30108125.97
FRANS.NIELSEN,20072008,NYI,131.06666666666666,2,0,1,1,3,2,47,101,54,16,29,4,6,3,0,99,111,92,102,4,3,0.46534653465346537,30108025.735
FRANTISEK.KABERLE,20072008,CAR,1371.9333333333334,0,10,9,19,19,10,0,0,0,89,185,28,74,4,NA,1400,1094,968,878,43,39,0,NA
FREDDY.MEYER,20072008,NYI,123.18333333333334,0,0,1,1,1,0,0,0,0,5,15,8,4,4,3,101,155,76,98,5,3,0,30108022.365000002
FREDERICK.MEYER IV,20072008,ARI,33.333333333333336,0,0,0,0,0,0,0,0,0,2,3,1,1,0,0,23,25,20,23,0,3,0,30108014.4
FREDERICK.MEYER IV,20072008,NYI,886.9833333333333,3,3,3,6,9,6,0,0,0,44,106,77,42,5,8,786,744,631,506,24,23,0,30108053.875
FREDRIK.MODIN,20072008,CBJ,386.16666666666663,6,2,4,6,12,8,43,100,57,41,83,16,22,9,9,337,281,206,189,10,8,0.43,30108036.759999998
FREDRIK.SJOSTROM,20072008,ARI,691.1500000000001,10,2,6,8,18,12,6,33,27,83,136,72,25,11,7,570,645,462,507,16,21,0.18181818181818182,30108073.950000003
FREDRIK.SJOSTROM,20072008,NYR,210.08333333333334,2,0,1,1,3,2,0,3,3,28,44,45,4,6,5,150,155,147,144,4,4,0,30108028.884999998
GABE.GAUTHIER,20072008,L.A,21.383333333333336,0,0,0,0,0,0,8,17,9,2,2,3,0,1,0,9,19,9,19,0,0,0.47058823529411764,15054008.88
GARNET.EXELBY,20072008,ATL,1492.1333333333334,2,2,3,5,7,4,0,0,0,37,92,176,39,18,NA,926,1556,800,1138,35,61,0,NA
GARRETT.STAFFORD,20072008,DET,13.5,0,0,0,0,0,0,0,0,0,1,2,1,0,0,0,15,10,9,7,0,0,0,15054006.65
GARTH.MURRAY,20072008,FLA,30.85,0,0,0,0,0,0,0,2,2,3,3,9,0,5,4,21,33,20,22,0,0,0,30108015.2
GARTH.MURRAY,20072008,MTL,12.766666666666666,0,0,0,0,0,0,0,1,1,0,0,4,0,0,0,2,13,2,13,0,0,0,15054007.9
GARY.ROBERTS,20072008,PIT,619.6,5,10,4,14,19,15,7,11,4,50,77,75,11,17,25,516,486,336,442,14,22,0.6363636363636364,30108073.6
GEOFF.PLATT,20072008,ANA,56.45,0,0,0,0,0,0,2,7,5,4,7,3,0,1,1,44,37,33,31,2,1,0.2857142857142857,30108015.29
GEOFF.SANDERSON,20072008,EDM,416.4,3,5,5,10,13,8,12,23,11,40,59,8,8,9,8,312,396,273,335,12,21,0.5217391304347826,30108054.545
GEORGE.PARROS,20072008,ANA,412.3,1,2,2,4,5,3,3,10,7,30,46,91,5,31,42,249,278,235,264,8,6,0.3,30108048.28
GEORGES.LARAQUE,20072008,PIT,637.3166666666666,5,5,6,11,16,10,0,1,1,33,55,103,11,26,37,416,589,379,546,19,18,0,30108084.66
GILBERT.BRULE,20072008,CBJ,603.6833333333334,1,6,2,8,9,7,39,76,37,72,114,73,19,19,12,513,402,430,387,13,17,0.5131578947368421,30108054.95
GLEN.METROPOLIT,20072008,BOS,1452.5333333333333,12,11,11,22,34,23,666,1350,684,151,234,80,38,22,20,1070,1412,316,325,10,15,0.49333333333333335,30108091.335
GLEN.MURRAY,20072008,BOS,1239.1166666666668,17,8,5,13,30,25,6,19,13,166,288,49,54,17,26,1271,916,342,301,13,9,0.3157894736842105,30108059.634999998
GLEN.WESLEY,20072008,CAR,1255.4166666666665,1,3,2,5,6,4,0,0,0,62,135,85,44,17,21,989,1282,834,822,30,34,0,30108091.42
GREG.DE VRIES,20072008,NSH,1570.2666666666667,5,3,7,10,15,8,0,0,0,68,125,79,32,10,26,1095,1514,942,1089,50,56,0,30108129.025
GREG.MOORE,20072008,NYR,70.93333333333332,0,0,0,0,0,0,3,8,5,13,18,7,2,0,0,64,59,57,42,2,3,0.375,30108015.72
GREG.ZANON,20072008,NSH,1551.4333333333334,0,3,4,7,7,3,0,0,0,39,100,174,37,6,13,989,1574,831,1014,37,43,0,30108117.36
GREGORY.CAMPBELL,20072008,FLA,1006.6833333333334,5,9,4,13,18,14,235,460,225,112,182,155,33,15,21,721,1042,617,670,17,34,0.5108695652173914,30108100.700000003
GREGORY.STEWART,20072008,MTL,11.433333333333334,0,0,0,0,0,0,0,0,0,2,4,2,1,2,1,13,13,7,6,0,0,0,15054006.67
GUILLAUME.LATENDRESSE,20072008,MTL,979.55,16,9,3,12,28,25,2,9,7,134,236,149,47,25,NA,872,916,641,811,28,33,0.2222222222222222,NA
HAL.GILL,20072008,PIT,701.15,1,2,2,4,5,3,0,0,0,33,68,58,18,8,14,473,732,432,479,21,15,0,30108062.18
HAL.GILL,20072008,TOR,1303.9,2,5,11,16,18,7,0,0,0,69,141,NA,38,8,23,948,1345,838,787,39,38,0,30108088.555
HENRIK.SEDIN,20072008,VAN,1597.8,15,37,24,61,76,52,642,1365,723,139,230,19,40,24,27,1677,1109,963,855,46,42,0.4703296703296703,30108152.82
HENRIK.TALLINDER,20072008,BUF,1461.9,1,3,11,14,15,4,0,0,0,69,147,32,46,9,23,1121,1454,902,890,46,43,0,30108096.765
HENRIK.ZETTERBERG,20072008,DET,2151.9,56,37,23,60,116,93,861,1574,713,472,760,46,135,50,25,2658,1330,1556,859,71,38,0.5470139771283354,30108148.314999998
IAN.LAPERRIERE,20072008,COL,1084.9333333333334,5,8,8,16,21,13,77,170,93,80,122,112,18,36,38,597,1124,545,719,23,29,0.45294117647058824,30108108.89
IAN.WHITE,20072008,TOR,1520.9666666666667,5,6,8,14,19,11,0,0,0,116,282,NA,112,12,22,1504,1284,1171,959,52,52,0,30108089.32
ILJA.ZUBOV,20072008,OTT,14.633333333333333,0,0,0,0,0,0,2,5,3,0,0,3,0,0,0,9,9,7,9,0,0,0.4,15054007.13
ILYA.KOVALCHUK,20072008,ATL,1696.7333333333333,52,25,9,34,86,77,14,32,18,283,532,40,138,31,20,1528,1350,758,1051,52,66,0.4375,30108172.295
IVAN.BARANKA,20072008,NYR,12.733333333333334,0,1,0,1,1,1,0,0,0,1,1,1,0,0,0,9,12,9,12,1,0,0,15054007.8
J-F.JACQUES,20072008,EDM,55.45,0,0,0,0,0,0,0,0,0,2,6,15,3,0,1,37,37,37,37,1,4,0,30108015.35
J-P.DUMONT,20072008,NSH,1583.95,29,33,12,45,74,62,3,13,10,200,351,48,65,28,19,1574,1220,1033,1022,64,55,0.23076923076923078,30108147.25
JACK.HILLEN,20072008,NYI,15.416666666666666,0,1,0,1,1,1,0,0,0,2,2,0,0,0,1,17,17,13,15,1,0,0,15054008.25
JACK.JOHNSON,20072008,L.A,1605.4666666666667,3,2,6,8,11,5,3,5,2,81,176,84,63,13,NA,1169,1854,963,1396,43,65,0.6,NA
JACK.SKILLE,20072008,CHI,191.61666666666667,3,1,1,2,5,4,2,4,2,23,38,15,5,4,0,172,137,146,121,6,4,0.5,30108025.195
JACOB.DOWELL,20072008,CHI,226.61666666666667,2,1,0,1,3,3,79,168,89,19,25,24,2,5,5,131,238,114,132,3,2,0.47023809523809523,30108032.71
JAMAL.MAYERS,20072008,STL,1274.5166666666667,12,11,3,14,26,23,383,679,296,153,232,NA,30,19,NA,731,1337,596,799,27,42,0.5640648011782032,NA
JAMES.DOWD,20072008,PHI,767.1833333333334,6,5,2,7,13,11,305,565,260,51,81,34,17,11,20,406,802,347,527,16,18,0.5398230088495575,30108091.46
JAMES.SHEPPARD,20072008,MIN,880.5833333333333,4,5,10,15,19,9,292,693,401,59,109,47,24,14,15,742,669,625,627,21,24,0.4213564213564214,30108096.82
JAMES.VANDERMEER,20072008,CGY,528.4666666666667,0,1,1,2,2,1,0,0,0,28,56,46,17,11,14,409,466,328,339,9,11,0,30108046.785
JAMES.VANDERMEER,20072008,CHI,494.9166666666667,2,4,3,7,9,6,0,0,0,23,51,45,20,6,14,356,349,253,247,15,11,0,30108038.285
JAMES.VANDERMEER,20072008,PHI,548.0666666666666,1,2,3,5,6,3,0,0,0,26,56,42,22,7,12,450,509,340,367,14,19,0,30108049.845
JAMES.WISNIEWSKI,20072008,CHI,1139.3,7,9,8,17,24,16,0,0,0,80,163,111,49,24,27,875,840,666,665,47,34,0,30108082.79
JAMIE.LANGENBRUNNER,20072008,N.J,1263.3166666666666,13,17,14,31,44,30,10,21,11,170,296,69,63,20,16,1269,871,727,584,25,26,0.47619047619047616,30108081.1
JAN.HEJDA,20072008,CBJ,1710.1833333333334,0,4,9,13,13,4,0,0,0,71,163,146,62,13,29,1178,1546,1030,998,49,38,0,30108104.455
JAN.HLAVAC,20072008,NSH,405.8,3,7,5,12,15,10,2,10,8,39,78,19,14,6,5,351,337,271,268,14,13,0.2,30108043.915
JAN.HLAVAC,20072008,T.B,915.3166666666666,9,6,7,13,22,15,1,2,1,123,206,55,34,24,16,918,681,717,614,26,31,0.5,30108078.205
JANNIK.HANSEN,20072008,VAN,57.81666666666667,0,0,0,0,0,0,1,1,0,3,8,0,0,2,1,43,34,30,33,0,0,1,30108015.759999998
JARED.BOLL,20072008,CBJ,600.9333333333334,5,3,2,5,10,8,2,6,4,63,98,NA,19,53,56,445,426,422,404,15,18,0.3333333333333333,30108063.96
JARKKO.RUUTU,20072008,PIT,936.0833333333334,8,7,4,11,19,15,4,13,9,78,144,184,32,37,55,637,919,594,763,24,21,0.3076923076923077,30108111.03
JAROME.IGINLA,20072008,CGY,1916.6999999999998,54,32,21,53,107,86,261,485,224,365,599,117,111,49,30,2097,1265,1355,1050,78,50,0.5381443298969072,30108162.205
JAROMIR.JAGR,20072008,NYR,1876.65,30,32,24,56,86,62,1,3,2,286,538,33,132,45,33,2177,1154,1381,974,61,46,0.3333333333333333,30108120.29
JAROSLAV.HLINKA,20072008,COL,892.8666666666667,8,16,4,20,28,24,169,386,217,92,142,19,24,15,8,697,858,575,710,34,26,0.4378238341968912,30108110.86
JAROSLAV.MODRY,20072008,L.A,1132.35,1,1,4,5,6,2,0,1,1,39,87,37,33,2,21,772,1240,693,892,34,37,0,30108107.82
JAROSLAV.MODRY,20072008,PHI,570.35,0,2,4,6,6,2,0,0,0,23,46,18,14,1,4,464,529,328,360,10,27,0,30108049.16
JAROSLAV.SPACEK,20072008,BUF,1355.9333333333334,9,11,10,21,30,20,0,0,0,93,211,76,80,7,20,1274,1081,742,727,46,42,0,30108085.87
JARRET.STOLL,20072008,EDM,1453.25,14,11,10,21,35,25,675,1224,549,187,332,122,77,21,35,1186,1369,669,848,19,37,0.5514705882352942,30108143.46
JASON.ARNOTT,20072008,NSH,1573.7166666666667,29,19,25,44,73,48,635,1319,684,254,421,47,68,12,27,1643,1093,1016,880,67,42,0.48142532221379836,30108150.295
JASON.BLAKE,20072008,TOR,1459.5333333333333,15,26,10,36,51,41,14,28,14,330,534,54,113,34,NA,1659,1117,1071,876,49,39,0.5,NA
JASON.CHIMERA,20072008,CBJ,1417.0666666666666,14,10,7,17,31,24,16,35,19,198,306,73,56,37,35,1185,1174,856,816,29,32,0.45714285714285713,30108110.985
JASON.JAFFRAY,20072008,VAN,239.18333333333334,2,2,2,4,6,4,84,176,92,15,26,14,5,4,8,192,185,142,162,6,2,0.4772727272727273,30108035.950000003
JASON.KING,20072008,ANA,43.78333333333333,0,0,0,0,0,0,1,1,0,2,7,1,3,0,0,42,24,19,19,0,2,1,30108013.54
JASON.POMINVILLE,20072008,BUF,1608.4666666666667,25,29,23,52,77,54,24,66,42,220,380,30,79,25,8,1485,1327,827,855,51,36,0.36363636363636365,30108128.884999998
JASON.SMITH,20072008,PHI,1664.85,1,6,3,9,10,7,1,1,0,60,149,198,51,17,32,1184,1849,1030,1297,46,54,1,30108152.685000002
JASON.SPEZZA,20072008,OTT,1629.0666666666666,33,37,22,59,92,70,762,1490,728,217,377,20,75,24,26,1864,1266,1126,996,76,46,0.5114093959731544,30108171.32
JASON.STRUDWICK,20072008,NYR,692.5999999999999,1,0,1,1,2,1,0,0,0,21,46,71,17,8,14,504,633,462,519,13,15,0,30108066.255
JASON.WARD,20072008,T.B,990.9333333333334,8,4,2,6,14,12,18,45,27,85,147,48,32,7,17,681,910,550,630,15,36,0.4,30108087.939999998
JASON.WILLIAMS,20072008,CHI,694.05,13,13,9,22,35,26,7,10,3,96,148,26,30,7,9,645,462,351,393,23,23,0.7,30108068.674999997
JASSEN.CULLIMORE,20072008,FLA,1174.4166666666665,3,3,6,9,12,6,1,1,0,55,100,77,33,6,19,898,1169,772,807,34,23,1,30108094.25
JAY.BOUWMEESTER,20072008,FLA,2251.5,15,12,7,19,34,27,0,0,0,182,332,105,88,7,35,2000,2142,1307,1329,56,57,0,30108156.445
JAY.LEACH,20072008,T.B,9.233333333333333,0,0,0,0,0,0,0,0,0,0,1,1,1,0,0,8,9,8,8,0,0,0,15054006.65
JAY.MCCLEMENT,20072008,STL,1127.5333333333333,9,7,6,13,22,16,366,700,334,110,172,62,28,15,NA,684,1116,607,793,27,45,0.5228571428571429,NA
JAY.MCKEE,20072008,STL,1180.9166666666667,2,3,4,7,9,5,0,0,0,42,80,72,22,10,21,754,1185,654,809,31,32,0,30108101.4
JAY.PANDOLFO,20072008,N.J,1013.9666666666667,12,4,8,12,24,16,3,7,4,91,145,39,27,6,12,646,969,541,615,26,21,0.42857142857142855,30108087.03
JED.ORTMEYER,20072008,NSH,635.1333333333333,4,2,2,4,8,6,6,12,6,68,118,63,17,10,13,384,546,331,371,9,19,0.5,30108056.939999998
JEFF.CARTER,20072008,PHI,1885.3666666666668,35,21,7,28,63,56,799,1704,905,332,586,72,124,22,28,1796,1799,1179,1195,47,46,0.4688967136150235,30108201.505
JEFF.COWAN,20072008,VAN,401.98333333333335,0,1,0,1,1,1,0,1,1,35,56,67,11,23,27,234,385,226,354,5,10,0,30108058.03
JEFF.FINGER,20072008,COL,1547.0666666666666,8,7,5,12,20,15,1,1,0,100,201,131,62,13,19,1159,1439,966,1085,57,51,1,30108126.395
JEFF.GIULIANO,20072008,L.A,625.7333333333333,0,4,2,6,6,4,108,238,130,30,52,68,8,6,7,304,753,273,471,10,21,0.453781512605042,30108076.68
JEFF.HALPERN,20072008,DAL,1046.9166666666667,10,8,6,14,24,18,295,546,251,86,170,55,44,20,20,715,881,565,587,24,26,0.5402930402930403,30108090.55
JEFF.HALPERN,20072008,T.B,345.8666666666667,10,6,2,8,18,16,85,185,100,46,71,26,19,5,7,307,269,217,183,11,5,0.4594594594594595,30108042.1
JEFF.HOGGAN,20072008,BOS,3.4333333333333336,0,0,0,0,0,0,0,0,0,0,0,2,0,0,0,0,7,0,2,0,0,0,15054006.3
JEFF.SCHULTZ,20072008,WSH,1323.3666666666668,5,6,6,12,17,11,1,1,0,36,103,61,44,4,14,1030,1199,909,775,42,39,1,30108081.08
JEFF.TAFFE,20072008,PIT,431.3666666666667,5,2,5,7,12,7,74,152,78,56,98,52,19,7,3,346,424,244,374,10,7,0.4868421052631579,30108063.005000003
JEFF.TAMBELLINI,20072008,NYI,313.9,1,1,2,3,4,2,0,0,0,41,54,19,6,5,4,264,283,236,262,6,14,0,30108041.8
JEFF.WOYWITKA,20072008,STL,433.83333333333337,2,0,4,4,6,2,0,0,0,25,49,15,14,1,6,355,382,327,335,15,13,0,30108045.41
JEFFREY.HAMILTON,20072008,CAR,626.2,9,7,8,15,24,16,38,79,41,115,223,16,62,5,4,775,466,265,336,9,10,0.4810126582278481,30108057.32
JERE.LEHTINEN,20072008,DAL,1201.1333333333334,19,15,11,26,45,34,1,12,11,147,253,27,56,12,8,1088,749,675,491,31,16,0.08333333333333333,30108070.435
JEREMY.COLLITON,20072008,NYI,140.28333333333333,0,0,0,0,0,0,54,104,50,16,24,12,3,3,4,98,139,89,78,1,5,0.5192307692307693,30108022.04
JEREMY.REICH,20072008,BOS,520.7666666666667,2,1,0,1,3,3,17,35,18,42,75,58,12,17,24,342,467,98,99,1,3,0.4857142857142857,30108028.55
JEREMY.ROENICK,20072008,S.J,1122.75,16,12,10,22,38,28,97,222,125,109,175,NA,24,10,13,1066,689,738,599,32,33,0.4369369369369369,30108087.880000003
JEREMY.WILLIAMS,20072008,TOR,132.13333333333333,2,0,0,0,2,2,0,4,4,16,29,11,7,1,3,117,113,69,89,2,3,0,30108023.41
JERRED.SMITHSON,20072008,NSH,1049.7833333333333,7,6,3,9,16,13,324,631,307,66,113,140,28,16,19,530,1056,444,636,13,28,0.5134706814580031,30108105.895
JESSE.BOULERICE,20072008,PHI,19.333333333333332,0,0,0,0,0,0,0,0,0,1,2,4,1,4,6,9,14,9,13,0,2,0,30108014.34
JESSE.WINCHESTER,20072008,OTT,14,0,0,0,0,0,0,0,0,0,1,1,1,0,0,1,9,10,0,0,0,0,0,15054006.2
JIM.SLATER,20072008,ATL,717.05,8,3,2,5,13,11,190,366,176,95,144,84,28,20,NA,472,799,442,632,13,25,0.5191256830601093,NA
JIRI.HUDLER,20072008,DET,1321.7333333333333,18,23,15,38,56,41,10,26,16,177,272,33,34,18,19,1503,697,1010,626,43,29,0.38461538461538464,30108082.805
JIRI.NOVOTNY,20072008,CBJ,1151.1999999999998,8,7,7,14,22,15,375,788,413,90,145,NA,28,9,12,891,886,568,570,20,32,0.47588832487309646,30108095.165
JIRI.TLUSTY,20072008,TOR,633.0833333333334,10,3,3,6,16,13,1,2,1,69,127,NA,27,9,7,578,547,486,476,18,27,0.5,30108065.855
JOAKIM.LINDSTROM,20072008,CBJ,235.83333333333331,3,2,2,4,7,5,2,7,5,25,45,9,7,3,7,219,151,154,143,7,7,0.2857142857142857,30108029.560000002
JOCHEN.HECHT,20072008,BUF,1423,22,12,13,25,47,34,369,880,511,224,354,46,52,24,18,1204,1330,822,853,43,38,0.4193181818181818,30108143.575
JODY.SHELLEY,20072008,CBJ,134.4,0,0,0,0,0,0,0,1,1,10,15,30,3,9,13,76,103,75,98,1,3,0,30108024.939999998
JODY.SHELLEY,20072008,S.J,248.83333333333331,1,2,3,5,6,3,0,1,1,32,45,67,6,12,23,208,168,200,167,8,10,0,30108032.195
JOE.CORVO,20072008,CAR,477.76666666666665,7,6,7,13,20,13,0,0,0,56,106,6,35,5,4,588,311,294,244,14,9,0,30108038.725
JOE.CORVO,20072008,OTT,899.5166666666667,6,11,10,21,27,17,0,0,0,110,236,25,90,14,9,1030,623,652,522,38,24,0,30108056.490000002
JOE.DIPENTA,20072008,ANA,245.01666666666665,1,1,3,4,5,2,0,0,0,5,16,10,7,7,5,152,167,128,114,10,9,0,30108022.695
JOE.JENSEN,20072008,CAR,38.583333333333336,1,0,0,0,1,1,6,14,8,6,7,3,0,1,1,22,32,19,32,3,2,0.42857142857142855,30108016.9
JOE.MOTZKO,20072008,WSH,99.63333333333334,2,2,0,2,4,4,0,3,3,10,14,4,2,0,0,99,67,67,63,5,6,0,30108020.200000003
JOE.PAVELSKI,20072008,S.J,1441.9833333333333,24,17,7,24,48,41,NA,653,NA,250,398,NA,68,30,12,1351,1015,867,793,33,28,NA,NA
JOE.SAKIC,20072008,COL,1070.7166666666667,15,18,17,35,50,33,365,724,359,154,255,11,64,13,10,1002,773,534,630,32,39,0.5041436464088398,30108110.705
JOE.THORNTON,20072008,S.J,2071.3500000000004,31,46,29,75,106,77,909,1720,811,206,368,80,100,47,25,2196,1264,1311,971,72,38,0.5284883720930232,30108161.455
JOEL.KWIATKOWSKI,20072008,ATL,301.33333333333337,0,0,5,5,5,0,0,0,0,24,45,9,12,1,10,241,269,219,241,8,13,0,30108037.285
JOEL.LUNDQVIST,20072008,DAL,888.2333333333333,5,11,5,16,21,16,107,226,119,66,120,153,27,12,15,662,624,606,563,23,27,0.47345132743362833,30108079.125
JOEL.PERRAULT,20072008,ARI,707.4833333333333,7,6,4,10,17,13,294,599,305,87,146,42,33,16,21,692,596,527,531,19,25,0.49081803005008345,30108085.97
JOEY.MORMINA,20072008,CAR,7.75,0,0,0,0,0,0,0,0,0,1,2,4,0,0,0,8,5,8,5,0,0,0,15054006.4
JOFFREY.LUPUL,20072008,PHI,1294.85,24,18,14,32,56,42,3,4,1,222,364,107,68,23,15,1291,1175,758,877,40,36,0.75,30108130.8
JOHAN.FRANZEN,20072008,DET,1576.85,39,10,6,16,55,49,210,435,225,266,407,118,44,36,29,1612,997,1067,699,47,20,0.4827586206896552,30108110.259999998
JOHN-MICHAEL.LILES,20072008,COL,1784.8500000000001,8,13,16,29,37,21,0,0,0,184,356,63,102,20,14,1740,1198,1063,1020,57,46,0,30108113.45
JOHN.ERSKINE,20072008,WSH,921.1333333333333,2,5,3,8,10,7,0,0,0,56,127,120,51,13,NA,753,871,692,649,27,29,0,NA
JOHN.HILLEN III,20072008,NYI,15.65,0,0,0,0,0,0,0,0,0,1,1,1,0,0,1,20,16,18,14,0,0,0,15054007.4
JOHN.MADDEN,20072008,N.J,1661.8,22,16,8,24,46,38,851,1587,736,199,320,54,57,16,NA,1082,1623,790,954,41,40,0.5362318840579711,NA
JOHN.ODUYA,20072008,N.J,119.66666666666666,0,0,0,0,0,0,0,0,0,1,10,6,6,2,NA,102,93,85,62,4,4,0,NA
JOHN.PEVERLEY,20072008,NSH,7.033333333333333,0,0,0,0,0,0,0,0,0,1,1,2,0,0,0,5,5,5,5,0,0,0,15054006.55
JOHN.POHL,20072008,TOR,234.2,1,2,2,4,5,3,41,94,53,23,47,28,13,1,5,202,192,174,177,6,10,0.43617021276595747,30108033.1
JOHN.ZEILER,20072008,L.A,305.33333333333337,0,0,1,1,1,0,12,31,19,18,31,102,5,9,10,167,273,161,259,3,9,0.3870967741935484,30108044.994999997
JOHNNY.BOYCHUK,20072008,COL,35.766666666666666,0,0,0,0,0,0,0,1,1,3,7,9,4,0,0,28,21,20,21,0,0,0,30108013.75
JOHNNY.ODUYA,20072008,N.J,1408.85,5,11,9,20,25,16,0,0,0,63,169,73,71,8,22,1310,980,907,730,38,27,0,30108076.555
JON.KLEMM,20072008,L.A,240.93333333333334,0,0,0,0,0,0,2,2,0,6,10,34,2,3,5,106,307,90,209,3,10,1,30108039.16
JONATHAN.CHEECHOO,20072008,S.J,1381.9,27,10,8,18,45,37,5,26,21,254,391,160,56,33,25,1452,827,954,703,45,24,0.19230769230769232,30108097.380000003
JONATHAN.ERICSSON,20072008,DET,127.73333333333333,1,0,0,0,1,1,0,0,0,19,29,9,5,1,2,112,78,84,61,2,5,0,30108017.86
JONATHAN.FILEWICH,20072008,PIT,43.46666666666667,0,0,0,0,0,0,0,0,0,3,6,2,2,0,0,20,44,19,44,0,2,0,30108017.5
JONATHAN.SIM,20072008,NYI,28.616666666666667,0,0,1,1,1,0,0,0,0,6,6,4,0,1,1,25,15,17,12,0,2,0,30108013.485
JONATHAN.TOEWS,20072008,CHI,1194.6000000000001,24,12,18,30,54,36,505,948,443,143,214,27,41,25,21,1055,836,628,621,47,33,0.5327004219409283,30108112.950000003
JONI.PITKANEN,20072008,EDM,1519.7166666666667,8,8,10,18,26,16,0,0,0,101,203,32,62,11,28,1325,1359,890,982,50,50,0,30108118.11
JORDAN.HENDRY,20072008,CHI,688.4333333333334,1,0,1,1,2,1,0,0,0,31,53,46,13,13,11,422,638,382,489,24,23,0,30108064.805
JORDAN.LAVALLEE-SMOTHERMAN,20072008,ATL,22.916666666666668,1,1,0,1,2,2,0,0,0,1,2,6,0,0,0,11,27,10,26,2,0,0,30108016.4
JORDAN.LEOPOLD,20072008,COL,806.3499999999999,5,2,8,10,15,7,0,0,0,40,82,34,23,5,10,705,621,576,534,27,22,0,30108064.549999997
JORDAN.STAAL,20072008,PIT,1863.0333333333333,18,12,5,17,35,30,659,1495,836,216,356,131,62,45,32,1358,1879,972,1147,33,36,0.4408026755852843,30108192.035
JORDIN.TOOTOO,20072008,NSH,698.5333333333333,13,5,2,7,20,18,2,4,2,110,211,77,52,41,33,653,580,608,549,20,27,0.5,30108076.09
JOSEF.VASICEK,20072008,NYI,1264.75,15,11,7,18,33,26,606,1085,479,123,229,73,49,15,26,1229,1094,922,797,32,24,0.5585253456221199,30108118.465
JOSH.GORGES,20072008,MTL,1230.2166666666667,0,5,6,11,11,5,0,0,0,48,103,90,28,10,13,921,1242,736,930,30,37,0,30108113.65
JOSH.GRATTON,20072008,ARI,9.666666666666666,0,0,0,0,0,0,0,0,0,0,1,4,0,1,1,7,6,7,6,1,0,0,15054006.56
JOSH.HENNESSY,20072008,OTT,18.799999999999997,0,0,0,0,0,0,5,12,7,2,2,1,0,1,0,11,16,6,14,0,1,0.4166666666666667,30108014.21
JOSH.LANGFELD,20072008,NSH,26.083333333333332,0,0,0,0,0,0,0,0,0,5,7,3,1,1,0,20,21,19,21,0,0,0,15054008.31
JOZEF.STUMPEL,20072008,FLA,903.2,7,7,5,12,19,14,329,642,313,64,118,38,25,10,5,823,770,501,552,16,23,0.5124610591900312,30108089.134999998
JUNIOR.LESSARD,20072008,DAL,24.166666666666668,0,0,0,0,0,0,0,0,0,3,4,3,0,0,1,22,16,15,16,0,1,0,15054007.95
JUNIOR.LESSARD,20072008,T.B,183.08333333333334,1,1,0,1,2,2,0,0,0,18,32,37,5,3,3,113,159,98,145,3,7,0,30108030.28
JUSSI.JOKINEN,20072008,DAL,671.4666666666667,14,7,7,14,28,21,153,283,130,92,156,9,39,10,8,647,425,444,376,25,20,0.5406360424028268,30108061.645000003
JUSSI.JOKINEN,20072008,T.B,378.8833333333333,2,7,4,11,13,9,21,46,25,38,66,6,15,0,3,405,308,249,248,7,19,0.45652173913043476,30108042.39
JUSTIN.ABDELKADER,20072008,DET,24.433333333333334,0,0,0,0,0,0,5,12,7,6,8,5,0,0,1,19,19,19,17,1,1,0.4166666666666667,15054008.2
JUSTIN.WILLIAMS,20072008,CAR,713.8833333333333,9,10,11,21,30,19,5,13,8,106,184,43,42,14,20,767,610,505,400,24,18,0.38461538461538464,30108058.265
KAMIL.KREPS,20072008,FLA,986.4666666666667,8,6,11,17,25,14,411,763,352,98,150,45,32,11,NA,772,979,594,666,25,20,0.5386631716906947,NA
KAREL.RACHUNEK,20072008,N.J,911.25,4,5,4,9,13,9,0,0,0,68,140,62,41,5,18,854,616,546,455,27,28,0,30108054.75
KARL.STEWART,20072008,T.B,36.96666666666667,0,0,0,0,0,0,0,0,0,2,4,6,0,0,1,16,26,14,22,1,2,0,30108014.700000003
KARLIS.SKRASTINS,20072008,COL,775.55,1,1,2,3,4,2,0,0,0,32,82,25,33,4,10,533,787,504,572,21,19,0,30108069.04
KARLIS.SKRASTINS,20072008,FLA,340.9,1,0,0,0,1,1,0,0,0,11,34,17,11,2,6,261,368,239,264,7,15,0,30108039.12
KEITH.AUCOIN,20072008,CAR,511.45,5,4,4,8,13,9,124,327,203,65,118,34,27,16,5,568,338,407,275,16,13,0.37920489296636084,30108045.52
KEITH.BALLARD,20072008,ARI,1743.5666666666666,6,9,6,15,21,15,0,0,0,105,208,169,64,25,37,1299,1821,1062,1209,48,43,0,30108144.1
KEITH.CARNEY,20072008,MIN,897.5833333333334,2,5,4,9,11,7,0,0,0,29,65,40,19,8,17,759,742,698,618,27,25,0,30108071.43
KEITH.TKACHUK,20072008,STL,1331.35,27,16,15,31,58,43,551,1114,563,176,297,92,49,31,31,1271,953,769,794,43,38,0.49461400359066426,30108144.075000003
KEITH.YANDLE,20072008,ARI,605.15,5,3,4,7,12,8,0,0,0,72,128,13,37,6,7,642,493,504,451,15,25,0,30108056.810000002
KEN.KLEE,20072008,ATL,1443.3333333333335,1,3,5,8,9,4,0,0,0,56,126,78,51,9,NA,1013,1380,865,997,39,50,0,NA
KENT.HUSKINS,20072008,ANA,1309.9,4,7,9,16,20,11,0,0,0,48,122,68,44,13,25,967,987,771,789,42,24,0,30108092.505000003
KEVIN.BIEKSA,20072008,VAN,795.3166666666666,2,3,6,9,11,5,0,0,0,64,153,52,51,12,24,659,700,409,482,16,27,0,30108064.22
KEVIN.DALLMAN,20072008,L.A,438.2,3,1,2,3,6,4,0,2,2,41,94,42,21,3,2,421,360,366,345,13,7,0,30108045.630000003
KEVIN.DOELL,20072008,ATL,77.31666666666668,0,1,0,1,1,1,25,53,28,6,6,7,0,0,2,39,70,35,59,1,3,0.4716981132075472,30108021.25
KEVIN.KLEIN,20072008,NSH,187.23333333333335,0,2,0,2,2,2,0,0,0,14,25,7,5,1,3,126,149,118,130,4,7,0,30108026.509999998
KEVYN.ADAMS,20072008,CHI,285.7833333333333,0,1,1,2,2,1,98,196,98,31,41,13,3,6,5,146,252,127,142,2,11,0.5,30108033.105
KIM.JOHNSSON,20072008,MIN,1998.5333333333333,4,13,9,22,26,17,0,0,0,99,212,49,64,15,26,1561,1763,1125,1192,51,56,0,30108136.925
KIMMO.TIMONEN,20072008,PHI,2206.1833333333334,8,17,24,41,49,25,0,0,0,149,288,85,78,9,29,2094,1921,1116,1163,40,44,0,30108141.59
KIP.BRENNAN,20072008,NYI,13.066666666666666,0,0,0,0,0,0,0,0,0,0,0,9,0,1,2,6,10,6,10,0,0,0,30108013.509999998
KIRK.MALTBY,20072008,DET,852.8833333333334,6,4,1,5,11,10,3,7,4,80,133,120,29,23,21,595,639,540,481,14,24,0.42857142857142855,30108064.725
KRIS.BEECH,20072008,CBJ,207.95,5,3,1,4,9,8,109,205,96,24,32,22,5,5,1,185,126,125,109,4,4,0.5317073170731708,30108031.085
KRIS.BEECH,20072008,PIT,41.2,0,0,0,0,0,0,17,34,17,6,6,8,0,1,1,39,40,26,35,1,1,0.5,30108016.939999998
KRIS.BEECH,20072008,VAN,38.43333333333334,1,1,0,1,2,2,18,37,19,6,7,3,1,0,0,30,24,25,19,2,1,0.4864864864864865,30108015.47
KRIS.DRAPER,20072008,DET,1356.0833333333333,12,7,1,8,20,19,776,1289,513,134,228,127,41,18,38,966,1135,811,757,21,31,0.6020170674941815,30108118.494999997
KRIS.LETANG,20072008,PIT,1417.5666666666666,6,4,9,13,19,10,0,0,0,82,186,103,56,19,16,1272,1224,881,991,41,28,0,30108115.814999998
KRIS.NEWBURY,20072008,TOR,122.48333333333333,1,1,0,1,2,2,22,54,32,14,17,23,1,7,9,94,96,80,83,2,8,0.4074074074074074,30108024.75
KRIS.RUSSELL,20072008,CBJ,989.9666666666667,2,2,4,6,8,4,0,0,0,89,175,NA,56,4,7,991,592,643,509,18,26,0,30108053.439999998
KRIS.VERSTEEG,20072008,CHI,206.53333333333333,2,1,1,2,4,3,2,3,1,21,33,15,7,3,3,183,152,133,132,6,7,0.6666666666666666,30108026.785
KRISTIAN.HUSELIUS,20072008,CGY,1530.1166666666668,25,29,16,45,70,54,1,4,3,205,330,12,69,21,23,1667,974,1075,828,54,44,0.25,30108112.700000003
KRYS.BARCH,20072008,DAL,NA,1,1,1,2,3,2,0,2,2,22,38,73,6,21,23,242,227,202,210,6,10,0,30108037.785
KURT.SAUER,20072008,COL,1203.0166666666667,2,1,4,5,7,3,0,0,0,33,77,51,25,9,23,698,1192,631,789,35,27,0,30108097.240000002
KURTIS.FOSTER,20072008,MIN,901.4666666666667,6,7,4,11,17,13,2,3,1,114,224,NA,66,9,16,873,676,596,533,25,25,0.6666666666666666,30108065.07
KYLE.BRODZIAK,20072008,EDM,1033.4,14,13,4,17,31,27,151,295,144,123,217,40,42,15,9,728,1040,653,739,35,44,0.511864406779661,30108109.240000002
KYLE.CALDER,20072008,L.A,844.8833333333333,7,8,5,13,20,15,7,18,11,70,119,26,20,17,NA,810,622,492,574,21,27,0.3888888888888889,NA
KYLE.CHIPCHURA,20072008,MTL,409.35,4,4,3,7,11,8,139,317,178,36,64,21,22,9,2,317,493,266,330,9,13,0.4384858044164038,30108058.475
KYLE.CUMISKEY,20072008,COL,460.8833333333333,0,1,3,4,4,1,0,0,0,19,39,7,12,8,7,389,316,326,298,14,17,0,30108039.355
KYLE.GREENTREE,20072008,PHI,18.383333333333333,0,0,0,0,0,0,0,0,0,3,7,2,1,1,0,26,18,24,18,0,1,0,30108013.509999998
KYLE.MCLAREN,20072008,S.J,1167.95,3,0,7,7,10,3,0,0,0,39,99,132,37,22,39,919,988,764,703,39,35,0,30108078.495
KYLE.OKPOSO,20072008,NYI,148.15,2,2,1,3,5,4,0,0,0,15,27,5,8,2,1,139,144,103,125,4,1,0,30108027.295
KYLE.QUINCEY,20072008,DET,83.83333333333334,0,0,0,0,0,0,0,0,0,5,10,12,2,1,2,61,72,57,48,0,3,0,30108016.61
KYLE.TURRIS,20072008,ARI,59.266666666666666,0,1,0,1,1,1,17,42,25,11,15,0,2,0,1,53,57,41,50,0,3,0.40476190476190477,30108019.48
KYLE.WANVIG,20072008,T.B,70.9,1,0,0,0,1,1,1,1,0,10,15,12,3,1,2,63,67,63,66,3,4,1,30108019.35
KYLE.WELLWOOD,20072008,TOR,746.1,8,9,4,13,21,17,178,325,147,56,105,NA,19,11,0,779,489,447,369,12,19,0.5476923076923077,30108059.68
LADISLAV.NAGY,20072008,L.A,524.3166666666667,9,8,9,17,26,17,43,82,39,78,135,28,27,13,9,576,396,381,363,18,18,0.524390243902439,30108058.925
LADISLAV.SMID,20072008,EDM,1160.9833333333333,0,2,1,3,3,2,0,0,0,45,83,91,22,11,20,792,1199,713,869,30,44,0,30108105.435000002
LASSE.KUKKONEN,20072008,PHI,1049.2666666666667,1,0,6,6,7,1,0,0,0,37,87,64,30,14,22,775,1152,634,835,25,30,0,30108103.740000002
LAURI.KORPIKOSKI,20072008,NYR,7.233333333333333,1,0,0,0,1,1,0,1,1,2,2,2,0,0,0,5,9,5,8,1,0,0,15054007.65
LAURI.TUKONEN,20072008,L.A,9.8,0,0,0,0,0,0,0,0,0,1,1,1,0,0,0,7,5,7,5,0,0,0,15054006.45
LAWRENCE.NYCHOLAT,20072008,OTT,35.83333333333333,0,0,0,0,0,0,0,0,0,4,5,4,1,1,0,20,23,17,23,1,0,0,30108014.509999998
LEE.STEMPNIAK,20072008,STL,1270.7833333333333,13,17,8,25,38,30,4,11,7,162,293,103,65,16,19,1150,975,761,793,32,33,0.36363636363636365,30108108.82
LIAM.REDDOX,20072008,EDM,5.916666666666667,0,0,0,0,0,0,0,0,0,1,2,1,1,1,0,6,5,6,5,0,1,0,15054006.36
LOUI.ERIKSSON,20072008,DAL,1295.5833333333333,18,15,6,21,39,33,3,15,12,150,252,31,47,19,19,1169,846,950,771,43,41,0.2,30108099.06
LUBOMIR.VISNOVSKY,20072008,L.A,1886.05,8,15,17,32,40,23,1,8,7,152,338,60,109,17,NA,1885,1467,1123,1176,53,68,0.125,NA
LUC.BOURDON,20072008,VAN,347.6166666666667,2,0,0,0,2,2,0,0,0,26,47,18,12,5,7,266,301,213,275,12,5,0,30108042.8
LUKAS.KASPAR,20072008,S.J,36.733333333333334,0,0,0,0,0,0,0,1,1,5,8,3,3,0,0,44,28,41,27,1,2,0,30108013.7
LUKAS.KRAJICEK,20072008,VAN,708.4333333333333,2,6,3,9,11,8,0,0,0,28,66,27,19,1,18,549,564,376,432,22,24,0,30108060.884999998
LUKE.RICHARDSON,20072008,OTT,924.3833333333334,2,3,2,5,7,5,0,0,0,40,87,64,30,5,15,800,782,719,700,37,33,0,30108078.5
MAGNUS.JOHANSSON,20072008,CHI,245.88333333333333,0,2,2,4,4,2,0,0,0,12,29,4,11,3,2,231,140,150,104,10,11,0,30108019.130000003
MAGNUS.JOHANSSON,20072008,FLA,444.75,0,2,6,8,8,2,0,0,0,21,50,19,21,1,7,418,371,297,285,10,8,0,30108038.91
MANNY.MALHOTRA,20072008,CBJ,1168.1666666666667,11,13,5,18,29,24,680,1155,475,112,183,64,40,14,15,962,965,731,654,29,30,0.5887445887445888,30108103.365000002
MARC-ANDRE.BERGERON,20072008,ANA,115.53333333333335,0,1,0,1,1,1,0,0,0,12,27,7,6,1,2,91,82,70,78,1,3,0,30108020.61
MARC-ANDRE.BERGERON,20072008,NYI,822.3833333333333,9,4,5,9,18,13,0,0,0,92,185,20,67,6,7,875,605,491,478,18,26,0,30108060.985
MARC-ANDRE.GRAGNANI,20072008,BUF,12.583333333333332,0,0,0,0,0,0,0,0,0,1,2,2,1,0,2,7,14,4,12,0,3,0,15054007.8
MARC-ANTOINE.POULIOT,20072008,EDM,248.08333333333331,1,4,2,6,7,5,21,44,23,32,60,23,11,3,4,219,201,203,185,9,11,0.4772727272727273,30108032.82
MARC-EDOUARD.VLASIC,20072008,S.J,2089.4,2,6,7,13,15,8,0,0,0,87,209,33,65,10,11,1574,1771,1264,1198,40,49,0,30108124.075
MARC.METHOT,20072008,CBJ,128.06666666666666,0,0,0,0,0,0,0,0,0,9,18,16,6,3,2,95,87,93,75,5,7,0,30108017.73
MARC.SAVARD,20072008,BOS,1638.3,16,32,35,67,83,48,866,1677,811,210,365,41,90,20,35,1689,1288,416,379,19,18,0.5163983303518187,30108110.965
MARC.STAAL,20072008,NYR,1726.9,3,8,1,9,12,11,0,0,0,89,211,151,69,9,18,1424,1421,1195,985,46,38,0,30108096.564999998
MARCEL.GOC,20072008,S.J,577.0833333333334,5,3,0,3,8,8,115,224,109,90,135,52,18,11,7,422,431,348,326,13,20,0.5133928571428571,30108053.96
MARCEL.HOSSA,20072008,ARI,163.13333333333333,0,0,0,0,0,0,2,10,8,12,19,32,1,3,2,122,157,113,120,3,8,0.2,30108025.060000002
MARCEL.HOSSA,20072008,NYR,525.5833333333334,1,5,2,7,8,6,1,5,4,54,86,62,14,10,11,445,441,396,310,15,8,0.2,30108042.59
MARCO.STURM,20072008,BOS,1559.7666666666667,29,21,10,31,60,50,9,34,25,250,370,59,51,23,NA,1488,1182,353,273,11,11,0.2647058823529412,NA
MARCUS.NILSON,20072008,CGY,469.2833333333333,3,0,2,2,5,3,22,45,23,47,74,6,16,8,2,317,360,275,266,9,7,0.4888888888888889,30108040.310000002
MAREK.MALIK,20072008,NYR,808.1166666666667,2,4,3,7,9,6,0,0,0,34,88,40,35,6,NA,644,719,568,491,30,18,0,NA
MAREK.SVATOS,20072008,COL,846.5833333333333,26,6,5,11,37,32,1,3,2,139,208,36,25,10,16,822,622,563,562,32,17,0.3333333333333333,30108091.015
MAREK.ZIDLICKY,20072008,NSH,1759.7166666666667,5,17,24,41,46,22,0,0,0,133,260,88,87,14,34,1797,1234,1126,1008,50,46,0,30108112.89
MARIAN.GABORIK,20072008,MIN,1601.2,42,29,12,41,83,71,6,22,16,298,485,NA,79,43,27,1481,1278,874,1024,56,43,0.2727272727272727,30108168.02
MARIAN.HOSSA,20072008,ATL,1313.95,26,20,10,30,56,46,4,14,10,227,348,54,66,27,15,1071,1117,576,734,27,39,0.2857142857142857,30108123.63
MARIAN.HOSSA,20072008,PIT,642.6666666666667,15,10,11,21,36,25,0,4,4,111,180,41,34,5,9,721,546,415,441,21,15,0,30108073.125
MARK.BELL,20072008,TOR,341.0333333333333,4,2,4,6,10,6,74,179,105,42,75,28,12,10,20,295,289,220,260,15,14,0.4134078212290503,30108049.86
MARK.EATON,20072008,PIT,707,0,1,2,3,3,1,0,0,0,28,48,17,12,1,1,452,752,368,426,16,15,0,30108055.56
MARK.FISTRIC,20072008,DAL,604.9333333333334,0,0,2,2,2,0,0,0,0,20,50,104,14,4,15,460,472,433,381,16,16,0,30108046.439999998
MARK.HARTIGAN,20072008,DET,185.95,3,0,2,2,5,3,66,130,64,19,29,28,4,2,9,147,120,144,116,6,8,0.5076923076923077,30108027.81
MARK.MOWERS,20072008,ANA,153.66666666666669,1,0,0,0,1,1,22,45,23,6,10,6,2,5,5,130,71,79,59,3,3,0.4888888888888889,30108018.88
MARK.PARRISH,20072008,MIN,963.6,16,7,7,14,30,23,4,10,6,94,153,32,16,15,10,849,778,489,545,25,21,0.4,30108085.335
MARK.POPOVIC,20072008,ATL,477.6166666666667,0,0,2,2,2,0,0,0,0,25,45,22,11,3,5,326,426,310,379,12,15,0,30108052.08
MARK.RECCHI,20072008,ATL,973.1166666666668,12,18,9,27,39,30,23,49,26,84,126,51,22,8,10,780,820,416,664,24,40,0.46938775510204084,30108109.725
MARK.RECCHI,20072008,PIT,311.73333333333335,2,2,4,6,8,4,4,9,5,36,53,20,7,3,6,310,246,196,217,6,7,0.4444444444444444,30108038.54
MARK.SMITH,20072008,CGY,320.45000000000005,1,2,1,3,4,3,30,56,26,27,52,44,11,18,16,210,237,203,215,5,11,0.5357142857142857,30108038.505
MARK.STREIT,20072008,MTL,1578.8333333333335,14,24,28,52,66,38,1,2,1,184,358,69,108,15,NA,1725,1253,763,887,34,43,0.5,NA
MARK.STUART,20072008,BOS,1364.5,4,4,0,4,8,8,0,0,0,64,158,109,66,17,29,1081,1240,369,382,9,18,0,30108052.32
MARKUS.NASLUND,20072008,VAN,1422.9833333333333,25,13,16,29,54,38,0,1,1,236,381,13,66,23,23,1445,964,913,794,43,44,0,30108110.48
MARTIN.ERAT,20072008,NSH,1543.4666666666667,24,19,18,37,61,43,18,48,30,176,281,55,50,28,22,1533,1168,998,885,44,45,0.375,30108123.05
MARTIN.GELINAS,20072008,NSH,803.7,9,9,2,11,20,18,11,22,11,109,167,50,18,14,10,705,680,594,512,21,17,0.5,30108072.18
MARTIN.HANZAL,20072008,ARI,1205.8,8,17,9,26,34,25,468,1015,547,110,187,98,36,25,15,1120,919,732,690,29,31,0.46108374384236456,30108115.445
MARTIN.HAVLAT,20072008,CHI,630.8166666666666,10,9,8,17,27,19,0,3,3,84,116,5,17,15,11,558,391,337,296,24,13,0,30108052.1
MARTIN.LAPOINTE,20072008,CHI,440.06666666666666,3,2,2,4,7,5,9,22,13,37,59,41,15,8,12,286,344,247,250,7,11,0.4090909090909091,30108041.490000002
MARTIN.LAPOINTE,20072008,OTT,242.01666666666665,3,0,3,3,6,3,0,0,0,30,50,45,13,5,8,238,168,149,133,6,7,0,30108026.725
MARTIN.LOJEK,20072008,FLA,12.266666666666667,0,0,0,0,0,0,0,0,0,2,2,1,0,0,0,16,9,16,9,0,1,0,15054006.65
MARTIN.RUCINSKY,20072008,STL,600.4333333333334,5,8,3,11,16,13,7,13,6,67,107,19,15,10,20,490,474,311,369,13,18,0.5384615384615384,30108062.405
MARTIN.SKOULA,20072008,MIN,1750.5166666666667,3,2,5,7,10,5,0,0,0,63,132,NA,46,8,13,1242,1664,1055,1188,34,58,0,30108134.205
MARTIN.ST. LOUIS,20072008,T.B,1991.2833333333333,25,38,20,58,83,63,3,12,9,241,412,34,75,31,11,1927,1629,1147,1208,62,72,0.25,30108169.630000003
MARTIN.ST. PIERRE,20072008,CHI,76.4,0,0,0,0,0,0,33,59,26,2,3,3,1,2,0,59,52,29,43,1,4,0.559322033898305,30108017.79
MARTIN.STRAKA,20072008,NYR,1408.0666666666666,17,18,15,33,50,35,9,22,13,128,227,28,41,16,NA,1398,1016,907,713,46,38,0.4090909090909091,NA
MARTY.REASONER,20072008,EDM,1226.8,11,8,6,14,25,19,478,906,428,112,207,23,41,14,25,877,1266,726,844,27,46,0.5275938189845475,30108130.759999998
MASON.RAYMOND,20072008,VAN,613.65,9,8,4,12,21,17,24,63,39,80,130,23,26,14,1,554,442,355,378,19,15,0.38095238095238093,30108061.2
MATHIAS.TJARNQVIST,20072008,ARI,1063.9833333333333,4,4,3,7,11,8,15,46,31,90,159,86,29,21,14,672,1143,608,726,23,21,0.32608695652173914,30108096.134999998
MATHIEU.DANDENAULT,20072008,MTL,758.0333333333333,9,3,2,5,14,12,0,1,1,82,137,81,20,3,13,579,879,511,697,14,28,0,30108100.130000003
MATHIEU.DARCHE,20072008,T.B,1053.1333333333332,7,10,5,15,22,17,43,89,46,120,205,125,46,12,11,913,855,719,635,25,31,0.48314606741573035,30108081.064999998
MATHIEU.ROY,20072008,EDM,135.06666666666666,0,0,1,1,1,0,0,0,0,8,15,7,6,5,5,111,110,111,105,6,6,0,30108021.674999997
MATHIEU.SCHNEIDER,20072008,ANA,1572.0833333333335,13,16,11,27,40,29,0,0,0,146,323,88,95,8,28,1410,1042,839,820,41,26,0,30108102.955
MATS.SUNDIN,20072008,TOR,1479.7,32,28,18,46,78,60,936,1700,764,257,445,33,90,32,32,1687,1231,957,850,54,37,0.5505882352941176,30108156.009999998
MATT.BRADLEY,20072008,WSH,851.3333333333333,7,9,4,13,20,16,15,34,19,119,190,146,39,29,23,711,667,664,566,20,26,0.4411764705882353,30108075.490000002
MATT.CARLE,20072008,S.J,1179.6333333333332,2,8,6,14,16,10,1,1,0,70,146,NA,45,6,15,1162,724,781,575,31,35,1,30108059.85
MATT.COOKE,20072008,VAN,816.6333333333333,6,4,5,9,15,10,11,26,15,66,138,154,35,21,19,589,724,524,570,19,24,0.4230769230769231,30108076.975
MATT.COOKE,20072008,WSH,306.75,3,2,2,4,7,5,2,4,2,26,57,66,15,2,9,263,254,238,183,7,7,0.5,30108030.35
MATT.CULLEN,20072008,CAR,995.5833333333333,13,18,18,36,49,31,363,646,283,137,255,33,61,19,NA,1147,758,581,571,31,28,0.5619195046439629,NA
MATT.D'AGOSTINI,20072008,MTL,8.816666666666666,0,0,0,0,0,0,0,0,0,0,0,1,0,0,1,2,5,2,4,0,0,0,15054006.65
MATT.ELLIS,20072008,DET,187.05,2,4,0,4,6,6,42,86,44,28,41,15,6,2,6,166,114,164,112,7,7,0.4883720930232558,30108026.35
MATT.ELLIS,20072008,L.A,240.93333333333334,1,1,0,1,2,2,10,27,17,38,61,13,9,2,6,151,264,132,181,3,3,0.37037037037037035,30108035.57
MATT.FOY,20072008,MIN,226.08333333333334,4,3,1,4,8,7,2,7,5,38,55,10,8,10,10,193,177,164,171,9,9,0.2857142857142857,30108035.155
MATT.GREENE,20072008,EDM,768.1833333333334,0,0,1,1,1,0,0,0,0,28,82,64,29,12,18,532,816,500,590,18,21,0,30108072.744999997
MATT.HUNWICK,20072008,BOS,137.58333333333334,0,1,0,1,1,1,0,0,0,6,11,8,2,1,2,102,128,30,33,3,2,0,30108015.86
MATT.JONES,20072008,ARI,655.1500000000001,0,0,2,2,2,0,0,0,0,25,48,79,9,3,5,450,717,407,585,15,27,0,30108077.98
MATT.KEITH,20072008,NYI,32.05,0,0,0,0,0,0,0,0,0,3,7,2,3,0,0,22,43,16,15,0,1,0,30108013.15
MATT.LASHOFF,20072008,BOS,233.2,1,1,2,3,4,2,0,0,0,11,29,4,12,0,0,189,212,32,28,0,3,0,30108014.75
MATT.MOULSON,20072008,L.A,265,5,3,1,4,9,8,1,3,2,35,49,14,10,6,2,194,297,175,262,11,9,0.3333333333333333,30108046.825
MATT.MURLEY,20072008,ARI,35.18333333333333,0,1,0,1,1,1,2,3,1,3,5,3,1,0,0,22,29,21,26,1,0,0.6666666666666666,30108015.28
MATT.NISKANEN,20072008,DAL,1860.6333333333334,7,5,17,22,29,12,0,0,0,116,219,58,58,12,NA,1494,1405,1129,1065,62,50,0,NA
MATT.PETTINGER,20072008,VAN,263.25,4,1,1,2,6,5,4,7,3,29,54,26,10,5,4,170,287,149,209,7,7,0.5714285714285714,30108038.985
MATT.PETTINGER,20072008,WSH,823.7166666666667,2,4,1,5,7,6,7,12,5,98,147,49,27,12,10,698,703,547,475,13,24,0.5833333333333334,30108060.275
MATT.SMABY,20072008,T.B,169.96666666666667,0,0,0,0,0,0,0,0,0,7,20,31,8,2,6,124,156,120,135,2,8,0,30108026.020000003
MATT.STAJAN,20072008,TOR,118.88333333333333,0,0,0,0,0,0,53,109,56,7,17,7,8,4,1,92,116,41,40,2,2,0.48623853211009177,30108017.259999998
MATT.WALKER,20072008,STL,683.55,1,0,1,1,2,1,0,0,0,47,81,45,26,17,18,544,624,507,491,20,24,0,30108059.395000003
MATTHEW.LOMBARDI,20072008,CGY,1540.2166666666667,14,9,13,22,36,23,484,1014,530,196,326,78,60,25,34,1124,1359,865,903,27,39,0.47731755424063116,30108143.685000002
MATTHEW.SPILLER,20072008,NYI,178.1,0,0,1,1,1,0,0,0,0,6,14,11,6,2,2,138,222,128,159,2,5,0,30108028.945
MATTHEW.STAJAN,20072008,TOR,1431.4166666666665,16,10,7,17,33,26,559,1180,621,120,200,82,39,28,NA,1313,1312,944,822,34,39,0.47372881355932206,NA
MATTIAS.NORSTROM,20072008,DAL,1653.1,4,5,8,13,17,9,0,0,0,64,128,113,37,13,28,1127,1468,988,1046,47,41,0,30108120.58
MATTIAS.OHLUND,20072008,VAN,1259.75,9,7,7,14,23,16,0,0,0,128,257,64,68,10,31,1114,1050,694,704,28,27,0,30108090.325000003
MATTIAS.RITOLA,20072008,DET,11.55,0,1,0,1,1,1,0,0,0,2,2,0,0,0,0,10,8,10,8,1,1,0,30108013.2
MAX.TALBOT,20072008,PIT,1219.6666666666667,15,10,9,19,34,25,282,631,349,96,153,91,34,28,30,740,1228,636,759,34,27,0.4469096671949287,30108124.735
MAXIM.AFINOGENOV,20072008,BUF,894.7666666666667,10,11,7,18,28,21,1,5,4,114,216,25,55,22,21,957,611,594,494,22,34,0.2,30108067.685000002
MAXIM.KONDRATIEV,20072008,ANA,30.050000000000004,0,0,0,0,0,0,0,0,0,1,4,3,2,1,0,22,17,20,13,1,2,0,30108012.560000002
MAXIM.LAPIERRE,20072008,MTL,837.1333333333333,7,8,6,14,21,15,318,643,325,87,134,132,20,21,20,563,936,460,695,21,27,0.49455676516329705,30108117.48
MICHAEL.BLUNDEN,20072008,CHI,7.85,0,0,0,0,0,0,0,0,0,0,0,0,0,0,0,3,13,1,8,0,1,0,15054007.15
MICHAEL.FUNK,20072008,BUF,46.43333333333334,0,0,0,0,0,0,0,0,0,1,3,3,1,1,0,29,52,27,52,0,3,0,30108018.36
MICHAEL.GRIER,20072008,S.J,1187.6666666666665,8,9,3,12,20,17,21,82,61,122,174,NA,19,17,9,795,1139,634,666,20,29,0.25609756097560976,30108095.585
MICHAEL.KNUBLE,20072008,PHI,1442.2833333333333,27,13,11,24,51,40,8,22,14,165,263,52,30,17,31,1408,1197,773,836,32,38,0.36363636363636365,30108130.015
MICHAEL.KOMISAREK,20072008,MTL,1827.9499999999998,5,6,8,14,19,11,0,1,1,93,242,NA,101,33,47,1515,2136,1255,1431,60,47,0,30108159.229999997
MICHAEL.MODANO,20072008,DAL,1452.25,19,14,17,31,50,33,519,1050,531,184,346,7,79,27,NA,1384,1021,738,741,26,41,0.4942857142857143,NA
MICHAEL.NYLANDER,20072008,WSH,766.2666666666667,11,15,11,26,37,26,262,534,272,77,116,4,23,9,NA,912,526,513,443,20,33,0.49063670411985016,NA
MICHAEL.PECA,20072008,CBJ,1206.9166666666667,8,20,6,26,34,28,569,1081,512,86,153,74,33,12,32,959,1011,604,618,25,28,0.5263644773358002,30108111.98
MICHAEL.RUPP,20072008,N.J,554.8166666666667,3,5,1,6,9,8,89,182,93,71,106,117,18,20,19,411,364,347,337,8,15,0.489010989010989,30108056.585
MICHAEL.RYAN,20072008,BUF,445.1,4,3,1,4,8,7,0,2,2,53,85,27,16,11,9,299,395,251,291,12,15,0,30108047.634999998
MICHAEL.RYDER,20072008,MTL,969.3833333333334,14,8,9,17,31,22,5,19,14,140,278,125,78,17,17,1027,863,639,725,24,29,0.2631578947368421,30108098.745
MICHAEL.SILLINGER,20072008,NYI,966.0666666666666,13,10,1,11,24,23,567,1013,446,91,158,28,30,14,12,840,904,515,523,16,26,0.5597235932872655,30108095.595
MICHAEL.YORK,20072008,ARI,754.6500000000001,6,4,3,7,13,10,104,205,101,85,133,23,27,12,NA,750,615,542,542,15,20,0.5073170731707317,NA
MICHAEL.ZIGOMANIS,20072008,ARI,409.31666666666666,2,0,1,1,3,2,196,328,132,35,53,26,3,2,3,230,416,183,250,6,10,0.5975609756097561,30108047.335
MICHAL.HANDZUS,20072008,L.A,1249.7333333333333,7,11,3,14,21,18,531,1164,633,88,125,69,17,20,17,772,1424,655,974,24,48,0.45618556701030927,30108163.865000002
MICHAL.ROZSIVAL,20072008,NYR,2214.583333333333,14,11,17,28,42,25,0,0,0,140,300,112,88,22,NA,2086,1731,1349,1093,60,44,0,NA
MICHEL.OUELLET,20072008,T.B,872.4000000000001,17,13,6,19,36,30,19,42,23,132,235,57,40,14,6,880,617,648,541,32,18,0.4523809523809524,30108078.05
MICKI.DUPONT,20072008,STL,25.133333333333336,0,0,0,0,0,0,0,0,0,3,5,2,1,0,1,24,13,11,12,1,0,0,15054007.25
MIKAEL.SAMUELSSON,20072008,DET,1537.65,17,16,17,33,50,33,8,24,16,327,526,94,109,32,18,1740,892,1204,800,60,30,0.3333333333333333,30108088.515
MIKE.BROWN,20072008,VAN,119.88333333333333,1,0,0,0,1,1,0,0,0,9,17,44,2,10,16,67,118,59,109,1,4,0,30108028.6
MIKE.CAMMALLERI,20072008,L.A,1170.65,19,18,10,28,47,37,204,377,173,209,387,31,80,26,13,1300,891,789,783,34,45,0.5411140583554377,30108116.119999997
MIKE.COMMODORE,20072008,CAR,788.9,3,5,4,9,12,8,0,0,0,67,149,93,51,14,28,721,758,611,496,31,27,0,30108056.39
MIKE.COMMODORE,20072008,OTT,494.33333333333337,0,2,2,4,4,2,0,0,0,34,71,65,25,6,10,391,458,298,279,10,19,0,30108038.21
MIKE.COMRIE,20072008,NYI,1437.8833333333332,21,15,11,26,47,36,549,1197,648,191,298,46,65,30,36,1434,1168,854,937,37,43,0.45864661654135336,30108160.485
MIKE.FISHER,20072008,OTT,1543.4,23,16,8,24,47,39,608,1211,603,212,362,232,72,28,32,1467,1342,857,790,30,36,0.5020644095788604,30108137.6
MIKE.GLUMAC,20072008,STL,40.53333333333334,0,0,0,0,0,0,1,3,2,3,5,6,1,3,1,29,33,29,33,0,1,0.3333333333333333,30108015.77
MIKE.GREEN,20072008,WSH,2127.1833333333334,21,20,22,42,63,41,0,1,1,251,511,106,153,36,34,2484,1443,1642,1196,65,57,0,30108122.009999998
MIKE.GRIER,20072008,S.J,276.1666666666667,1,2,0,2,3,3,2,9,7,31,50,34,4,5,1,183,270,169,190,3,7,0.2222222222222222,30108034.880000003
MIKE.IGGULDEN,20072008,S.J,6.666666666666667,0,0,0,0,0,0,0,0,0,1,2,0,1,0,0,8,3,7,3,0,1,0,15054006
MIKE.JOHNSON,20072008,STL,273.4666666666667,2,2,1,3,5,4,2,8,6,21,32,13,6,2,4,146,250,119,190,4,8,0.25,30108037.575000003
MIKE.KNUBLE,20072008,PHI,330.05,5,6,0,6,11,11,5,9,4,36,66,30,18,1,6,333,296,234,215,9,9,0.5555555555555556,30108038.16
MIKE.LUNDIN,20072008,T.B,1117.3166666666666,0,2,4,6,6,2,0,0,0,32,90,18,40,5,NA,868,1017,791,846,37,33,0,NA
MIKE.MODANO,20072008,DAL,480.01666666666665,7,7,4,11,18,14,150,317,167,53,100,13,21,8,12,375,378,207,249,11,6,0.47318611987381703,30108054.630000003
MIKE.MOTTAU,20072008,N.J,1675.8666666666668,5,5,6,11,16,10,0,0,0,72,135,46,42,11,21,1365,1376,877,914,29,43,0,30108108.16
MIKE.RIBEIRO,20072008,DAL,1791.7166666666667,30,43,27,70,100,73,NA,1128,NA,139,234,85,50,34,22,1788,1095,1118,973,66,38,NA,NA
MIKE.RICHARDS,20072008,PHI,1924.95,34,34,20,54,88,68,855,1677,822,262,519,151,147,59,33,1834,1783,919,1022,46,39,0.5098389982110912,30108185.590000004
MIKE.VAN RYN,20072008,FLA,356.26666666666665,0,2,0,2,2,2,0,0,0,16,33,21,9,1,7,266,356,212,267,8,12,0,30108041.86
MIKE.WEAVER,20072008,VAN,772.0833333333334,0,1,0,1,1,1,0,1,1,33,84,45,38,11,11,644,642,587,502,20,17,0,30108053.259999998
MIKE.WEBER,20072008,BUF,256.26666666666665,0,2,0,2,2,2,0,0,0,11,25,44,11,3,4,226,200,191,152,17,5,0,30108023.33
MIKHAIL.GRABOVSKI,20072008,MTL,269.41666666666663,3,4,2,6,9,7,51,153,102,23,51,7,13,7,5,248,278,201,227,11,11,0.3333333333333333,30108043.41
MIKKO.KOIVU,20072008,MIN,1282.7166666666667,15,15,16,31,46,30,583,1122,539,162,252,46,45,22,22,1141,1003,722,634,36,23,0.5196078431372549,30108111.54
MILAN.HEJDUK,20072008,COL,1680.5666666666666,32,17,11,28,60,49,61,150,89,223,354,21,66,20,19,1490,1296,948,972,54,43,0.4066666666666667,30108143.015
MILAN.JURCINA,20072008,WSH,1363.0333333333333,1,2,6,8,9,3,0,0,0,61,150,167,60,4,16,1090,1256,994,897,39,36,0,30108089.740000002
MILAN.LUCIC,20072008,BOS,1039.4166666666667,10,11,7,18,28,21,4,8,4,99,177,214,31,30,NA,942,795,317,281,8,17,0.5,NA
MILAN.MICHALEK,20072008,S.J,1654.9333333333334,28,20,10,30,58,48,7,12,5,253,417,95,72,35,23,1609,1044,1072,834,57,29,0.5833333333333334,30108112.130000003
MIROSLAV.SATAN,20072008,NYI,1449.5,16,19,5,24,40,35,18,36,18,169,347,19,113,19,18,1512,1120,925,832,36,28,0.5,30108102.285
NATHAN.GUENIN,20072008,PHI,19.883333333333336,0,0,0,0,0,0,0,0,0,0,1,1,0,0,1,11,36,11,36,2,0,0,15054010.7
NATHAN.HORTON,20072008,FLA,1536.1333333333332,27,20,15,35,62,47,29,73,44,211,382,81,89,28,31,1637,1292,1105,1071,57,44,0.3972602739726027,30108143.915
NATHAN.MCIVER,20072008,VAN,177.88333333333333,0,0,0,0,0,0,0,0,0,9,13,19,1,12,14,115,130,109,120,1,9,0,30108026.92
NATHAN.PAETSCH,20072008,BUF,798.6666666666667,2,3,4,7,9,5,0,0,0,48,87,34,29,7,11,680,613,498,515,28,24,0,30108063.270000003
NATHAN.SMITH,20072008,PIT,99.78333333333333,0,0,0,0,0,0,40,75,35,3,10,14,4,1,1,42,114,36,94,1,0,0.5333333333333333,30108025.21
NICHOLAS.BOYNTON,20072008,ARI,1252.3000000000002,3,4,3,7,10,7,0,0,0,90,192,87,66,21,45,1002,1246,872,920,27,41,0,30108108.435000002
NICK.BOYNTON,20072008,ARI,91.66666666666667,0,0,1,1,1,0,0,0,0,3,7,6,4,0,1,63,110,54,95,2,3,0,30108023.025
NICK.FOLIGNO,20072008,OTT,463.55,7,2,1,3,10,9,22,52,30,50,78,65,16,9,10,410,358,352,329,16,15,0.4230769230769231,30108050.395
NICK.SCHULTZ,20072008,MIN,1606.8333333333333,2,1,9,10,12,3,0,0,0,51,128,99,38,14,18,1086,1552,936,1033,44,40,0,30108115.865000002
NICK.TARNASKY,20072008,T.B,659.55,6,2,2,4,10,8,4,9,5,90,129,119,23,22,19,457,580,430,541,11,25,0.4444444444444444,30108079.78
NICKLAS.BACKSTROM,20072008,WSH,1700.5,17,30,27,57,74,47,447,959,512,170,305,39,55,32,NA,2024,1097,1323,920,65,45,0.46611053180396245,NA
NICKLAS.BERGFORS,20072008,N.J,11.283333333333333,0,0,0,0,0,0,0,1,1,3,3,0,0,0,0,10,8,6,6,0,1,0,15054006.8
NICKLAS.GROSSMANN,20072008,DAL,1299.5833333333335,1,2,6,8,9,3,0,0,0,48,104,121,39,2,14,897,1103,846,833,44,31,0,30108088.97
NICKLAS.LIDSTROM,20072008,DET,2619.9666666666662,12,30,37,67,79,42,0,0,0,226,470,34,134,8,27,2844,1799,1655,1090,76,36,0,30108104.355
NICLAS.HAVELID,20072008,ATL,1660.9166666666665,1,5,7,12,13,6,0,0,0,54,97,35,26,12,21,993,1876,799,1227,51,62,0,30108154.495
NICLAS.WALLIN,20072008,CAR,1196.6166666666668,2,3,3,6,8,5,0,1,1,60,134,134,45,11,NA,932,1210,766,820,24,47,0,NA
NIGEL.DAWES,20072008,NYR,917.3,16,12,5,17,33,28,1,2,1,139,224,106,36,12,5,910,660,703,587,34,21,0.5,30108080.435
NIK.ANTROPOV,20072008,TOR,35.61666666666667,0,4,0,4,4,4,3,5,2,5,12,2,2,1,1,47,33,19,9,3,1,0.6,30108014.33
NIKLAS.HAGMAN,20072008,DAL,1546.8833333333334,29,9,6,15,44,38,2,20,18,211,341,56,56,33,25,1275,1241,875,872,40,33,0.1,30108125.86
NIKLAS.HJALMARSSON,20072008,CHI,177.05,0,1,0,1,1,1,0,0,0,5,13,7,3,2,5,133,111,127,104,3,5,0,30108021.92
NIKLAS.KRONVALL,20072008,DET,NA,6,19,22,41,47,25,0,0,0,126,252,133,79,14,31,1818,1269,1279,932,73,33,0,30108092.439999998
NIKO.KAPANEN,20072008,ARI,1091.0833333333335,10,12,6,18,28,22,419,804,385,85,141,23,24,9,17,1103,874,745,738,23,22,0.5211442786069652,30108114.4
NIKOLAI.ANTROPOV,20072008,TOR,1407.7,26,16,9,25,51,42,111,266,155,159,284,100,55,31,30,1407,1267,834,820,42,34,0.41729323308270677,30108125.825000003
NIKOLAI.ZHERDEV,20072008,CBJ,1587.8833333333332,26,28,7,35,61,54,12,29,17,254,438,37,98,42,19,1627,978,1030,823,39,39,0.41379310344827586,30108114.225
NOAH.CLARKE,20072008,N.J,10.65,1,0,0,0,1,1,0,0,0,3,3,0,0,0,0,4,13,4,13,1,1,0,15054008.45
NOAH.WELCH,20072008,FLA,32.266666666666666,0,0,0,0,0,0,0,0,0,0,3,6,1,1,2,36,22,36,19,2,1,0,30108012.91
NOLAN.PRATT,20072008,BUF,722.3833333333333,1,3,0,3,4,4,0,0,0,21,48,54,12,7,12,508,658,469,533,19,20,0,30108069.12
OLE-KRISTIAN.TOLLEFSEN,20072008,CBJ,627.7166666666667,2,1,1,2,4,3,0,0,0,21,49,NA,16,20,32,444,513,401,368,16,20,0,30108050.424999997
OLLI.JOKINEN,20072008,FLA,1630.8333333333333,34,25,12,37,71,59,404,937,533,340,562,77,108,35,33,1816,1371,1084,1133,42,51,0.4311632870864461,30108188.61
OLLI.MALMIVAARA,20072008,N.J,17.6,0,0,0,0,0,0,0,0,0,0,0,1,0,0,0,16,5,12,5,0,0,0,15054006.15
OWEN.NOLAN,20072008,CGY,1408.8000000000002,19,14,3,17,36,33,192,378,186,174,311,NA,65,24,30,1187,1140,873,794,38,34,0.5079365079365079,30108114.045
P. J..AXELSSON,20072008,BOS,118.68333333333334,0,0,0,0,0,0,3,6,3,14,30,14,11,3,1,115,132,89,81,2,5,0.5,30108018.75
PASCAL.DUPUIS,20072008,ATL,916,10,2,3,5,15,12,5,13,8,111,185,50,41,18,12,600,920,524,619,20,26,0.38461538461538464,30108085.705
PASCAL.DUPUIS,20072008,PIT,593.8666666666667,4,10,5,15,19,14,1,6,5,70,116,77,24,8,11,449,634,395,454,20,11,0.16666666666666666,30108067.895
PASCAL.PELLETIER,20072008,BOS,66.36666666666666,0,0,0,0,0,0,1,1,0,8,19,12,3,1,0,57,32,15,7,0,1,1,30108012.25
PATRICE.BERGERON,20072008,BOS,181.66666666666669,3,1,3,4,7,4,88,175,87,24,45,6,10,2,1,162,141,39,25,0,1,0.5028571428571429,30108020.015
PATRICE.BRISEBOIS,20072008,MTL,889.3333333333333,4,9,3,12,16,13,0,0,0,52,135,38,48,5,12,918,784,596,649,17,23,0,30108082.225
PATRICK.EAVES,20072008,CAR,141.33333333333331,1,3,1,4,5,4,0,2,2,22,34,14,2,4,2,124,130,110,114,7,8,0,30108026.215
PATRICK.EAVES,20072008,OTT,330.8666666666667,4,3,3,6,10,7,1,1,0,58,102,28,23,9,2,367,243,223,210,8,8,1,30108035.655
PATRICK.KALETA,20072008,BUF,244.73333333333332,3,2,0,2,5,5,1,6,5,25,29,106,1,24,11,166,205,156,195,9,8,0.16666666666666666,30108038.53
PATRICK.KANE,20072008,CHI,1489.25,21,34,17,51,72,55,15,25,10,187,305,16,63,37,27,1402,915,852,776,52,44,0.6,30108117.345
PATRICK.MARLEAU,20072008,S.J,1718.6833333333334,23,20,13,33,56,43,370,698,328,228,386,118,80,25,15,1730,1126,1037,900,33,47,0.5300859598853869,30108132.875
PATRICK.O'SULLIVAN,20072008,L.A,1533.7833333333333,22,17,14,31,53,39,202,460,258,219,394,95,78,21,NA,1380,1569,952,1093,45,61,0.4391304347826087,NA
PATRICK.RISSMILLER,20072008,S.J,1130.9166666666667,8,4,4,8,16,12,114,225,111,131,252,NA,61,35,17,829,944,724,674,22,29,0.5066666666666667,30108086.409999996
PATRICK.SHARP,20072008,CHI,1483.4333333333334,35,16,10,26,61,51,296,573,277,204,320,50,54,25,25,1191,1170,734,784,52,37,0.5165794066317626,30108136.14
PATRICK.THORESEN,20072008,EDM,182.15,2,1,0,1,3,3,10,19,9,18,29,20,5,2,3,152,156,144,148,4,7,0.5263157894736842,30108029.32
PATRICK.THORESEN,20072008,PHI,395.6333333333333,0,4,3,7,7,4,34,86,52,31,58,37,11,7,6,317,336,302,290,12,17,0.3953488372093023,30108044.155
PATRIK.ELIAS,20072008,N.J,1468.75,24,22,14,36,60,46,389,854,465,281,469,59,104,18,18,1604,954,908,633,32,32,0.45550351288056207,30108107.39
PAUL.GAUSTAD,20072008,BUF,1381.25,10,15,11,26,36,25,621,1138,517,133,202,198,31,25,29,1189,1099,725,759,32,35,0.5456942003514939,30108127.115000002
PAUL.KARIYA,20072008,STL,1534.5666666666666,16,31,18,49,65,47,0,6,6,223,355,18,70,28,25,1475,1072,930,895,51,46,0,30108126.68
PAUL.MARA,20072008,NYR,1268.8333333333335,1,7,10,17,18,8,0,1,1,92,214,88,55,12,32,1163,1024,794,763,31,24,0,30108088.72
PAUL.MARTIN,20072008,N.J,1866.7166666666667,6,12,17,29,35,18,0,0,0,106,237,56,84,12,NA,1715,1370,968,763,37,27,0,NA
PAUL.RANGER,20072008,T.B,1815.8666666666668,10,8,10,18,28,18,0,0,0,105,211,106,64,13,27,1546,1555,1157,1074,55,72,0,30108118.98
PAUL.STASTNY,20072008,COL,1570.4333333333334,26,22,26,48,74,48,613,1221,608,154,250,21,39,26,15,1412,1210,847,829,61,36,0.502047502047502,30108145.729999997
PAVEL.DATSYUK,20072008,DET,2230.266666666667,41,53,26,79,120,94,516,950,434,338,575,95,110,55,13,2726,1322,1612,918,84,37,0.5431578947368421,30108135.740000002
PAVEL.KUBINA,20072008,TOR,1720.9166666666665,11,19,10,29,40,30,0,1,1,136,276,121,83,11,47,1601,1674,957,999,52,43,0,30108126.66
PAVOL.DEMITRA,20072008,MIN,1427.7,16,26,15,41,57,42,424,927,503,137,254,21,53,16,12,1325,1176,793,853,46,40,0.45738942826321466,30108141.795
PER JOHAN.AXELSSON,20072008,BOS,1310.5166666666669,12,11,4,15,27,23,17,45,28,98,184,44,40,18,5,998,1300,281,254,14,9,0.37777777777777777,30108049.759999998
PETE.VANDERMEER,20072008,ARI,15.1,0,0,0,0,0,0,0,0,0,0,1,2,1,1,0,11,15,11,15,0,0,0,30108013.560000002
PETER.FORSBERG,20072008,COL,301.1333333333333,2,9,8,17,19,11,17,23,6,28,42,14,8,13,10,291,216,188,197,14,5,0.7391304347826086,30108038.96
PETER.HARROLD,20072008,L.A,409.7,2,0,3,3,5,2,1,2,1,16,35,7,15,7,1,362,321,326,286,18,15,0.5,30108036.335
PETER.MUELLER,20072008,ARI,1398,21,21,11,32,53,42,104,250,146,200,375,30,80,16,16,1498,1116,944,953,39,47,0.416,30108135.795
PETER.SCHAEFER,20072008,BOS,1025.7666666666667,10,13,6,19,29,23,3,7,4,97,169,NA,26,15,10,899,831,297,255,10,12,0.42857142857142855,30108051.27
PETR.PRUCHA,20072008,NYR,744.6,7,4,6,10,17,11,2,3,1,89,167,85,38,27,11,761,501,576,452,18,15,0.6666666666666666,30108056.55
PETR.SYKORA,20072008,PIT,1663.1666666666665,34,23,15,38,72,57,9,16,7,243,474,33,115,13,26,1668,1355,967,1143,54,40,0.5625,30108163.765
PETRI.KONTIOLA,20072008,CHI,174.61666666666667,0,1,4,5,5,1,29,43,14,12,16,12,1,3,2,140,103,122,84,6,2,0.6744186046511628,30108019.64
PETTERI.NOKELAINEN,20072008,BOS,554.4666666666667,7,5,0,5,12,12,162,303,141,45,78,61,17,13,10,430,439,158,162,4,6,0.5346534653465347,30108042.21
PETTERI.NUMMELIN,20072008,MIN,463.4166666666667,2,5,3,8,10,7,0,1,1,39,82,3,32,2,1,467,343,322,307,10,12,0,30108042.195
PETTERI.WIRTANEN,20072008,ANA,12.55,1,0,0,0,1,1,5,11,6,1,1,0,0,0,1,6,6,6,6,1,0,0.45454545454545453,15054007.6
PHIL.KESSEL,20072008,BOS,1298.5,21,8,11,19,40,29,139,328,189,223,398,15,91,20,NA,1294,953,367,280,14,20,0.42378048780487804,NA
PHILIPPE.BOUCHER,20072008,DAL,877.75,2,8,3,11,13,10,0,0,0,77,145,74,39,6,NA,658,695,455,470,20,20,0,NA
PIERRE-MARC.BOUCHARD,20072008,MIN,1441.1,14,31,19,50,64,45,5,11,6,143,275,9,78,32,14,1567,978,981,850,40,36,0.45454545454545453,30108110.845
QUINTIN.LAING,20072008,WSH,450.6333333333333,1,2,3,5,6,3,2,6,4,48,81,49,13,4,5,353,434,323,219,11,7,0.3333333333333333,30108030.494999997
R.J..UMBERGER,20072008,PHI,1607.65,23,26,16,42,65,49,50,126,76,212,351,81,82,33,13,1391,1666,988,1141,47,42,0.3968253968253968,30108162.18
RADEK.BONK,20072008,NSH,1364.9833333333333,15,9,6,15,30,24,504,964,460,148,233,48,41,22,20,1167,1015,732,853,17,42,0.5228215767634855,30108139.13
RADEK.DVORAK,20072008,FLA,1012.7,8,4,5,9,17,12,2,12,10,145,214,50,24,20,NA,761,1025,663,682,19,22,0.16666666666666666,NA
RADEK.MARTINEK,20072008,NYI,1554.15,0,6,9,15,15,6,0,0,0,95,169,80,52,10,19,1242,1637,988,978,28,38,0,30108108.975
RADIM.VRBATA,20072008,ARI,1383.2,27,15,13,28,55,42,7,19,12,245,366,13,57,12,NA,1322,1177,771,818,38,31,0.3684210526315789,NA
RAFFI.TORRES,20072008,EDM,544.7166666666667,5,3,3,6,11,8,13,20,7,87,137,55,16,13,15,457,458,336,412,15,16,0.65,30108064.675
RAITIS.IVANANS,20072008,L.A,547.5833333333333,6,2,0,2,8,8,0,0,0,48,63,139,9,20,NA,331,547,320,536,14,24,0,NA
RANDY.JONES,20072008,PHI,1716.9666666666667,5,12,14,26,31,17,0,0,0,123,290,44,116,8,24,1551,1666,1079,1154,53,43,0,30108126.78
RANDY.ROBITAILLE,20072008,OTT,934.9333333333333,9,12,8,20,29,21,81,139,58,101,170,23,32,9,9,977,716,705,622,38,28,0.5827338129496403,30108081.63
RAY.WHITNEY,20072008,CAR,1249.7333333333336,25,18,17,35,60,43,3,5,2,203,360,13,73,18,NA,1503,877,839,643,31,33,0.6,NA
RENE.BOURQUE,20072008,CHI,932.0666666666666,10,9,5,14,24,19,2,8,6,98,161,69,26,21,20,635,820,499,575,27,24,0.25,30108086.064999998
RHETT.WARRENER,20072008,CGY,416.2166666666667,1,1,1,2,3,2,0,1,1,15,32,31,11,4,9,330,352,308,265,15,17,0,30108035.965
RICH.PEVERLEY,20072008,NSH,387.0333333333333,5,4,3,7,12,9,77,169,92,46,73,12,10,6,4,323,345,283,320,13,10,0.4556213017751479,30108055.115
RICHARD.PARK,20072008,NYI,1235.4666666666667,12,11,9,20,32,23,309,612,303,131,215,43,43,22,9,1014,1294,742,747,30,34,0.5049019607843137,30108111.305
RICHARD.ZEDNIK,20072008,FLA,949.45,15,8,3,11,26,23,0,2,2,140,232,51,39,16,19,994,752,636,645,26,29,0,30108092.435000002
RICK.NASH,20072008,CBJ,1638.5,38,19,12,31,69,57,14,44,30,328,520,67,96,53,43,1543,1221,906,768,39,41,0.3181818181818182,30108124.34
RICK.RYPIEN,20072008,VAN,178.45,1,2,0,2,3,3,44,106,62,8,14,28,3,8,12,93,167,83,141,2,8,0.41509433962264153,30108034.990000002
RILEY.COTE,20072008,PHI,311.83333333333337,1,3,0,3,4,4,1,2,1,17,28,64,7,33,41,191,280,173,265,8,5,0.5,30108050.57
ROB.BLAKE,20072008,L.A,137.79999999999998,1,0,0,0,1,1,0,0,0,6,15,7,4,1,3,94,158,58,103,1,6,0,30108025.259999998
ROB.DAVISON,20072008,NYI,354.6166666666667,1,1,0,1,2,2,0,0,0,22,41,33,13,5,13,275,349,249,246,8,11,0,30108037.65
ROB.DAVISON,20072008,S.J,116.69999999999999,0,0,0,0,0,0,0,0,0,10,17,36,4,8,7,100,80,79,60,1,2,0,30108017.93
ROB.GLOBKE,20072008,FLA,69.05,0,0,0,0,0,0,0,1,1,4,8,7,0,2,1,49,59,41,45,0,3,0,30108017.119999997
ROB.NIEDERMAYER,20072008,ANA,1409.35,8,5,3,8,16,13,26,73,47,111,179,64,28,30,25,901,1258,656,752,17,22,0.3561643835616438,30108105.515
ROB.SCHREMP,20072008,EDM,13.683333333333334,0,0,0,0,0,0,0,1,1,3,5,0,1,0,0,19,10,11,9,0,1,0,15054006.85
ROB.SCUDERI,20072008,PIT,507.0833333333333,0,2,2,4,4,2,0,0,0,6,18,23,4,2,1,311,543,286,350,14,10,0,30108049.22
ROBERT.BLAKE,20072008,L.A,1476.2666666666667,8,12,10,22,30,20,4,8,4,138,261,85,73,6,33,1320,1481,754,970,31,47,0.5,30108129.22
ROBERT.EARL,20072008,TOR,83.13333333333333,0,1,0,1,1,1,2,2,0,9,14,3,2,1,0,58,79,56,79,2,4,1,30108021.44
ROBERT.HOLIK,20072008,ATL,1236.0666666666666,12,8,10,18,30,20,831,1422,591,129,225,141,49,19,NA,951,1104,696,834,31,45,0.5843881856540084,NA
ROBERT.LANG,20072008,CHI,1381.9,21,24,9,33,54,45,581,1093,512,170,250,25,35,15,22,1268,877,796,686,44,29,0.5315645013723697,30108123.564999998
ROBERT.NILSSON,20072008,EDM,988.9333333333334,10,21,10,31,41,31,7,15,8,102,173,20,38,18,12,894,812,652,699,39,29,0.4666666666666667,30108099.41
ROBERT.SCUDERI,20072008,PIT,1203.5333333333333,0,0,4,4,4,0,0,0,0,26,52,30,12,8,13,775,1176,644,783,32,33,0,30108094.28
ROBYN.REGEHR,20072008,CGY,1902.7,5,5,10,15,20,10,0,0,0,96,234,NA,75,17,36,1335,1658,1032,1040,56,51,0,30108114.119999997
ROD.BRIND'AMOUR,20072008,CAR,1324.55,19,18,13,31,50,37,851,1458,607,151,233,55,46,22,19,1309,1166,801,715,36,30,0.5836762688614541,30108123.535
RODNEY.PELLEY,20072008,N.J,540.0166666666667,2,2,2,4,6,4,149,319,170,58,97,73,14,9,8,314,468,260,297,6,9,0.4670846394984326,30108054.4
ROMAN.HAMRLIK,20072008,MTL,2057.3333333333335,6,12,11,23,29,18,0,0,0,144,291,173,94,15,23,1793,2151,1225,1332,51,54,0,30108151.225
ROMAN.POLAK,20072008,STL,69.23333333333332,0,1,0,1,1,1,0,0,0,2,5,6,2,0,0,47,57,47,56,3,2,0,30108017.95
RON.HAINSEY,20072008,CBJ,1759.85,8,14,9,23,31,22,0,0,0,161,370,51,130,6,11,1682,1155,955,864,32,41,0,30108093.285
RORY.FITZPATRICK,20072008,PHI,240.83333333333331,0,0,1,1,1,0,0,0,0,10,20,18,7,6,3,172,252,151,212,3,14,0,30108035.835
ROSTISLAV.KLESLA,20072008,CBJ,1903.2833333333333,6,3,9,12,18,9,4,5,1,129,245,106,69,12,30,1502,1587,1075,1005,43,41,0.8,30108109.805
ROSTISLAV.OLESZ,20072008,FLA,955.6833333333334,14,7,5,12,26,21,7,10,3,139,203,69,25,15,8,900,802,584,538,19,20,0.7,30108079.305
RUSLAN.FEDOTENKO,20072008,NYI,1100.2666666666669,16,9,8,17,33,25,11,28,17,116,215,101,51,24,20,1059,888,711,689,27,30,0.39285714285714285,30108094.63
RUSLAN.SALEI,20072008,COL,536.35,4,5,3,8,12,9,0,0,0,40,81,65,32,3,12,433,458,325,361,17,18,0,30108052.155
RUSLAN.SALEI,20072008,FLA,1512.2166666666667,3,9,11,20,23,12,0,1,1,81,198,121,71,5,NA,1278,1442,896,1011,35,43,0,NA
RYAN.BAYDA,20072008,CAR,390.5,3,1,2,3,6,4,0,2,2,58,94,38,21,7,NA,389,284,334,232,9,9,0,NA
RYAN.CALDWELL,20072008,ARI,12.25,0,0,0,0,0,0,0,0,0,1,1,1,0,0,1,13,7,2,0,0,0,0,15054006.1
RYAN.CALLAHAN,20072008,NYR,802.65,10,3,4,7,17,13,1,6,5,117,181,170,29,31,NA,617,681,547,550,25,17,0.16666666666666666,NA
RYAN.CARTER,20072008,ANA,422.6333333333333,4,4,0,4,8,8,204,339,135,61,103,55,13,17,18,291,349,266,287,10,14,0.6017699115044248,30108053.93
RYAN.CRAIG,20072008,T.B,91.41666666666667,1,1,0,1,2,2,1,1,0,8,10,8,1,4,0,63,90,44,58,1,4,1,30108019.880000003
RYAN.GETZLAF,20072008,ANA,1635.5333333333333,25,31,30,61,86,56,582,1241,659,198,324,142,53,36,46,1697,1037,983,786,56,33,0.46897663174858983,30108145.49
RYAN.HOLLWEG,20072008,NYR,620.0666666666666,2,0,0,0,2,2,19,40,21,64,99,187,13,15,25,421,480,391,457,4,15,0.475,30108067.810000002
RYAN.JOHNSON,20072008,STL,1134.5666666666666,5,9,3,12,17,14,438,803,365,84,142,NA,29,15,11,593,1237,514,674,19,25,0.5454545454545454,30108108.745
RYAN.KESLER,20072008,VAN,1524.8333333333333,21,6,10,16,37,27,719,1355,636,177,287,78,54,52,28,1223,1415,815,833,32,31,0.5306273062730628,30108140.229999997
RYAN.MALONE,20072008,PIT,1843.4833333333333,33,19,15,34,67,52,17,48,31,202,333,216,58,51,41,1635,1713,987,1099,64,46,0.3541666666666667,30108162.015
RYAN.O'BYRNE,20072008,MTL,485.25,1,1,3,4,5,2,0,0,0,13,37,70,15,3,14,348,478,304,387,17,14,0,30108054.305
RYAN.PARENT,20072008,PHI,395.9666666666667,0,0,1,1,1,0,0,0,0,11,27,30,9,0,3,306,406,262,337,9,14,0,30108047.825000003
RYAN.POTULNY,20072008,PHI,45.55,0,1,0,1,1,1,14,32,18,5,8,6,0,2,2,34,38,25,37,0,0,0.4375,30108018.18
RYAN.SHANNON,20072008,VAN,347.34999999999997,5,5,3,8,13,10,32,82,50,34,62,10,10,0,7,370,226,202,184,9,11,0.3902439024390244,30108038.055
RYAN.SMYTH,20072008,COL,1218.2833333333333,16,21,4,25,41,37,13,34,21,190,279,35,37,29,25,1163,882,748,732,41,40,0.38235294117647056,30108110.21
RYAN.STONE,20072008,PIT,38.5,0,0,1,1,1,0,3,5,2,3,6,7,1,3,1,25,53,24,52,1,2,0.6,30108018.775
RYAN.SUTER,20072008,NSH,1691.4666666666667,8,10,14,24,32,18,0,0,0,143,285,62,89,27,36,1547,1316,1021,917,45,42,0,30108103.369999997
RYAN.WHITNEY,20072008,PIT,2121.4666666666667,13,21,12,33,46,34,0,0,0,156,283,41,79,15,27,1921,1939,1083,1361,63,47,0,30108174.25
RYANE.CLOWE,20072008,S.J,461.23333333333335,8,4,5,9,17,12,5,15,10,63,100,71,24,14,10,448,334,304,282,13,15,0.3333333333333333,30108046.965
SAKU.KOIVU,20072008,MTL,1531.3833333333332,19,29,17,46,65,48,785,1489,704,167,291,52,70,30,42,1629,1417,873,957,35,38,0.5271994627266622,30108168.975
SAM.GAGNER,20072008,EDM,1238.5166666666667,13,26,10,36,49,39,125,299,174,135,232,18,40,16,9,1074,1005,755,883,38,48,0.4180602006688963,30108134.86
SAMI.KAPANEN,20072008,PHI,1158.2,7,2,0,2,9,9,13,32,19,95,176,65,47,14,9,781,1202,669,809,16,32,0.40625,30108103.509999998
SAMI.LEPISTO,20072008,WSH,93.03333333333333,0,0,1,1,1,0,0,0,0,8,20,6,10,1,6,99,71,96,63,2,3,0,30108016.235
SAMI.SALO,20072008,VAN,1489.1166666666668,8,8,9,17,25,16,0,0,0,122,278,36,83,4,19,1250,1283,746,856,26,22,0,30108106.415
SAMUEL.PAHLSSON,20072008,ANA,1161.2,6,3,4,7,13,9,648,1180,532,99,158,126,26,25,17,672,1063,481,605,15,22,0.5491525423728814,30108106.57
SANDIS.OZOLINSH,20072008,S.J,659.5,3,9,4,13,16,12,0,0,0,38,102,28,39,5,12,681,444,397,362,18,22,0,30108049
SCOTT.GOMEZ,20072008,NYR,1820.15,20,41,19,60,80,61,696,1321,625,269,415,57,68,29,22,2099,1306,1250,992,52,39,0.5268735806207419,30108159.605
SCOTT.HANNAN,20072008,COL,2032.9333333333334,2,7,12,19,21,9,1,1,0,89,162,61,38,11,28,1392,1950,1226,1424,61,68,1,30108164.35
SCOTT.HARTNELL,20072008,PHI,1557.4833333333333,26,15,8,23,49,41,13,32,19,197,319,153,63,60,65,1460,1326,1001,1137,44,47,0.40625,30108164.52
SCOTT.NICHOL,20072008,NSH,983.45,10,4,3,7,17,14,441,738,297,102,161,115,19,28,28,730,917,625,624,27,22,0.5975609756097561,30108096.895000003
SCOTT.NIEDERMAYER,20072008,ANA,1294,8,6,13,19,27,14,0,0,0,94,184,44,42,11,10,1089,942,618,565,20,27,0,30108072.735
SCOTT.PARKER,20072008,COL,92.35,0,0,0,0,0,0,0,0,0,5,8,18,2,5,12,66,71,66,68,0,0,0,30108020.7
SCOTT.THORNTON,20072008,L.A,413.43333333333334,5,2,1,3,8,7,17,39,22,35,65,49,11,13,14,280,404,255,387,14,15,0.4358974358974359,30108063.134999998
SCOTT.WALKER,20072008,CAR,963.7833333333333,14,11,7,18,32,25,21,48,27,122,216,98,38,30,NA,1023,718,686,545,24,27,0.4375,NA
SCOTTIE.UPSHALL,20072008,PHI,1050.1166666666666,17,12,8,20,37,29,2,7,5,165,279,117,50,57,42,1049,874,846,767,31,33,0.2857142857142857,30108107.049999997
SEAN.AVERY,20072008,NYR,1016.8333333333334,19,15,6,21,40,34,13,32,19,138,270,138,60,56,45,991,791,754,644,42,27,0.40625,30108092.63
SEAN.BERGENHEIM,20072008,NYI,867.1333333333333,9,6,6,12,21,15,9,15,6,152,248,137,45,20,32,878,738,771,666,25,24,0.6,30108085.71
SEAN.HILL,20072008,MIN,571,2,2,5,7,9,4,0,0,0,19,44,70,16,4,17,393,553,346,486,13,29,0,30108069.665
SEAN.O'DONNELL,20072008,ANA,1506.6166666666668,3,5,3,8,11,8,2,2,0,27,69,56,26,15,28,908,1379,773,875,33,26,1,30108106.505000003
SERGEI.BRYLIN,20072008,N.J,1168.5333333333333,7,4,5,9,16,11,89,194,105,68,126,62,37,11,10,784,938,637,628,22,27,0.4587628865979381,30108082.345
SERGEI.FEDOROV,20072008,CBJ,873.0833333333334,9,11,8,19,28,20,372,682,310,93,172,34,33,12,15,872,539,498,401,19,17,0.5454545454545454,30108071.2
SERGEI.FEDOROV,20072008,WSH,480.1833333333333,3,6,9,15,18,9,266,465,199,52,109,14,29,5,7,537,377,266,234,7,9,0.5720430107526882,30108045.465
SERGEI.GONCHAR,20072008,PIT,2524.883333333333,13,29,37,66,79,42,0,0,0,213,456,82,135,11,35,2295,2286,1163,1376,57,49,0,30108175.285
SERGEI.KOSTITSYN,20072008,MTL,266.56666666666666,3,3,4,7,10,6,4,14,10,29,50,28,11,9,13,262,262,176,205,12,6,0.2857142857142857,30108038.5
SERGEI.SAMSONOV,20072008,CAR,685.55,14,11,7,18,32,25,0,2,2,71,128,11,28,3,5,743,550,465,461,24,18,0,30108070.905
SERGEI.SAMSONOV,20072008,CHI,270.0333333333333,0,3,1,4,4,3,0,1,1,36,59,1,16,6,3,222,187,144,159,6,11,0,30108029.435000002
SERGEI.ZUBOV,20072008,DAL,1459.1333333333332,5,20,16,36,41,25,0,0,0,102,225,25,77,6,7,1279,1054,785,741,36,36,0,30108088.86
SHANE.DOAN,20072008,ARI,1660.2833333333333,28,33,16,49,77,61,77,187,110,243,392,156,84,42,20,1731,1373,1057,1004,47,49,0.4117647058823529,30108149.35
SHANE.HNIDY,20072008,ANA,433.6166666666667,1,1,1,2,3,2,0,0,0,21,47,21,19,4,12,333,328,282,245,8,7,0,30108034.815
SHANE.HNIDY,20072008,BOS,743.9833333333333,2,2,3,5,7,4,0,0,0,34,86,NA,30,11,15,645,662,234,210,3,8,0,30108033.635
SHANE.O'BRIEN,20072008,T.B,1633.8833333333332,4,5,12,17,21,9,0,0,0,68,146,128,48,30,NA,1214,1572,1029,1192,52,52,0,NA
SHAONE.MORRISONN,20072008,WSH,1689.4166666666665,1,4,4,8,9,5,1,1,0,49,126,107,50,12,33,1429,1635,1277,1019,46,55,1,30108097.310000002
SHAWN.BATES,20072008,NYI,14,0,0,0,0,0,0,1,4,3,0,1,2,1,1,0,7,16,7,13,0,2,0.25,30108013.6
SHAWN.HORCOFF,20072008,EDM,1177.7666666666667,21,16,12,28,49,37,487,962,475,115,195,15,37,11,14,1034,1007,627,666,35,30,0.5062370062370062,30108120.990000002
SHAWN.MATTHIAS,20072008,FLA,52.5,2,0,0,0,2,2,17,38,21,5,11,1,1,1,1,38,53,29,49,1,3,0.4473684210526316,30108020.29
SHAWN.THORNTON,20072008,BOS,481.9333333333333,4,1,2,3,7,5,2,8,6,80,126,NA,19,23,20,371,375,143,124,4,4,0.25,30108031.009999998
SHEA.WEBER,20072008,NSH,1169.75,7,9,7,16,23,16,0,0,0,156,323,133,107,13,23,1163,932,765,734,36,34,0,30108084.155
SHEAN.DONOVAN,20072008,OTT,833.3333333333333,6,4,3,7,13,10,14,33,19,94,151,75,27,23,28,700,722,582,605,24,27,0.42424242424242425,30108082.564999998
SHELDON.BROOKBANK,20072008,N.J,665.6,0,3,4,7,7,3,0,0,0,42,109,28,35,7,19,595,560,473,431,17,19,0,30108052.17
SHELDON.SOURAY,20072008,EDM,632.8833333333333,3,2,5,7,10,5,0,0,0,71,177,29,64,4,11,529,570,319,372,10,13,0,30108049.565
SIARHEI.KASTSITSYN,20072008,MTL,662.5,9,11,5,16,25,20,4,12,8,42,82,44,24,21,18,576,615,390,481,25,17,0.3333333333333333,30108075.395
SIDNEY.CROSBY,20072008,PIT,1518.7,30,45,24,69,99,75,774,1527,753,232,379,67,70,64,22,1717,1248,951,986,52,34,0.5068762278978389,30108187.05
SIMON.GAGNE,20072008,PHI,453.6333333333333,7,7,4,11,18,14,1,2,1,76,129,4,27,10,2,437,391,233,296,11,17,0.5,30108052.34
SIMON.GAMACHE,20072008,TOR,105.53333333333333,2,0,2,2,4,2,0,0,0,11,23,10,5,3,3,113,84,104,76,5,5,0,30108019.28
STAFFAN.KRONVALL,20072008,TOR,200.05,0,0,0,0,0,0,0,0,0,8,15,14,3,6,2,179,193,125,116,6,6,0,30108022.560000002
STEFAN.MEYER,20072008,FLA,9.7,0,0,0,0,0,0,3,6,3,0,0,6,0,1,0,5,11,5,11,0,1,0.5,30108013.53
STEFAN.RUZICKA,20072008,PHI,121.21666666666667,1,2,1,3,4,3,0,5,5,10,19,9,4,4,8,87,115,73,106,7,2,0,30108026.465
STEPHANE.ROBIDAS,20072008,DAL,2152.366666666667,12,16,9,25,37,28,0,0,0,193,403,299,140,17,43,1781,1652,1248,1162,59,51,0,30108128.195
STEPHANE.VEILLEUX,20072008,MIN,1184.4666666666667,11,3,3,6,17,14,18,47,29,147,251,120,56,20,29,858,1087,759,790,18,34,0.3829787234042553,30108104.195
STEPHANE.YELLE,20072008,CGY,985.2666666666667,5,5,4,9,14,10,214,419,205,67,115,103,26,17,13,591,870,529,557,16,19,0.5107398568019093,30108082.93
STEPHEN.WEISS,20072008,FLA,1301.4,13,18,11,29,42,31,613,1195,582,132,231,26,52,22,21,1331,1045,899,835,45,33,0.5129707112970712,30108130.515
STEVE.BEGIN,20072008,MTL,665.2833333333333,3,5,3,8,11,8,32,87,55,88,148,NA,29,25,22,545,755,445,471,19,17,0.367816091954023,30108068.655
STEVE.BERNIER,20072008,BUF,234.98333333333335,3,4,2,6,9,7,1,5,4,35,48,29,11,5,1,219,170,159,145,9,6,0.2,30108029.39
STEVE.BERNIER,20072008,S.J,773.25,13,6,4,10,23,19,5,10,5,95,159,127,26,20,19,732,527,498,446,26,26,0.5,30108066.9
STEVE.DOWNIE,20072008,PHI,351.56666666666666,6,5,2,7,13,11,5,15,10,27,43,42,9,22,32,276,295,260,288,15,17,0.3333333333333333,30108052.52
STEVE.EMINGER,20072008,WSH,303.25,1,0,1,1,2,1,0,0,0,15,26,31,10,3,5,259,247,248,233,9,11,0,30108034.005000003
STEVE.KELLY,20072008,MIN,7.45,0,0,0,0,0,0,2,3,1,1,1,0,0,0,0,4,7,4,5,0,0,0.6666666666666666,15054006.63
STEVE.MCCARTHY,20072008,ATL,868.5,1,2,3,5,6,3,0,0,0,41,68,101,11,12,17,573,837,479,701,13,33,0,30108096.345
STEVE.MONTADOR,20072008,FLA,850.0166666666667,8,10,5,15,23,18,0,0,0,96,157,95,34,15,29,847,660,594,571,23,25,0,30108080.175
STEVE.OTT,20072008,DAL,1375.9166666666667,13,9,3,12,25,22,222,391,169,104,194,237,42,56,51,881,1167,752,810,28,34,0.5677749360613811,30108119.314999998
STEVE.REGIER,20072008,NYI,63.88333333333334,0,0,0,0,0,0,0,1,1,7,11,9,2,0,2,44,77,39,44,0,2,0,30108017.049999997
STEVE.STAIOS,20072008,EDM,1805.5833333333333,7,2,7,9,16,9,1,1,0,73,170,81,53,25,48,1229,1894,1065,1307,49,69,1,30108157.115
STEVE.WAGNER,20072008,STL,443.48333333333335,2,2,4,6,8,4,0,0,0,25,56,35,16,4,4,337,369,241,287,12,15,0,30108043.490000002
STEVEN.REINPRECHT,20072008,ARI,1271.3666666666668,16,20,10,30,46,36,514,1013,499,105,195,28,47,20,NA,1324,1037,862,876,38,35,0.5074037512339585,NA
STU.BARNES,20072008,DAL,1233.3333333333333,14,5,6,11,25,19,373,686,313,83,158,17,33,17,12,725,1088,630,723,24,32,0.543731778425656,30108111.44
T.J..HENSICK,20072008,COL,402.4666666666667,6,3,3,6,12,9,115,271,156,55,80,5,13,3,1,333,324,250,295,8,12,0.42435424354243545,30108056.255000003
TANNER.GLASS,20072008,FLA,181.26666666666665,1,1,0,1,2,2,0,2,2,11,16,29,2,11,9,117,185,114,174,4,8,0,30108034.86
TAYLOR.PYATT,20072008,VAN,1246.6,16,12,9,21,37,28,12,36,24,167,249,76,34,16,26,1069,1022,691,771,38,26,0.3333333333333333,30108114.265
TEDDY.PURCELL,20072008,L.A,119.86666666666666,1,2,0,2,3,3,0,0,0,10,23,2,5,2,0,91,116,79,110,5,3,0,30108025.37
TEEMU.SELANNE,20072008,ANA,588.5999999999999,14,7,6,13,27,21,35,76,41,107,162,13,21,16,7,572,365,319,326,16,9,0.4605263157894737,30108061.759999998
TEPPO.NUMMINEN,20072008,BUF,16.05,0,0,0,0,0,0,0,0,0,1,2,0,1,0,0,9,17,0,0,0,0,0,15054005.9
THEO.PECKHAM,20072008,EDM,13.366666666666667,0,0,0,0,0,0,0,0,0,0,2,1,0,0,1,8,10,8,10,0,0,0,15054007.25
THOMAS.POCK,20072008,NYR,18.883333333333333,0,0,0,0,0,0,0,0,0,2,4,1,2,0,0,18,13,16,11,0,2,0,15054006.65
THOMAS.VANEK,20072008,BUF,1356.8166666666666,33,18,9,27,60,51,6,13,7,234,374,45,54,24,36,1458,938,844,773,48,49,0.46153846153846156,30108121.755000003
TIM.BRENT,20072008,PIT,4.566666666666666,0,0,0,0,0,0,3,5,2,0,0,0,0,0,0,0,2,0,2,0,1,0.6,15054006.37
TIM.CONBOY,20072008,CAR,132.36666666666667,0,3,2,5,5,3,0,0,0,16,26,25,5,12,15,135,121,123,96,8,6,0,30108023.27
TIM.CONNOLLY,20072008,BUF,878.8666666666667,7,17,14,31,38,24,213,447,234,107,176,18,36,17,4,909,714,481,480,28,20,0.47651006711409394,30108081.34
TIM.GLEASON,20072008,CAR,1490.6666666666665,3,9,7,16,19,12,0,0,0,98,202,151,58,17,NA,1248,1430,1039,952,52,47,0,NA
TIM.JACKMAN,20072008,NYI,237.98333333333335,1,1,1,2,3,2,2,2,0,36,55,40,12,17,14,201,180,190,161,6,9,1,30108029.325
TIM.RAMHOLT,20072008,CGY,0.75,0,0,0,0,0,0,0,0,0,0,0,0,0,0,0,0,1,0,1,0,1,0,15054006.15
TIMOTHY JR..THOMAS,20072008,BOS,3341.9833333333336,0,0,0,0,0,0,0,0,0,0,1,0,1,4,1,2716,2855,0,0,0,0,0,30108012.04
TOBIAS.ENSTROM,20072008,ATL,2006.4,5,11,22,33,38,16,0,0,0,105,208,21,66,15,21,1577,1754,770,1095,43,50,0,30108141.15
TOBY.PETERSEN,20072008,DAL,218.76666666666668,0,3,0,3,3,3,65,151,86,25,40,28,5,3,3,174,189,149,154,4,8,0.4304635761589404,30108033.33
TODD.BERTUZZI,20072008,ANA,1204.3,14,16,12,28,42,30,52,121,69,131,194,79,25,33,44,1077,764,639,651,37,32,0.4297520661157025,30108104.310000002
TODD.FEDORUK,20072008,DAL,75.15,0,1,1,2,2,1,0,0,0,6,9,12,2,3,7,60,63,60,62,3,1,0,30108019.555
TODD.FEDORUK,20072008,MIN,705.6833333333333,7,2,3,5,12,9,1,7,6,55,84,76,14,25,36,605,531,431,490,22,24,0.14285714285714285,30108073.465
TODD.MARCHANT,20072008,ANA,1217.7333333333336,11,4,3,7,18,15,333,679,346,101,158,98,19,15,22,736,1132,568,665,23,25,0.49042709867452133,30108109.645
TODD.WHITE,20072008,ATL,1363.5166666666664,14,18,5,23,37,32,543,1164,621,111,160,37,24,15,18,965,1319,608,914,32,50,0.46649484536082475,30108164.395
TOM.CAVANAGH,20072008,S.J,13.9,0,1,0,1,1,1,1,3,2,0,2,0,0,0,0,11,10,11,10,1,0,0.3333333333333333,15054007.44
TOM.GILBERT,20072008,EDM,1820.4,13,6,12,18,31,19,0,0,0,98,209,27,76,10,10,1490,1776,1128,1279,61,60,0,30108146.7
TOM.KOSTOPOULOS,20072008,MTL,918.0333333333333,10,5,2,7,17,15,8,28,20,122,193,NA,36,31,NA,747,994,640,665,20,30,0.2857142857142857,NA
TOM.POTI,20072008,WSH,1835.1,2,9,19,28,30,11,0,0,0,108,198,45,61,10,27,1677,1645,1238,974,50,44,0,30108096.875
TOM.PREISSING,20072008,L.A,1377,8,6,9,15,23,14,2,9,7,92,189,22,54,7,8,1267,1178,872,952,43,51,0.2222222222222222,30108112.424999997
TOMAS.FLEISCHMANN,20072008,WSH,966.3000000000001,10,9,11,20,30,19,15,29,14,108,192,28,41,7,9,1015,673,774,619,32,39,0.5172413793103449,30108075.345
TOMAS.HOLMSTROM,20072008,DET,1401.4333333333334,24,12,15,27,51,36,0,1,1,177,313,103,41,40,41,1861,728,1141,624,47,29,0,30108075.325
TOMAS.KABERLE,20072008,TOR,2035.916666666667,8,18,26,44,52,26,1,2,1,155,262,41,69,2,NA,2215,1614,1231,1159,48,53,0.5,NA
TOMAS.KOPECKY,20072008,DET,784.4000000000001,5,5,2,7,12,10,44,108,64,85,174,109,29,20,20,660,491,582,442,20,20,0.4074074074074074,30108058.46
TOMAS.PLEKANEC,20072008,MTL,1677.45,33,28,17,45,78,61,796,1586,790,225,362,42,63,30,NA,1659,1456,933,959,47,39,0.501891551071879,NA
TOMAS.PLIHAL,20072008,S.J,291.25,2,0,1,1,3,2,7,22,15,43,74,30,15,3,2,250,204,228,166,7,4,0.3181818181818182,30108026.835
TOMMY.SESTITO,20072008,CBJ,4.6,0,0,0,0,0,0,0,0,0,0,1,1,1,1,3,5,4,5,4,0,0,0,15054006.66
TONI.LYDMAN,20072008,BUF,1745.5,4,6,15,21,25,10,0,1,1,83,173,155,59,15,36,1309,1710,1014,1092,52,53,0,30108125.424999997
TORREY.MITCHELL,20072008,S.J,1355.65,11,7,5,12,23,18,410,815,405,127,205,NA,32,29,30,967,1196,775,773,25,28,0.5030674846625767,30108119.865000002
TRAVIS.MOEN,20072008,ANA,1303.1666666666665,4,4,2,6,10,8,9,26,17,102,164,168,23,38,29,786,1145,657,789,14,26,0.34615384615384615,30108107.689999998
TRAVIS.ZAJAC,20072008,N.J,1439.25,14,10,11,21,35,24,554,1071,517,158,292,64,74,26,NA,1494,902,924,713,27,31,0.5172735760971056,NA
TRENT.HUNTER,20072008,NYI,1472.8666666666668,12,16,13,29,41,28,6,29,23,217,369,253,77,22,20,1338,1391,866,827,29,40,0.20689655172413793,30108110.185000002
TREVOR.DALEY,20072008,DAL,1963.6166666666668,6,6,12,18,24,12,1,1,0,110,220,48,51,24,40,1496,1583,1202,1135,45,54,1,30108127.880000003
TREVOR.LETOWSKI,20072008,CAR,770.2333333333333,9,4,4,8,17,13,269,601,332,67,112,26,28,13,12,527,816,452,518,17,26,0.4475873544093178,30108088.34
TREVOR.LINDEN,20072008,VAN,666.3499999999999,8,4,0,4,12,12,157,315,158,46,75,48,17,9,6,416,631,339,455,15,15,0.4984126984126984,30108075.92
TROY.BROUWER,20072008,CHI,23.866666666666667,0,1,0,1,1,1,0,0,0,0,3,3,2,0,0,9,13,8,12,2,1,0,15054007.35
TUOMO.RUUTU,20072008,CAR,289.3,4,3,4,7,11,7,2,16,14,29,59,38,11,9,8,263,254,189,187,10,9,0.125,30108035.619999997
TUOMO.RUUTU,20072008,CHI,934.6666666666667,6,13,2,15,21,19,26,49,23,70,130,130,36,36,34,781,612,587,503,33,22,0.5306122448979592,30108069.1
TYLER.ARNASON,20072008,COL,1210.1666666666665,12,12,12,24,36,24,420,885,465,206,300,7,51,26,8,1087,831,802,748,32,33,0.4745762711864407,30108118.36
TYLER.KENNEDY,20072008,PIT,877.9,10,8,5,13,23,18,4,14,10,138,225,75,43,18,16,713,744,587,669,22,17,0.2857142857142857,30108094.965
VACLAV.PROSPAL,20072008,PHI,596.15,7,15,5,20,27,22,97,164,67,74,144,24,43,4,7,625,519,378,449,22,17,0.5914634146341463,30108071.395
VACLAV.PROSPAL,20072008,T.B,1239.4833333333333,29,19,9,28,57,48,95,175,80,175,278,69,51,15,NA,1270,1012,846,868,50,48,0.5428571428571428,NA
VALTTERI.FILPPULA,20072008,DET,1689.7666666666667,24,16,7,23,47,40,415,814,399,161,258,49,45,32,14,1606,1142,1211,876,54,31,0.5098280098280098,30108120.395000003
VERNON.FIDDLER,20072008,NSH,1201.7666666666667,11,13,8,21,32,24,229,444,215,108,183,59,33,28,19,890,1119,704,764,32,37,0.5157657657657657,30108114.09
VIKTOR.KOZLOV,20072008,WSH,1549.5333333333333,16,29,11,40,56,45,203,442,239,232,364,62,53,20,9,1790,1086,1299,959,65,40,0.4592760180995475,30108124.244999997
VILLE.KOISTINEN,20072008,NSH,805.4166666666667,4,7,6,13,17,11,0,0,0,59,130,37,42,11,9,774,602,505,506,32,19,0,30108063.060000002
VILLE.PELTONEN,20072008,FLA,885.9333333333333,5,11,4,15,20,16,3,16,13,108,165,33,24,12,10,732,892,531,619,23,25,0.1875,30108088.740000002
VINCENT.LECAVALIER,20072008,T.B,1859.0833333333335,40,27,25,52,92,67,812,1668,856,318,531,112,117,35,NA,1837,1523,1067,1141,62,72,0.486810551558753,NA
VITALY.VISHNEVSKI,20072008,N.J,1112.5666666666666,2,2,3,5,7,4,0,0,0,49,104,150,32,6,26,836,910,721,663,26,36,0,30108075.835
VLADIMIR.SOBOTKA,20072008,BOS,469.66666666666663,3,3,3,6,9,6,141,285,144,44,83,NA,20,11,11,399,308,146,108,4,3,0.49473684210526314,30108031.025
VYACHESLAV.KOZLOV,20072008,ATL,1306.8666666666668,17,11,13,24,41,28,31,68,37,161,274,27,54,21,13,1140,979,744,812,32,33,0.45588235294117646,30108114.375
WADE.BELAK,20072008,FLA,70.61666666666667,0,0,0,0,0,0,0,0,0,4,6,13,2,3,3,40,76,39,73,1,1,0,30108021.229999997
WADE.BELAK,20072008,TOR,120.96666666666667,1,0,0,0,1,1,0,1,1,13,15,28,1,7,16,76,122,73,114,4,6,0,30108028.57
WADE.BROOKBANK,20072008,CAR,121.6,1,0,1,1,2,1,1,4,3,12,15,19,2,20,16,84,103,76,87,7,3,0.25,30108024.015
WADE.REDDEN,20072008,OTT,1830.9499999999998,6,14,18,32,38,20,0,0,0,139,324,92,111,16,31,1958,1420,1190,1006,70,58,0,30108101.259999998
WAYNE.PRIMEAU,20072008,CGY,548.9833333333333,4,4,3,7,11,8,66,124,58,45,72,54,11,6,17,377,501,364,453,14,17,0.532258064516129,30108070.325
WES.WALZ,20072008,MIN,137.23333333333335,1,1,1,2,3,2,57,122,65,9,15,1,2,1,2,82,144,79,109,4,9,0.4672131147540984,30108028.265
WILLIAM.THOMAS,20072008,ARI,91.98333333333333,0,0,0,0,0,0,0,0,0,9,16,10,1,0,0,73,94,56,91,0,2,0,30108023.15
WILLIE.MITCHELL,20072008,VAN,1667.35,2,5,5,10,12,7,0,0,0,65,141,49,47,15,27,1084,1672,905,1045,38,42,0,30108122.725
WOJTEK.WOLSKI,20072008,COL,1319.3,20,16,17,33,53,36,25,50,25,170,284,62,69,18,8,1147,1043,853,888,49,39,0.5,30108119.805
WYATT.SMITH,20072008,COL,301.75,0,2,1,3,3,2,57,113,56,25,44,10,10,5,4,179,282,166,175,3,9,0.504424778761062,30108033.305
YAN.STASTNY,20072008,STL,131.83333333333334,1,0,1,1,2,1,27,61,34,10,25,16,6,2,3,97,121,91,84,3,4,0.4426229508196721,30108021.875
YANIC.PERREAULT,20072008,CHI,591.7833333333333,8,1,4,5,13,9,279,433,154,52,89,17,25,3,11,434,450,351,362,17,21,0.6443418013856813,30108058.09
ZACH.FITZGERALD,20072008,VAN,13.333333333333334,0,0,0,0,0,0,0,0,0,1,3,1,1,0,0,11,11,11,11,1,1,0,15054006.85
ZACH.PARISE,20072008,N.J,1553.5333333333333,33,20,16,36,69,53,50,104,54,282,462,87,73,33,NA,1745,999,1023,779,41,38,0.4807692307692308,NA
ZACHERY.STORTINI,20072008,EDM,539.3333333333334,3,5,4,9,12,8,3,7,4,38,62,99,13,42,47,397,499,385,491,21,18,0.42857142857142855,30108075.990000002
ZBYNEK.MICHALEK,20072008,ARI,1619.5833333333335,4,5,8,13,17,9,0,0,0,91,187,53,56,11,17,1327,1468,1145,1092,46,42,0,30108116.61
ZDENO.CHARA,20072008,BOS,2236.1000000000004,18,18,14,32,50,36,0,0,0,220,434,243,123,34,NA,2042,1809,521,380,26,17,0,NA
ZENON.KONOPKA,20072008,CBJ,23.71666666666667,0,0,0,0,0,0,11,21,10,4,5,5,1,3,3,14,23,14,23,0,0,0.5238095238095238,30108015.67
AARON.DOWNEY,20082009,DET,20.833333333333332,1,0,1,1,2,1,0,0,0,2,2,11,0,2,2,15,17,15,17,2,2,0,30123016.195
AARON.JOHNSON,20082009,CHI,537.3499999999999,3,1,3,4,7,4,0,0,0,27,57,40,14,6,16,403,459,359,331,23,10,0,30123046.335
AARON.MACKENZIE,20082009,COL,73.16666666666667,0,0,0,0,0,0,0,0,0,3,8,6,3,1,0,56,64,55,45,1,0,0,30123017.060000002
AARON.ROME,20082009,CBJ,139.13333333333333,0,2,0,2,2,2,0,0,0,9,20,15,6,0,0,124,93,110,82,6,3,0,30123020.05
AARON.VOROS,20082009,NYR,630.9833333333333,8,6,2,8,16,14,4,10,6,68,110,121,14,27,41,683,458,512,428,19,24,0.4,30123066.28
AARON.WARD,20082009,BOS,1430.9666666666667,4,2,4,6,10,6,0,0,0,58,141,166,50,8,22,1116,1398,991,1051,46,37,0,30123117.68
ADAM.BURISH,20082009,CHI,794.2166666666667,9,4,1,5,14,13,99,249,150,105,133,81,12,22,27,526,719,495,432,21,14,0.39759036144578314,30123073.205
ADAM.FOOTE,20082009,COL,825.6166666666667,1,1,3,4,5,2,0,0,0,19,43,54,14,2,15,517,949,470,609,19,30,0,30123081.095
ADAM.HALL,20082009,T.B,828.6500000000001,5,3,2,5,10,8,169,337,168,90,143,85,25,21,10,526,848,478,522,12,19,0.5014836795252225,30123080.57
ADAM.MAIR,20082009,BUF,793.4166666666666,8,6,5,11,19,14,200,414,214,75,132,107,22,13,33,654,729,617,679,25,21,0.4830917874396135,30123104.255000003
ADAM.PARDY,20082009,CGY,979.9666666666667,1,5,5,10,11,6,0,0,0,43,105,88,35,16,30,941,808,891,694,36,36,0,30123073.035
ADRIAN.AUCOIN,20082009,CGY,1909.7333333333333,12,8,15,23,35,20,0,0,0,137,311,70,101,7,23,1881,1500,1201,945,46,55,0,30123097.445
ALES.HEMSKY,20082009,EDM,1342.6333333333334,23,24,19,43,66,47,0,3,3,185,333,16,102,38,16,1473,976,904,844,40,36,0,30123116.505000003
ALES.KOTALIK,20082009,BUF,853.2166666666667,13,7,12,19,32,20,30,77,47,152,255,93,64,10,13,860,632,562,559,24,27,0.38961038961038963,30123081.6
ALES.KOTALIK,20082009,EDM,305.76666666666665,7,2,2,4,11,9,6,8,2,55,98,28,21,3,3,295,262,225,239,11,10,0.75,30123042.72
ALEX.BOLDUC,20082009,VAN,51.35,0,0,1,1,1,0,5,13,8,7,9,4,1,0,2,34,46,33,36,2,0,0.38461538461538464,30123017.875
ALEX.BURROWS,20082009,VAN,1551.8833333333332,30,14,10,24,54,44,37,88,51,194,317,82,57,59,53,1255,1367,1067,928,57,39,0.42045454545454547,30123132.12
ALEX.EDLER,20082009,VAN,1895.45,11,13,18,31,42,24,1,1,0,156,364,113,132,11,29,1758,1541,1084,1134,51,38,1,30123130.4
ALEX.FROLOV,20082009,L.A,1533.6333333333332,32,13,14,27,59,45,5,11,6,175,316,49,55,20,16,1542,1300,934,888,37,42,0.45454545454545453,30123128.4
ALEX.GIROUX,20082009,WSH,126.86666666666666,1,1,0,1,2,2,0,1,1,20,38,22,8,1,5,136,98,115,93,5,1,0,30123022.81
ALEX.GOLIGOSKI,20082009,PIT,844.5833333333334,6,9,6,15,21,15,0,0,0,62,142,32,55,10,6,874,610,566,520,29,22,0,30123064.3
ALEX.HENRY,20082009,MTL,13.133333333333333,0,0,0,0,0,0,0,0,0,0,0,2,0,2,2,7,21,7,21,0,2,0,15061509.87
ALEX.KOVALEV,20082009,MTL,1594.6666666666665,28,20,20,40,68,48,16,54,38,221,418,62,108,38,36,1716,1408,960,1026,40,37,0.2962962962962963,30123147.869999997
ALEX.NIKULIN,20082009,ARI,5.583333333333333,0,0,0,0,0,0,0,3,3,1,2,0,1,1,0,4,6,3,6,0,1,0,15061507.56
ALEX.OVECHKIN,20082009,WSH,2144.2666666666664,67,37,27,64,131,104,12,38,26,616,1205,296,330,51,41,2906,1659,1748,1309,82,62,0.3157894736842105,30123168.564999998
ALEX.PICARD,20082009,CBJ,103.1,0,1,0,1,1,1,0,0,0,10,14,28,2,8,6,85,71,82,68,2,3,0,30123021.03
ALEX.PICARD,20082009,OTT,886.8833333333333,6,2,5,7,13,8,0,0,0,72,151,49,50,3,4,904,649,586,551,25,27,0,30123065.505000003
ALEX.PIETRANGELO,20082009,STL,132.11666666666667,0,0,1,1,1,0,0,0,0,7,19,3,8,0,1,147,98,108,92,7,7,0,30123020.225
ALEX.SEMIN,20082009,WSH,1472.5666666666666,39,38,16,54,93,77,13,29,16,265,536,29,138,37,41,1840,1099,1108,846,55,36,0.4482758620689655,30123125.89
ALEX.STEEN,20082009,STL,1081.75,6,12,5,17,23,18,70,166,96,136,238,29,54,10,11,976,959,671,690,18,26,0.42168674698795183,30123096.475
ALEX.STEEN,20082009,TOR,302.6166666666667,2,1,1,2,4,3,38,75,37,29,52,12,10,4,3,249,313,202,210,7,10,0.5066666666666667,30123037.785
ALEX.SULZER,20082009,NSH,13.116666666666667,0,0,0,0,0,0,0,0,0,0,0,0,0,0,0,14,10,13,10,0,0,0,15061507.6
ALEX.TANGUAY,20082009,MTL,835.4666666666667,16,16,10,26,42,32,3,9,6,80,148,47,27,23,18,952,713,537,606,35,22,0.3333333333333333,30123096.2
ALEXEI.PONIKAROVSKY,20082009,TOR,1279.7166666666667,23,22,16,38,61,45,6,11,5,183,326,104,64,14,18,1457,1090,1075,910,56,50,0.5454545454545454,30123119.83
ALEXEI.SEMENOV,20082009,S.J,613.2333333333333,1,2,5,7,8,3,0,1,1,28,68,53,24,14,24,518,482,484,430,16,16,0,30123055.165
ANDERS.ERIKSSON,20082009,CGY,37.400000000000006,0,0,0,0,0,0,0,0,0,2,4,2,1,0,0,25,34,24,29,1,2,0,30123016.45
ANDRE.DEVEAUX,20082009,TOR,152.03333333333333,0,1,0,1,1,1,2,7,5,15,23,44,5,17,19,108,144,102,142,2,4,0.2857142857142857,30123033.200000003
ANDRE.ROY,20082009,CGY,244.1,3,0,0,0,3,3,1,1,0,26,46,42,10,18,25,218,191,214,188,5,6,1,30123036.07
ANDREAS.LILJA,20082009,DET,1004.7166666666667,2,6,2,8,10,8,0,1,1,58,116,93,34,11,21,836,923,776,572,46,35,0,30123059.56
ANDREAS.NODL,20082009,PHI,423.51666666666665,1,3,0,3,4,4,0,0,0,33,62,40,15,5,1,352,389,316,349,5,20,0,30123051.25
ANDREI.KOSTITSYN,20082009,MTL,1210.6166666666668,24,12,6,18,42,36,3,6,3,177,336,131,81,28,19,1334,997,874,873,43,46,0.5,30123118.1
ANDREI.MARKOV,20082009,MTL,1921.0166666666667,12,28,23,51,63,40,0,0,0,165,371,61,136,14,18,2030,1833,1102,1178,49,46,0,30123143.965
ANDREJ.MESZAROS,20082009,T.B,1257.5833333333335,2,5,7,12,14,7,0,1,1,87,182,68,53,10,18,1011,1264,727,813,32,33,0,30123098.225
ANDREJ.SEKERA,20082009,BUF,1426.9833333333333,3,10,4,14,17,13,0,1,1,84,194,64,81,10,11,1271,1319,1005,906,44,51,0,30123094.3
ANDREW.ALBERTS,20082009,PHI,1329.25,1,5,7,12,13,6,0,0,0,48,131,179,56,14,31,1056,1390,953,1037,47,42,0,30123117.115000002
ANDREW.BRUNETTE,20082009,MIN,1353.75,22,23,5,28,50,45,2,9,7,118,170,22,23,14,11,1422,1011,920,934,42,42,0.2222222222222222,30123134.295
ANDREW.COGLIANO,20082009,EDM,1181.05,18,10,9,19,37,28,261,702,441,116,207,57,42,20,11,1033,1039,791,869,35,35,0.3717948717948718,30123138.615000002
ANDREW.EBBETT,20082009,ANA,837.0999999999999,9,16,10,26,35,25,256,549,293,115,183,51,24,11,12,886,650,661,590,35,24,0.4663023679417122,30123095.7
ANDREW.FERENCE,20082009,BOS,1058.5166666666667,1,5,8,13,14,6,0,0,0,75,155,63,49,12,19,941,986,707,714,28,19,0,30123084.47
ANDREW.GORDON,20082009,WSH,7.2,0,0,0,0,0,0,0,0,0,1,3,1,1,0,0,4,8,4,8,0,0,0,15061507.65
ANDREW.HUTCHINSON,20082009,DAL,544.9333333333333,2,2,1,3,5,4,0,0,0,56,108,11,28,1,6,461,465,408,403,14,18,0,30123053.535
ANDREW.HUTCHINSON,20082009,T.B,29.45,0,0,0,0,0,0,0,0,0,2,3,0,1,0,0,27,16,26,14,0,5,0,15061507.5
ANDREW.LADD,20082009,CHI,1399.8833333333332,18,23,12,35,53,41,10,42,32,229,NA,167,NA,27,18,NA,NA,NA,NA,65,44,0.23809523809523808,NA
ANDREW.MACDONALD,20082009,NYI,30.5,0,0,0,0,0,0,0,0,0,1,4,0,2,0,1,28,26,28,25,2,0,0,15061508.7
ANDREW.MURRAY,20082009,CBJ,755,8,2,1,3,11,10,39,85,46,89,135,147,23,11,5,544,618,487,449,14,19,0.4588235294117647,30123064.945
ANDREW.PETERS,20082009,BUF,112.68333333333334,0,1,0,1,1,1,0,1,1,10,15,10,2,15,20,68,86,67,84,1,3,0,30123026.55
ANDY.GREENE,20082009,N.J,844.1500000000001,2,2,6,8,10,4,0,0,0,43,114,37,40,6,11,813,691,626,640,20,19,0,30123076.009999998
ANDY.HILBERT,20082009,NYI,1082.0833333333335,11,13,3,16,27,24,71,185,114,165,294,41,77,13,11,930,1214,757,837,28,30,0.3837837837837838,30123115.545
ANDY.MCDONALD,20082009,STL,971.7833333333333,16,15,16,31,47,31,232,394,162,147,242,26,46,15,11,1041,691,596,564,28,31,0.5888324873096447,30123092.78
ANDY.SUTTON,20082009,NYI,465.3666666666667,2,3,4,7,9,5,0,0,0,19,42,30,19,8,20,345,556,299,412,16,15,0,30123062.48
ANDY.WOZNIEWSKI,20082009,STL,6.733333333333333,0,0,0,0,0,0,0,0,0,0,0,1,0,0,0,2,10,2,10,0,0,0,15061508.15
ANSSI.SALMELA,20082009,ATL,157.66666666666669,1,0,2,2,3,1,0,0,0,8,21,7,8,1,1,119,146,96,121,5,5,0,30123026.310000002
ANSSI.SALMELA,20082009,N.J,257.8666666666667,0,1,2,3,3,1,0,0,0,33,73,17,26,2,4,313,206,190,185,6,5,0,30123029.92
ANTHONY.STEWART,20082009,FLA,451.09999999999997,2,2,3,5,7,4,1,3,2,56,87,77,10,14,9,353,450,346,442,6,14,0.3333333333333333,30123067.205
ANTOINE.VERMETTE,20082009,CBJ,398.35,7,5,1,6,13,12,226,418,192,39,59,22,10,6,9,308,373,221,232,12,11,0.5406698564593302,30123052.375
ANTOINE.VERMETTE,20082009,OTT,1119.1666666666665,9,13,5,18,27,22,450,770,320,141,227,64,45,13,19,922,1085,634,714,19,30,0.5844155844155844,30123114.655
ANTON.BABCHUK,20082009,CAR,1509.6,16,9,11,20,36,25,0,0,0,148,320,29,102,9,13,1594,1298,1192,1011,45,42,0,30123109.915
ANTON.STRALMAN,20082009,TOR,571.6333333333333,1,3,8,11,12,4,1,1,0,42,99,34,32,8,10,617,466,421,374,19,20,1,30123047.520000003
ANTON.VOLCHENKOV,20082009,OTT,1369.5833333333333,2,7,1,8,10,9,0,0,0,78,182,182,60,7,18,1019,1300,879,870,23,35,0,30123099.595
ANTTI.MIETTINEN,20082009,MIN,1496.7666666666667,15,17,10,27,42,32,28,60,32,185,318,69,61,10,15,1270,1296,821,903,32,34,0.4666666666666667,30123127.47
ANTTI.PIHLSTROM,20082009,NSH,606.7666666666667,2,3,2,5,7,5,0,1,1,88,152,100,30,9,4,563,456,529,417,12,13,0,30123051.64
ANZE.KOPITAR,20082009,L.A,1676.9666666666667,27,28,11,39,66,55,671,1355,684,234,433,84,87,28,12,1871,1299,1140,965,49,51,0.4952029520295203,30123157.245
ARRON.ASHAM,20082009,PHI,729.7833333333333,9,7,6,13,22,16,8,16,8,78,121,151,26,39,42,593,641,575,621,32,34,0.5,30123090.71
ARTEM.ANISIMOV,20082009,NYR,15.033333333333331,0,0,0,0,0,0,3,7,4,1,1,0,0,0,0,6,11,6,11,0,0,0.42857142857142855,30123015.07
B.J..CROMBEEN,20082009,DAL,123.61666666666667,1,3,1,4,5,4,0,0,0,12,25,13,2,8,7,97,104,94,99,6,6,0,30123026.605
B.J..CROMBEEN,20082009,STL,946.0333333333333,11,4,2,6,17,15,3,7,4,114,198,75,37,35,43,748,826,692,703,19,30,0.42857142857142855,30123098.67
BARRET.JACKMAN,20082009,STL,2023.3333333333333,4,9,7,16,20,13,0,0,0,92,186,133,54,25,37,1460,2056,1226,1291,48,69,0,30123149.225
BARRY.TALLACKSON,20082009,N.J,17.95,0,0,0,0,0,0,0,1,1,2,2,5,0,0,0,24,13,21,9,0,0,0,30123013.95
BEN.EAGER,20082009,CHI,784.1666666666666,12,3,2,5,17,15,0,0,0,95,160,140,36,37,56,657,580,635,566,27,27,0,30123080.92
BEN.GUITE,20082009,COL,635.9666666666667,5,3,4,7,12,8,286,555,269,62,106,88,22,10,14,437,677,402,440,17,17,0.5153153153153153,30123074.89
BEN.LOVEJOY,20082009,PIT,23.766666666666666,0,0,0,0,0,0,0,0,0,1,1,1,0,0,0,14,22,13,22,1,1,0,30123016.049999997
BEN.MAXWELL,20082009,MTL,69.41666666666666,0,0,0,0,0,0,20,53,33,2,9,2,3,2,1,48,75,47,71,0,1,0.37735849056603776,30123023.07
BEN.WALTER,20082009,NYI,43.88333333333333,0,0,0,0,0,0,18,43,25,2,7,2,4,0,0,31,48,24,37,0,2,0.4186046511627907,30123018.42
BENJAMIN.ONDRUS,20082009,TOR,104,0,0,0,0,0,0,12,27,15,2,8,15,3,7,7,62,148,57,94,0,3,0.4444444444444444,30123026.15
BENOIT.POULIOT,20082009,MIN,438.25,5,2,4,6,11,7,93,217,124,34,56,21,12,3,9,369,350,252,311,11,8,0.42857142857142855,30123057.35
BILL.GUERIN,20082009,NYI,1050.05,16,9,11,20,36,25,27,61,34,182,314,59,71,15,23,1108,912,669,800,23,31,0.4426229508196721,30123117.055
BILL.GUERIN,20082009,PIT,641.2166666666667,12,9,6,15,27,21,6,8,2,112,182,38,31,7,11,704,523,457,471,30,16,0.75,30123073.310000002
BLAIR.BETTS,20082009,NYR,914.5333333333333,6,3,1,4,10,9,469,965,496,84,135,99,21,9,8,526,975,437,502,12,24,0.48601036269430054,30123093.525
BLAKE.COMEAU,20082009,NYI,862.6166666666666,7,10,8,18,25,17,14,45,31,78,164,90,46,12,12,776,849,565,692,23,37,0.3111111111111111,30123096.93
BLAKE.WHEELER,20082009,BOS,1194.4166666666667,21,15,9,24,45,36,13,35,22,153,249,54,39,15,22,1110,1132,939,875,59,26,0.37142857142857144,30123118.795
BOBBY.HOLIK,20082009,N.J,647.7833333333333,4,2,4,6,10,6,305,521,216,82,126,135,22,11,35,586,490,540,475,14,14,0.5854126679462572,30123073.759999998
BOBBY.RYAN,20082009,ANA,1243.5,36,13,15,28,64,49,6,14,8,223,359,96,58,28,14,1369,850,953,779,60,39,0.42857142857142855,30123112.345
BORIS.VALABIK,20082009,ATL,762.2333333333333,0,4,1,5,5,4,0,0,0,16,50,78,22,27,48,531,831,497,636,19,33,0,30123088.445
BOYD.DEVEREAUX,20082009,TOR,314.93333333333334,6,3,2,5,11,9,4,9,5,41,60,21,12,4,1,254,393,234,276,10,11,0.4444444444444444,30123048.35
BOYD.GORDON,20082009,WSH,1005.6,5,6,5,11,16,11,450,787,337,79,136,42,25,8,10,597,1111,529,576,15,23,0.5717916137229987,30123092.505
BOYD.KANE,20082009,PHI,8.2,0,0,0,0,0,0,0,0,0,0,2,2,2,0,0,7,10,7,10,0,0,0,15061507.6
BRAD.BOYES,20082009,STL,1655.8333333333335,34,25,15,40,74,59,156,322,166,232,438,49,85,19,14,1811,1206,1046,1044,42,57,0.484472049689441,30123158.055
BRAD.LUKOWICH,20082009,S.J,1027.2833333333333,0,5,2,7,7,5,0,0,0,49,104,129,35,7,6,894,847,835,690,26,27,0,30123072.42
BRAD.MAY,20082009,ANA,127.3,0,3,2,5,5,3,1,3,2,5,13,19,5,7,8,91,126,91,125,6,1,0.3333333333333333,30123029.46
BRAD.MAY,20082009,TOR,293.73333333333335,1,0,1,1,2,1,0,1,1,27,49,34,11,9,17,235,294,215,283,7,13,0,30123047.315
BRAD.RICHARDS,20082009,DAL,1146.7833333333333,16,17,15,32,48,33,461,911,450,180,313,11,63,7,3,1103,910,628,649,32,39,0.5060373216245884,30123114.285
BRAD.RICHARDSON,20082009,L.A,334.6666666666667,0,4,1,5,5,4,51,94,43,37,67,26,19,4,5,264,294,254,282,6,13,0.5425531914893617,30123045.905
BRAD.STAUBITZ,20082009,S.J,217.61666666666667,1,2,0,2,3,3,0,2,2,22,40,56,11,20,25,168,142,160,139,3,3,0,30123031.200000003
BRAD.STUART,20082009,DET,1887.5833333333333,5,10,8,18,23,15,0,0,0,138,287,208,84,13,19,1635,1723,1408,1258,64,62,0,30123129.08
BRAD.WINCHESTER,20082009,STL,825.2,13,7,1,8,21,20,9,20,11,86,166,142,37,27,34,693,716,539,673,23,24,0.45,30123101.655
BRANDON.BOCHENSKI,20082009,T.B,75.51666666666667,0,0,1,1,1,0,0,0,0,11,14,3,3,1,1,65,51,49,45,1,3,0,30123017.985
BRANDON.DUBINSKY,20082009,NYR,1491.75,14,18,13,31,45,32,524,986,462,197,326,273,64,45,44,1569,1178,1134,936,43,43,0.5314401622718052,30123136.585
BRANDON.PRUST,20082009,ARI,109.8,0,1,0,1,1,1,9,16,7,8,13,13,1,5,6,79,114,77,113,2,5,0.5625,30123028.310000002
BRANDON.PRUST,20082009,CGY,158.70000000000002,1,0,1,1,2,1,8,15,7,15,24,11,4,18,19,149,88,147,85,3,6,0.5333333333333333,30123022.675
BRANDON.SEGAL,20082009,T.B,27.583333333333332,0,0,0,0,0,0,0,0,0,2,6,4,0,0,0,25,22,22,20,0,0,0,15061508.75
BRANDON.SUTTER,20082009,CAR,441.25,1,3,2,5,6,4,128,332,204,57,84,37,11,15,5,318,531,295,326,9,11,0.3855421686746988,30123059.82
BRAYDON.COBURN,20082009,PHI,2128.95,7,10,13,23,30,17,0,0,0,133,290,162,97,20,41,1998,2036,1363,1323,59,62,0,30123144.775
BRENDAN.BELL,20082009,OTT,939.5166666666667,6,7,8,15,21,13,0,0,0,76,151,29,45,6,11,890,703,625,624,34,32,0,30123078.16
BRENDAN.MIKKELSON,20082009,ANA,473.8333333333333,0,2,0,2,2,2,0,0,0,19,40,19,13,5,6,349,413,329,360,15,17,0,30123049.85
BRENDAN.MORRISON,20082009,ANA,858.7666666666667,10,7,5,12,22,17,161,350,189,82,135,27,22,8,8,770,652,557,568,23,19,0.46,30123088.545
BRENDAN.MORRISON,20082009,DAL,292.31666666666666,6,2,1,3,9,8,43,100,57,29,59,6,15,8,8,279,229,185,179,10,6,0.43,30123037.875
BRENDAN.SHANAHAN,20082009,N.J,623.8333333333333,6,5,5,10,16,11,12,28,16,101,157,24,25,5,13,589,555,370,433,14,18,0.42857142857142855,30123069.155
BRENDAN.WITT,20082009,NYI,1320.0333333333333,0,1,7,8,8,1,1,2,1,52,116,142,40,13,33,950,1709,847,1172,26,58,0.5,30123145.845
BRENDEN.MORROW,20082009,DAL,384.31666666666666,5,6,4,10,15,11,3,9,6,52,89,53,17,9,18,353,328,191,225,9,14,0.3333333333333333,30123046.56
BRENT.BURNS,20082009,MIN,1320.5833333333335,8,10,9,19,27,18,3,5,2,146,317,58,89,16,20,1196,1147,777,841,30,34,0.6,30123105.255
BRENT.SEABROOK,20082009,CHI,2353.5,9,13,14,27,36,22,0,0,0,168,NA,290,NA,19,34,NA,NA,NA,NA,65,54,0,NA
BRENT.SOPEL,20082009,CHI,317.6333333333333,1,1,0,1,2,2,0,0,0,15,31,14,9,2,4,218,355,210,227,8,13,0,30123037.119999997
BRET.HEDICAN,20082009,ANA,831.5,1,1,4,5,6,2,0,0,0,40,95,51,35,4,18,777,648,667,528,28,34,0,30123056.189999998
BRETT.CARSON,20082009,CAR,78.65,0,0,0,0,0,0,0,0,0,2,5,6,3,1,3,52,76,36,32,0,3,0,30123016.61
BRETT.CLARK,20082009,COL,1696.65,2,5,3,8,10,7,0,0,0,97,219,73,79,6,17,1355,1702,968,1189,37,57,0,30123137.884999998
BRETT.FESTERLING,20082009,ANA,681.4833333333333,0,3,2,5,5,3,0,0,0,15,50,90,21,11,9,460,641,426,448,14,10,0,30123058.16
BRETT.LEBDA,20082009,DET,1182.0500000000002,6,8,7,15,21,14,1,1,0,88,192,48,59,10,29,1133,829,1070,782,45,25,1,30123079.665
BRETT.MCLEAN,20082009,FLA,994.0999999999999,7,6,6,12,19,13,197,456,259,114,193,30,45,13,13,801,994,672,828,24,35,0.43201754385964913,30123121.16
BRETT.SKINNER,20082009,NYI,128.85,0,0,0,0,0,0,0,0,0,5,11,1,5,0,2,115,124,95,120,6,3,0,30123025.65
BRETT.STERLING,20082009,ATL,83.31666666666666,1,0,0,0,1,1,0,0,0,11,15,5,4,6,1,63,90,47,83,1,4,0,30123024.31
BRETT.SUTTER,20082009,CGY,32.25,1,0,0,0,1,1,0,1,1,6,10,1,2,1,1,32,26,30,25,2,4,0,30123016.36
BRIAN.BOYLE,20082009,L.A,283.9166666666667,4,0,1,1,5,4,102,225,123,36,58,66,13,10,16,215,229,202,226,5,14,0.4533333333333333,30123046.905
BRIAN.CAMPBELL,20082009,CHI,2199.45,9,26,25,51,60,35,0,0,0,135,299,45,94,15,11,2282,1404,1516,1180,71,64,0,30123120.975
BRIAN.GIONTA,20082009,N.J,1499.1333333333332,22,26,17,43,65,48,66,154,88,271,472,48,95,20,18,1580,1157,1107,918,52,40,0.42857142857142855,30123124.965
BRIAN.LEE,20082009,OTT,1000.95,2,2,8,10,12,4,0,0,0,51,114,58,34,14,15,838,834,667,673,26,26,0,30123080.14
BRIAN.MCGRATTAN,20082009,ARI,27.6,0,0,0,0,0,0,0,0,0,2,3,2,1,3,3,17,35,17,35,0,2,0,15061511.58
BRIAN.POTHIER,20082009,WSH,367.66666666666663,1,2,2,4,5,3,0,0,0,19,46,28,19,1,6,397,306,349,286,14,11,0,30123037.810000002
BRIAN.RAFALSKI,20082009,DET,2187.116666666667,12,27,26,53,65,39,0,0,0,164,369,43,123,11,14,2531,1443,1630,1165,75,49,0,30123112.66
BRIAN.ROLSTON,20082009,N.J,1065.6,16,9,8,17,33,25,96,211,115,192,356,51,91,8,18,1165,819,688,720,32,25,0.4549763033175355,30123102.57
BRIAN.SALCIDO,20082009,ANA,24.583333333333332,0,1,0,1,1,1,0,0,0,1,3,2,0,0,0,21,20,18,19,2,0,0,15061509
BRIAN.SUTHERBY,20082009,ANA,122.33333333333334,3,2,1,3,6,5,22,45,23,17,26,21,3,6,4,82,120,74,80,8,2,0.4888888888888889,30123025.865
BRIAN.SUTHERBY,20082009,DAL,521.4333333333334,5,1,3,4,9,6,90,219,129,49,82,81,15,11,12,346,525,328,397,12,16,0.410958904109589,30123066.785
BRIAN.WILLSIE,20082009,COL,494.91666666666663,1,2,1,3,4,3,30,89,59,59,108,36,22,2,7,378,477,352,374,6,12,0.33707865168539325,30123056.345
BROOKS.LAICH,20082009,WSH,1661.6166666666668,26,21,13,34,60,47,291,560,269,209,340,110,65,36,17,1756,1514,1086,941,44,43,0.5196428571428572,30123138.625
BROOKS.ORPIK,20082009,PIT,2069.4833333333336,2,5,15,20,22,7,0,0,0,51,143,416,58,32,43,1622,2146,1430,1631,78,77,0,30123180.845
BRUNO.GERVAIS,20082009,NYI,1489.8,3,6,9,15,18,9,0,1,1,82,191,83,67,7,15,1265,1639,1049,1233,38,54,0,30123142.795
BRYAN.ALLEN,20082009,FLA,54.36666666666667,0,0,1,1,1,0,0,0,0,5,7,5,1,0,0,46,50,40,32,3,0,0,30123016.025
BRYAN.HELMER,20082009,WSH,198.85,0,2,1,3,3,2,0,0,0,8,24,13,8,3,1,180,167,143,125,5,4,0,30123024.905
BRYAN.LITTLE,20082009,ATL,1335.1666666666667,31,16,4,20,51,47,93,213,120,172,268,40,49,25,12,1325,975,733,847,48,48,0.43661971830985913,30123135.87
BRYAN.MCCABE,20082009,FLA,1596.4666666666667,15,10,12,22,37,25,0,0,0,153,308,72,107,8,18,1640,1330,998,1132,51,47,0,30123137.03
BRYAN.RODNEY,20082009,CAR,101,0,0,2,2,2,0,0,0,0,3,10,2,5,1,1,109,85,75,73,2,5,0,30123020.11
BRYCE.SALVADOR,20082009,N.J,1542.5666666666666,3,3,9,12,15,6,1,1,0,72,160,128,52,16,32,1146,1555,1033,1107,38,44,1,30123127.375
BYRON.BITZ,20082009,BOS,419.95,5,3,1,4,9,8,23,55,32,35,53,83,10,6,7,328,312,307,288,9,10,0.41818181818181815,30123047.955
CAL.CLUTTERBUCK,20082009,MIN,1014.0999999999999,11,5,2,7,18,16,2,17,15,134,252,356,50,49,24,759,957,689,801,23,29,0.11764705882352941,30123110.369999997
CAL.O'REILLY,20082009,NSH,138.63333333333333,3,1,1,2,5,4,35,88,53,6,10,0,2,2,1,106,116,100,105,7,3,0.3977272727272727,30123028.395
CAM.BARKER,20082009,CHI,1530.2166666666667,9,17,23,40,49,26,0,1,1,133,298,113,98,12,20,1446,1028,933,792,36,47,0,30123092.744999997
CAM.JANSSEN,20082009,STL,285.23333333333335,1,2,1,3,4,3,0,2,2,22,38,69,2,25,30,166,249,164,245,10,14,0,30123048.075
CAM.PADDOCK,20082009,STL,170.8,2,0,1,1,3,2,40,87,47,17,23,7,4,2,0,86,198,82,131,3,5,0.45977011494252873,30123032.295
CARLO.COLAIACOVO,20082009,STL,1253.6666666666665,3,14,11,25,28,17,0,0,0,89,175,60,50,7,14,1250,867,772,742,38,34,0,30123090.245
CARLO.COLAIACOVO,20082009,TOR,151.4,0,0,1,1,1,0,0,0,0,7,17,10,5,3,3,142,150,114,100,4,5,0,30123022.355
CASEY.BORER,20082009,CAR,33.266666666666666,0,0,0,0,0,0,0,0,0,0,0,3,0,1,1,21,38,17,29,1,1,0,30123017.009999998
CHAD.LAROSE,20082009,CAR,1529.9833333333331,22,11,7,18,40,33,9,25,16,218,369,161,77,29,23,1399,1463,1261,1152,51,51,0.36,30123141.375
CHRIS.BOURQUE,20082009,WSH,78.18333333333334,1,0,0,0,1,1,0,0,0,11,19,8,3,1,0,72,48,65,46,2,2,0,30123017.66
CHRIS.BUTLER,20082009,BUF,785.7,2,2,2,4,6,4,0,0,0,36,74,37,21,9,9,599,826,546,684,27,18,0,30123087.49
CHRIS.CAMPOLI,20082009,NYI,1011.5333333333333,6,5,6,11,17,11,0,0,0,52,113,56,39,13,16,904,993,644,771,19,39,0,30123100.78
CHRIS.CAMPOLI,20082009,OTT,473.9333333333333,5,3,4,7,12,8,0,0,0,38,70,25,24,6,6,421,377,288,348,17,13,0,30123053.46
CHRIS.CHELIOS,20082009,DET,370.93333333333334,0,0,0,0,0,0,0,0,0,18,48,25,16,8,9,340,278,325,220,10,9,0,30123028.68
CHRIS.CLARK,20082009,WSH,422.4166666666667,2,2,3,5,7,4,4,7,3,43,86,57,23,12,18,394,372,335,359,9,14,0.5714285714285714,30123053.605
CHRIS.CONNER,20082009,DAL,415.45,3,6,4,10,13,9,0,1,1,34,67,37,16,6,5,360,340,336,330,16,22,0,30123049.66
CHRIS.DRURY,20082009,NYR,1721.0666666666666,23,19,15,34,57,42,626,1225,599,224,407,48,89,17,16,1721,1577,1029,1070,36,47,0.5110204081632653,30123168.935000002
CHRIS.DURNO,20082009,COL,12.05,0,0,0,0,0,0,0,0,0,3,6,6,0,1,0,14,13,14,13,1,0,0,15061508.01
CHRIS.GRATTON,20082009,CBJ,58.58333333333333,0,1,0,1,1,1,22,49,27,4,9,4,1,0,1,39,45,35,40,2,0,0.4489795918367347,30123019.33
CHRIS.GRATTON,20082009,T.B,194.36666666666667,0,1,1,2,2,1,112,180,68,16,24,33,6,2,5,123,208,117,141,3,6,0.6222222222222222,30123031.925
CHRIS.HIGGINS,20082009,MTL,1038.7666666666667,14,8,3,11,25,22,31,59,28,159,282,86,62,16,12,939,1023,648,707,29,30,0.5254237288135594,30123098.924999997
CHRIS.KELLY,20082009,OTT,1279.1999999999998,12,8,2,10,22,20,234,494,260,118,193,97,42,13,13,872,1251,771,816,25,39,0.47368421052631576,30123118.89
CHRIS.KUNITZ,20082009,ANA,1022.15,16,13,6,19,35,29,10,22,12,138,234,148,54,22,19,1124,765,885,678,35,26,0.45454545454545453,30123086.869999997
CHRIS.KUNITZ,20082009,PIT,714.1,8,9,13,22,30,17,6,11,5,85,158,137,29,15,16,788,614,503,521,30,21,0.5454545454545454,30123076.165
CHRIS.NEIL,20082009,OTT,658.4,3,5,2,7,10,8,1,6,5,59,98,163,24,39,39,554,531,469,511,15,24,0.16666666666666666,30123075.28
CHRIS.PHILLIPS,20082009,OTT,1793.1,6,6,8,14,20,12,0,0,0,88,183,113,64,13,33,1434,1689,1194,1124,39,56,0,30123124.53
CHRIS.PORTER,20082009,STL,63.18333333333334,1,0,1,1,2,1,1,3,2,7,10,3,2,2,0,33,66,30,48,2,3,0.3333333333333333,30123019.835
CHRIS.PRONGER,20082009,ANA,2561.616666666667,13,18,26,44,57,31,2,7,5,222,492,93,151,14,46,2352,2232,1373,1377,63,57,0.2857142857142857,30123158.62
CHRIS.STEWART,20082009,COL,653.2333333333333,11,5,3,8,19,16,7,21,14,98,152,80,27,21,15,555,667,446,606,15,31,0.3333333333333333,30123094.465
CHRIS.THORBURN,20082009,ATL,786.4333333333334,7,4,4,8,15,11,15,37,22,85,131,127,24,30,30,653,765,631,748,22,32,0.40540540540540543,30123104.65
CHRISTIAN.BACKMAN,20082009,CBJ,875.9,2,2,3,5,7,4,0,1,1,54,136,40,55,10,16,870,575,645,477,25,18,0,30123048.775
CHRISTIAN.EHRHOFF,20082009,S.J,1783.8333333333333,8,21,13,34,42,29,0,0,0,185,385,87,113,20,30,1764,1401,1175,1001,37,48,0,30123114.475
CHRISTIAN.HANSON,20082009,TOR,81.61666666666666,1,0,1,1,2,1,1,4,3,9,21,3,7,1,1,109,72,73,66,2,3,0.25,30123019.925
CHRISTOPH.SCHUBERT,20082009,OTT,679.8333333333333,3,2,1,3,6,5,0,0,0,57,119,107,35,2,13,510,652,376,482,19,25,0,30123066.995
CHUCK.KOBASEW,20082009,BOS,1162.6166666666666,24,16,8,24,48,40,5,26,21,150,231,123,41,25,30,989,957,745,871,43,33,0.19230769230769232,30123133.75
CLARKE.MACARTHUR,20082009,BUF,979.55,17,10,4,14,31,27,75,216,141,108,176,80,38,19,24,924,820,719,698,29,33,0.3472222222222222,30123105.39
CLAUDE.GIROUX,20082009,PHI,732.3499999999999,11,12,9,21,32,23,173,369,196,76,144,47,33,13,10,712,642,562,534,29,21,0.46883468834688347,30123084.674999997
CLAUDE.LEMIEUX,20082009,S.J,142.96666666666667,0,0,1,1,1,0,3,14,11,18,32,35,7,2,5,114,97,113,92,2,7,0.21428571428571427,30123022.564999998
CLAY.WILSON,20082009,ATL,31.816666666666666,0,0,0,0,0,0,0,0,0,4,5,2,1,0,0,25,27,20,25,0,1,0,15061509.55
CLAY.WILSON,20082009,CBJ,47.13333333333333,0,0,1,1,1,0,0,0,0,9,16,4,3,0,0,66,17,22,14,0,2,0,30123014.575
CODY.BASS,20082009,OTT,68.18333333333334,0,0,0,0,0,0,21,50,29,5,9,24,1,4,3,44,59,43,55,1,3,0.42,30123021.28
CODY.MCCORMICK,20082009,COL,528.1,1,9,2,11,12,10,38,107,69,66,98,115,16,18,28,387,476,372,446,16,22,0.35514018691588783,30123073.55
CODY.MCLEOD,20082009,COL,913.9000000000001,15,3,2,5,20,18,2,5,3,118,196,192,39,37,50,699,944,627,806,29,35,0.4,30123119.05
COLBY.ARMSTRONG,20082009,ATL,1242.8,22,9,9,18,40,31,8,28,20,141,212,88,34,27,32,1107,1061,883,888,46,38,0.2857142857142857,30123124.615000002
COLIN (JOHN).WHITE,20082009,N.J,1489.1,1,4,13,17,18,5,0,1,1,71,139,145,37,12,27,1162,1391,1046,961,48,47,0,30123104.245
COLIN.FRASER,20082009,CHI,905.0666666666666,6,5,5,10,16,11,384,795,411,72,98,61,13,26,18,565,954,518,482,18,19,0.4830188679245283,30123085.845
COLIN.STUART,20082009,ATL,411.93333333333334,5,1,2,3,8,6,5,12,7,54,92,59,19,13,9,293,469,241,285,10,11,0.4166666666666667,30123048.53
COLTON.GILLIES,20082009,MIN,370.18333333333334,2,3,2,5,7,5,1,2,1,21,48,54,13,9,9,261,337,235,329,7,11,0.5,30123053.83
COLTON.ORR,20082009,NYR,551.1500000000001,1,1,3,4,5,2,4,16,12,40,72,139,10,33,51,380,468,366,451,7,24,0.25,30123072.314999998
CONNOR.JAMES,20082009,PIT,8.25,0,0,0,0,0,0,0,0,0,0,1,0,0,1,0,7,8,7,7,0,0,0,15061507.46
COREY.PERRY,20082009,ANA,1736.8833333333332,40,33,13,46,86,73,12,35,23,324,515,128,67,58,58,2050,1208,1344,1084,74,50,0.34285714285714286,30123161.384999998
COREY.POTTER,20082009,NYR,66.23333333333333,1,1,0,1,2,2,0,0,0,4,6,4,1,0,0,64,72,59,63,2,3,0,30123021
CORY.MURPHY,20082009,FLA,71.16666666666666,0,1,0,1,1,1,0,0,0,8,19,1,9,0,1,80,51,49,41,2,1,0,30123016.65
CORY.MURPHY,20082009,T.B,503.4666666666667,5,6,3,9,14,11,0,0,0,47,111,12,45,3,6,514,409,302,300,11,7,0,30123045.305
CORY.SARICH,20082009,CGY,1435.5,2,9,8,17,19,11,0,0,0,59,167,142,66,20,44,1182,1247,1056,829,46,31,0,30123084.95
CORY.STILLMAN,20082009,FLA,1045.2333333333333,17,19,13,32,49,36,11,30,19,115,226,67,54,16,17,1106,833,679,743,37,26,0.36666666666666664,30123109.975
CRAIG.ADAMS,20082009,CHI,313.96666666666664,2,3,1,4,6,5,6,15,9,38,67,53,13,9,6,256,267,234,235,4,8,0.4,30123040.905
CRAIG.ADAMS,20082009,PIT,298.48333333333335,3,3,0,3,6,6,41,90,49,35,54,45,11,5,4,208,342,187,188,3,6,0.45555555555555555,30123038.44
CRAIG.CONROY,20082009,CGY,1320.4833333333333,11,25,12,37,48,36,760,1446,686,108,166,52,32,27,14,1178,1259,1066,797,54,44,0.5255878284923928,30123123.67
CRAIG.MACDONALD,20082009,CBJ,85.21666666666667,1,0,1,1,2,1,4,11,7,6,9,7,2,0,0,50,70,42,59,2,1,0.36363636363636365,30123021.035
CRAIG.RIVET,20082009,BUF,1295.3000000000002,2,15,7,22,24,17,0,0,0,80,168,57,54,17,37,1092,1245,782,890,40,34,0,30123113.695
CRAIG.WELLER,20082009,MIN,250.36666666666667,1,1,1,2,3,2,0,5,5,27,46,60,7,13,12,180,232,149,227,4,7,0,30123043.305
CURTIS.GLENCROSS,20082009,CGY,1161.5666666666666,12,19,11,30,42,31,28,58,30,155,257,131,43,22,18,1160,985,999,696,46,39,0.4827586206896552,30123086.165
DAINIUS.ZUBRUS,20082009,N.J,1349.6,15,15,11,26,41,30,508,986,478,144,227,118,41,21,33,1451,973,1076,875,46,42,0.5152129817444219,30123128.655
DAN.BOYLE,20082009,S.J,2047.2333333333336,18,17,26,43,61,35,0,1,1,231,456,57,132,29,29,2341,1428,1377,1052,49,45,0,30123115.439999998
DAN.CARCILLO,20082009,ARI,646.9,3,4,3,7,10,7,10,18,8,94,157,121,32,44,44,556,643,459,605,14,28,0.5555555555555556,30123090.965
DAN.CARCILLO,20082009,PHI,246.31666666666666,1,2,3,5,6,3,3,4,1,39,56,41,12,14,15,235,225,232,222,11,10,0.75,30123038.134999998
DAN.CLEARY,20082009,DET,1625.4,23,15,15,30,53,38,74,132,58,217,333,171,48,25,28,1615,1357,1275,985,59,46,0.5606060606060606,30123124.384999998
DAN.FRITSCHE,20082009,MIN,379.20000000000005,4,3,2,5,9,7,36,87,51,34,62,35,13,2,5,282,353,243,301,6,12,0.41379310344827586,30123052.91
DAN.FRITSCHE,20082009,NYR,152.71666666666667,1,2,1,3,4,3,5,7,2,20,36,18,6,3,1,127,148,116,143,4,6,0.7142857142857143,30123030.755
DAN.GIRARDI,20082009,NYR,1912.85,4,5,12,17,21,9,0,0,0,134,336,228,138,13,20,1864,1736,1359,1249,36,50,0,30123123.08
DAN.HAMHUIS,20082009,NSH,1870.4833333333333,3,11,10,21,24,14,0,0,0,134,245,133,72,21,28,1419,1829,1112,1273,45,59,0,30123151.31
DAN.HINOTE,20082009,STL,582.3333333333333,1,1,3,4,5,2,35,77,42,25,42,91,7,27,21,302,660,272,419,13,23,0.45454545454545453,30123067.645000003
DAN.JANCEVSKI,20082009,DAL,45.983333333333334,0,0,0,0,0,0,0,0,0,4,6,4,2,0,0,28,50,27,45,2,2,0,30123018.5
DAN.LACOUTURE,20082009,CAR,46.983333333333334,2,0,0,0,2,2,4,10,6,4,5,9,1,2,2,39,57,34,52,2,3,0.4,30123021.33
DANIEL.ALFREDSSON,20082009,OTT,1649.2666666666667,24,28,22,50,74,52,4,17,13,202,347,57,82,23,12,1727,1325,1028,923,52,41,0.23529411764705882,30123127.04
DANIEL.BRIERE,20082009,PHI,554.1166666666667,12,9,8,17,29,21,79,168,89,64,118,16,31,14,16,601,468,343,407,20,18,0.47023809523809523,30123073.1
DANIEL.PAILLE,20082009,BUF,868.3,12,11,4,15,27,23,3,17,14,80,145,84,32,14,10,618,845,575,681,34,34,0.17647058823529413,30123098.060000002
DANIEL.SEDIN,20082009,VAN,1710.2833333333333,35,35,21,56,91,70,17,39,22,321,530,19,101,29,21,1937,1175,1147,976,63,30,0.4358974358974359,30123143.695
DANIEL.TJARNQVIST,20082009,COL,542.3833333333333,2,0,2,2,4,2,0,0,0,19,46,12,21,1,4,437,472,403,393,16,14,0,30123049.86
DANIEL.WINNIK,20082009,ARI,625.8833333333332,2,1,3,4,6,3,51,135,84,65,106,78,14,17,16,438,595,390,394,10,14,0.37777777777777777,30123061.185000002
DANNY.SYVRET,20082009,PHI,18.85,0,0,0,0,0,0,0,0,0,0,0,1,0,0,0,20,19,20,19,1,2,0,15061508.45
DANY.HEATLEY,20082009,OTT,1649.0666666666666,39,16,16,32,71,55,14,30,16,258,461,87,105,30,39,1776,1263,1108,1073,55,54,0.4666666666666667,30123152.060000002
DARCY.HORDICHUK,20082009,VAN,451.65,5,0,1,1,6,5,1,1,0,29,45,129,3,27,33,254,406,247,393,13,10,1,30123067.935000002
DARCY.TUCKER,20082009,COL,889.3333333333333,8,3,5,8,16,11,15,35,20,94,154,102,30,30,25,787,696,606,637,17,25,0.42857142857142855,30123088.925
DARREN.HELM,20082009,DET,477.05,4,0,2,2,6,4,181,339,158,71,113,155,23,19,4,440,348,416,317,10,17,0.5339233038348082,30123048.68
DARREN.MCCARTY,20082009,DET,68.78333333333333,1,0,0,0,1,1,2,5,3,6,7,4,1,5,5,42,67,40,62,1,2,0.4,30123022.43
DARROLL.POWE,20082009,PHI,716.5,7,3,4,7,14,10,132,275,143,82,145,140,34,15,18,527,717,505,574,18,29,0.48,30123086.18
DARRYL.SYDOR,20082009,DAL,1215.1166666666668,2,3,6,9,11,5,0,0,0,66,145,38,55,6,8,1035,1033,802,769,36,41,0,30123083.16
DARRYL.SYDOR,20082009,PIT,115.1,1,0,1,1,2,1,0,0,0,7,14,4,6,1,1,125,77,97,65,4,1,0,30123018.185000002
DAVE.BOLLAND,20082009,CHI,1651.05,23,21,15,36,59,44,658,1471,813,140,238,85,52,34,29,1415,1471,1091,971,58,50,0.44731475186947656,30123162.634999998
DAVID.BACKES,20082009,STL,1542.2333333333333,32,12,13,25,57,44,234,533,299,219,343,222,52,41,59,1422,1291,920,901,50,47,0.43902439024390244,30123150.145000003
DAVID.BOOTH,20082009,FLA,1230.5833333333333,31,21,8,29,60,52,7,17,10,246,403,89,76,28,18,1367,1021,928,858,50,34,0.4117647058823529,30123126.46
DAVID.CLARKSON,20082009,N.J,1048.1,19,13,2,15,34,32,3,9,6,170,276,140,55,44,48,1004,806,749,763,31,34,0.3333333333333333,30123114.61
DAVID.HALE,20082009,ARI,726.65,3,5,1,6,9,8,0,0,0,22,58,85,20,14,12,493,797,454,614,24,36,0,30123084.265
DAVID.JONES,20082009,COL,508.15000000000003,8,3,1,4,12,11,4,8,4,47,71,54,13,14,4,402,480,337,394,12,19,0.5,30123062.575
DAVID.KOCI,20082009,STL,14.45,0,0,0,0,0,0,0,0,0,5,6,9,0,2,3,15,15,15,15,0,2,0,15061508.97
DAVID.KOCI,20082009,T.B,205.7,1,0,1,1,2,1,0,0,0,8,19,30,6,14,30,159,195,158,184,9,6,0,30123036.765
DAVID.KREJCI,20082009,BOS,1558.1333333333332,24,33,22,55,79,57,589,1169,580,171,253,82,34,17,13,1493,1313,1044,940,66,27,0.5038494439692045,30123157.68
DAVID.LEGWAND,20082009,NSH,1419.3,20,11,11,22,42,31,508,1022,514,175,274,25,53,15,13,1319,1172,906,870,34,37,0.49706457925636005,30123137.994999997
DAVID.MOSS,20082009,CGY,1164.7666666666667,22,12,5,17,39,34,23,46,23,208,349,106,69,15,12,1320,864,1043,680,44,47,0.5,30123082.045
DAVID.PERRON,20082009,STL,1245.4166666666665,16,21,13,34,50,37,1,6,5,173,319,87,81,45,28,1232,823,746,728,44,22,0.16666666666666666,30123103.915
DAVID.SCHLEMKO,20082009,ARI,57.8,0,0,1,1,1,0,0,0,0,3,9,6,6,1,0,71,44,49,39,2,3,0,30123015.935000002
DAVID.SLOANE,20082009,PHI,6.733333333333333,0,0,0,0,0,0,0,0,0,0,0,0,0,0,0,6,3,6,3,0,0,0,15061506.9
DAVID.STECKEL,20082009,WSH,1273.8166666666666,11,7,6,13,24,18,619,1068,449,122,213,117,52,16,18,907,1393,800,770,27,31,0.5795880149812734,30123114.37
DAVID.VAN DER GULIK,20082009,CGY,50.88333333333333,0,1,1,2,2,1,0,1,1,10,14,6,2,0,0,55,33,53,31,2,3,0,30123016.075
DAVIS.DREWISKE,20082009,L.A,294.41666666666663,0,1,2,3,3,1,0,0,0,21,42,10,6,1,4,242,262,203,189,7,6,0,30123032.11
DAYMOND.LANGKOW,20082009,CGY,1339,20,17,14,31,51,37,365,791,426,169,267,54,52,17,8,1493,861,984,763,40,29,0.461441213653603,30123116.82
DEAN.MCAMMOND,20082009,NYI,272.6166666666667,2,3,4,7,9,5,125,266,141,19,41,10,12,1,4,234,296,205,210,13,8,0.4699248120300752,30123041.71
DEAN.MCAMMOND,20082009,OTT,425.5833333333333,3,3,1,4,7,6,115,275,160,40,69,21,16,9,8,303,406,266,287,11,9,0.41818181818181815,30123053.165
DENIS JR..GAUTHIER,20082009,L.A,944.6833333333334,2,1,0,1,3,3,0,0,0,36,101,181,39,15,32,707,1006,655,678,22,35,0,30123082
DENIS.GREBESHKOV,20082009,EDM,1524.4666666666667,7,16,15,31,38,23,0,0,0,61,138,46,46,13,19,1406,1411,1066,1022,58,44,0,30123118.755000003
DENNIS.SEIDENBERG,20082009,CAR,1899.9,6,12,18,30,36,18,0,0,0,145,291,202,104,21,25,1764,1862,1302,1293,47,58,0,30123143.060000002
DENNIS.WIDEMAN,20082009,BOS,2194.5,13,19,25,44,57,32,0,0,0,196,466,74,144,19,19,2083,1916,1472,1339,81,43,0,30123141.265
DEREK.ARMSTRONG,20082009,L.A,475.1166666666667,5,2,2,4,9,7,115,240,125,42,65,85,11,17,22,389,384,376,381,10,21,0.4791666666666667,30123064.119999997
DEREK.BOOGAARD,20082009,MIN,254.88333333333333,0,2,1,3,3,2,0,0,0,13,27,61,6,22,26,174,221,162,219,6,3,0,30123042.395000003
DEREK.DORSETT,20082009,CBJ,489.75,4,1,0,1,5,5,4,9,5,66,99,130,13,43,42,358,353,343,343,12,13,0.4444444444444444,30123057.64
DEREK.JOSLIN,20082009,S.J,136.31666666666666,0,0,0,0,0,0,0,0,0,9,19,11,7,3,3,122,111,118,101,3,6,0,30123022.18
DEREK.MACKENZIE,20082009,CBJ,7.25,0,0,0,0,0,0,2,4,2,1,2,1,0,0,1,8,4,8,4,0,1,0.5,15061507.23
DEREK.MEECH,20082009,DET,419.9833333333333,2,5,0,5,7,7,0,2,2,45,83,36,26,1,6,410,305,368,298,14,24,0,30123041.21
DEREK.MORRIS,20082009,ARI,1212.4666666666667,5,4,3,7,12,9,0,0,0,89,196,66,63,8,12,1043,1284,795,961,25,38,0,30123116.955
DEREK.MORRIS,20082009,NYR,468.95000000000005,0,4,6,10,10,4,0,0,0,37,97,25,37,3,8,496,406,327,313,12,13,0,30123042.48
DEREK.PELTIER,20082009,COL,145.81666666666666,0,0,0,0,0,0,0,0,0,7,10,2,2,0,1,123,127,113,122,3,7,0,30123025.9
DEREK.ROY,20082009,BUF,1738.15,28,27,15,42,70,55,745,1468,723,221,399,41,95,41,19,1719,1522,982,998,46,44,0.5074931880108992,30123171.535
DERICK.BRASSARD,20082009,CBJ,446.2166666666667,10,7,7,14,24,17,160,329,169,59,102,40,27,13,6,493,264,303,221,23,10,0.48632218844984804,30123046.205
DEVIN.SETOGUCHI,20082009,S.J,1411.45,32,14,22,36,68,46,6,21,15,263,464,157,108,34,15,1585,1058,1094,943,52,42,0.2857142857142857,30123124.43
DION.PHANEUF,20082009,CGY,2213.1000000000004,11,17,20,37,48,28,0,0,0,279,617,174,206,48,37,2413,1827,1525,1280,77,72,0,30123125.33
DJ.KING,20082009,STL,8.333333333333334,0,1,0,1,1,1,0,0,0,0,1,3,0,0,0,3,11,3,11,1,1,0,15061508.65
DMITRI.KALININ,20082009,ARI,282.55,1,1,1,2,3,2,0,0,0,15,43,18,16,2,3,246,254,177,202,7,10,0,30123034.045
DMITRI.KALININ,20082009,NYR,987.0999999999999,1,3,8,11,12,4,0,0,0,51,119,61,40,8,13,880,932,730,741,30,35,0,30123085.18
DOMINIC.MOORE,20082009,BUF,273.6333333333333,1,2,1,3,4,3,120,236,116,33,66,9,16,15,10,275,275,208,163,8,6,0.5084745762711864,30123033.725
DOMINIC.MOORE,20082009,TOR,1074.85,12,16,13,29,41,28,544,995,451,131,244,63,49,22,31,1031,1055,756,714,41,39,0.5467336683417086,30123116.005000003
DONALD.BRASHEAR,20082009,WSH,533.35,1,2,1,3,4,3,0,0,0,45,73,123,10,29,39,440,435,430,428,8,14,0,30123063.765
DOUG.JANIK,20082009,DAL,126.65,0,0,1,1,1,0,0,0,0,1,9,8,3,0,1,80,120,74,107,4,6,0,30123025.075000003
DOUG.JANIK,20082009,MTL,27.78333333333333,0,0,0,0,0,0,0,0,0,0,4,0,2,1,1,19,32,16,25,0,1,0,30123016.310000002
DOUG.WEIGHT,20082009,NYI,969.3166666666666,10,18,10,28,38,28,306,678,372,96,163,38,39,22,19,1026,834,588,725,20,33,0.45132743362831856,30123125.060000002
DOUGLAS.MURRAY,20082009,S.J,1349.6,0,1,6,7,7,1,0,0,0,59,143,197,47,14,18,1058,1110,990,867,38,35,0,30123088.09
DREW.DOUGHTY,20082009,L.A,1930.1166666666668,6,5,16,21,27,11,0,0,0,126,295,90,103,13,27,1807,1640,1133,1152,39,51,0,30123126.98
DREW.MILLER,20082009,ANA,560.4666666666667,6,1,6,7,13,7,3,16,13,67,105,24,19,9,8,381,548,352,432,15,13,0.1875,30123066.060000002
DREW.STAFFORD,20082009,BUF,1234.3333333333333,20,12,13,25,45,32,4,20,16,182,281,80,51,23,13,1215,980,839,875,44,37,0.2,30123122.165
DUNCAN.KEITH,20082009,CHI,2387.0666666666666,8,22,20,42,50,30,0,0,0,196,NA,50,NA,10,32,NA,NA,NA,NA,78,60,0,NA
DUSTIN.BOYD,20082009,CGY,945.9333333333334,12,5,6,11,23,17,219,479,260,79,152,52,38,9,5,826,940,670,626,26,39,0.4572025052192067,30123091.5
DUSTIN.BROWN,20082009,L.A,1552.1333333333332,24,19,10,29,53,43,25,54,29,292,516,285,108,81,23,1753,1277,1060,973,44,49,0.46296296296296297,30123131.71
DUSTIN.BYFUGLIEN,20082009,CHI,1437.2666666666667,18,9,12,21,39,27,2,12,10,241,NA,245,NA,37,37,NA,NA,NA,NA,38,29,0.16666666666666666,NA
DUSTIN.JEFFREY,20082009,PIT,150.96666666666667,1,0,2,2,3,1,43,103,60,18,24,8,2,0,0,100,142,82,112,4,1,0.4174757281553398,30123029.619999997
DUSTIN.PENNER,20082009,EDM,1199.6166666666668,17,14,6,20,37,31,54,114,60,137,240,77,37,18,23,1278,912,874,771,44,29,0.47368421052631576,30123106.29
DWIGHT.HELMINEN,20082009,CAR,160.14999999999998,1,1,0,1,2,2,62,132,70,15,30,23,11,2,0,145,153,141,144,5,7,0.4696969696969697,30123030.55
ED.JOVANOVSKI,20082009,ARI,1795.5500000000002,8,11,15,26,34,19,0,1,1,191,410,130,134,25,38,1854,1594,1225,1297,43,54,0,30123148.575
ENVER.LISIN,20082009,ARI,711.9166666666667,13,4,4,8,21,17,2,6,4,105,181,56,29,16,12,656,674,466,561,20,32,0.3333333333333333,30123085.99
ERIC.BELANGER,20082009,MIN,1409.25,13,13,9,22,35,26,626,1205,579,146,258,45,49,21,13,1117,1290,780,876,28,37,0.5195020746887967,30123143.424999997
ERIC.BOULTON,20082009,ATL,573.5,3,5,5,10,13,8,1,4,3,71,109,77,14,34,45,431,566,422,558,18,21,0.25,30123087.305
ERIC.BREWER,20082009,STL,703.4,1,3,2,5,6,4,0,0,0,49,111,40,32,7,12,573,690,399,431,17,22,0,30123057.67
ERIC.FEHR,20082009,WSH,752.3333333333333,12,5,8,13,25,17,1,4,3,144,254,26,63,20,11,892,546,778,530,28,25,0.25,30123061.39
ERIC.GODARD,20082009,PIT,288.76666666666665,2,0,2,2,4,2,1,1,0,20,34,36,5,29,42,185,269,185,265,6,9,1,30123051.48
ERIC.NYSTROM,20082009,CGY,760.5833333333334,7,4,3,7,14,11,11,30,19,89,150,87,26,19,21,589,680,550,424,13,21,0.36666666666666664,30123059.705
ERIC.PERRIN,20082009,ATL,1106.2333333333331,7,10,5,15,22,17,111,213,102,109,176,47,33,17,14,785,1196,629,720,26,35,0.5211267605633803,30123103.685000002
ERIC.STAAL,20082009,CAR,2086.666666666667,50,24,15,39,89,74,850,1904,1054,441,774,79,169,50,25,2512,1784,1613,1267,68,52,0.44642857142857145,30123207.175
ERIK.CHRISTENSEN,20082009,ANA,287.6166666666667,2,8,1,9,11,10,46,74,28,42,66,3,16,1,3,304,229,209,209,8,11,0.6216216216216216,30123040.175
ERIK.CHRISTENSEN,20082009,ATL,670.75,5,7,7,14,19,12,233,427,194,90,167,17,35,10,8,611,543,447,501,18,25,0.5456674473067916,30123079.395
ERIK.COLE,20082009,CAR,630.0333333333333,2,12,5,17,19,14,4,4,0,63,105,116,22,14,15,644,531,467,412,18,23,1,30123059.825000003
ERIK.COLE,20082009,EDM,1076.1999999999998,16,6,5,11,27,22,19,48,29,145,262,133,64,41,21,996,908,702,694,30,30,0.3958333333333333,30123095.345
ERIK.REITZ,20082009,MIN,305.6333333333333,1,0,1,1,2,1,0,0,0,15,41,58,15,10,13,231,324,222,307,11,12,0,30123048.125
ERIK.REITZ,20082009,NYR,112.91666666666667,0,0,0,0,0,0,0,0,0,7,14,23,7,4,9,90,115,88,111,2,6,0,30123026.14
ETHAN.MOREAU,20082009,EDM,1183.0666666666666,14,6,6,12,26,20,11,36,25,159,284,126,62,30,46,897,1369,806,985,34,37,0.3055555555555556,30123136.39
EVGENI.MALKIN,20082009,PIT,2329.3333333333335,48,64,34,98,146,112,364,841,477,388,689,120,172,77,61,2472,1931,1342,1501,90,63,0.4328180737217598,30123253.130000003
EVGENY.ARTYUKHIN,20082009,T.B,779.05,6,5,5,10,16,11,0,2,2,100,159,249,25,32,51,623,700,544,668,25,24,0,30123099.395
FABIAN.BRUNNSTROM,20082009,DAL,639.0666666666666,17,7,5,12,29,24,0,0,0,81,131,24,16,6,4,597,485,439,461,22,32,0,30123075.835
FEDOR.TYUTIN,20082009,CBJ,2020.35,9,11,13,24,33,20,1,1,0,170,348,111,101,13,33,1846,1529,1184,1002,59,49,1,30123107.494999997
FERNANDO.PISANI,20082009,EDM,581.8,7,6,2,8,15,13,50,123,73,72,115,48,21,5,7,415,675,373,496,19,22,0.4065040650406504,30123079.450000003
FILIP.KUBA,20082009,OTT,1653.1,3,17,20,37,40,20,0,0,0,110,255,44,90,5,13,1575,1354,895,938,39,32,0,30123110.55
FRANCIS.BOUILLON,20082009,MTL,892.6166666666666,5,1,3,4,9,6,0,0,0,51,120,122,55,12,19,721,874,639,659,28,37,0,30123077.745
FRANCOIS.BEAUCHEMIN,20082009,ANA,776.3666666666667,5,1,0,1,6,6,0,0,0,54,91,57,21,5,12,585,844,448,559,20,20,0,30123077.4
FRANS.NIELSEN,20082009,NYI,975.8833333333332,9,11,13,24,33,20,358,758,400,100,186,29,44,24,9,1088,892,638,630,24,27,0.47229551451187335,30123102.235
FRANTISEK.KABERLE,20082009,CAR,496.75,1,3,4,7,8,4,0,0,0,34,85,21,30,2,5,516,412,397,350,10,14,0,30123045.27
FREDDY.MEYER,20082009,NYI,566.5333333333333,4,4,0,4,8,8,0,0,0,35,67,71,22,4,7,428,661,339,446,11,27,0,30123066.34
FREDRIK.MODIN,20082009,CBJ,896.2,10,7,8,15,25,17,56,129,73,116,205,27,34,15,14,855,675,574,519,25,19,0.43410852713178294,30123076.39
FREDRIK.SJOSTROM,20082009,NYR,1043.6166666666668,7,3,4,7,14,10,3,6,3,104,163,128,22,16,15,742,1071,645,655,17,34,0.5,30123088.23
GARNET.EXELBY,20082009,ATL,986.5166666666667,0,4,3,7,7,4,0,0,0,42,83,151,19,18,38,688,1068,648,799,25,30,0,30123104.755000003
GARRETT.STAFFORD,20082009,DAL,54.016666666666666,0,0,2,2,2,0,0,0,0,5,14,4,6,0,0,58,35,51,34,2,2,0,30123015.25
GARTH.MURRAY,20082009,ARI,93.35,0,0,0,0,0,0,36,80,44,12,14,13,1,4,3,66,105,61,79,0,2,0.45,30123025.08
GARY.ROBERTS,20082009,T.B,349.4333333333334,4,1,2,3,7,5,1,2,1,32,51,38,8,11,5,271,327,215,301,6,15,0.5,30123051.8
GEOFF.KINRADE,20082009,T.B,17.533333333333335,0,0,0,0,0,0,0,0,0,1,2,1,1,0,0,15,14,11,11,0,1,0,15061507.75
GEORGE.PARROS,20082009,ANA,501.8833333333333,5,3,2,5,10,8,0,4,4,52,74,106,5,33,34,360,402,348,394,19,12,0,30123065.130000003
GEORGES.LARAQUE,20082009,MTL,296.25,0,0,2,2,2,0,0,1,1,20,31,52,6,21,20,241,297,224,286,5,12,0,30123047.96
GILBERT.BRULE,20082009,EDM,108.61666666666667,2,0,1,1,3,2,4,5,1,13,22,14,6,4,6,85,116,81,110,3,6,0.8,30123027.675
GLEN.METROPOLIT,20082009,MTL,308.35,2,2,1,3,5,4,124,275,151,24,38,17,10,5,6,212,354,182,227,7,11,0.4509090909090909,30123046.935000002
GLEN.METROPOLIT,20082009,PHI,713.8,4,7,3,10,14,11,282,562,280,63,103,39,23,11,6,507,691,448,528,19,20,0.501779359430605,30123086.215
GRAHAM.MINK,20082009,WSH,16.1,0,0,0,0,0,0,0,0,0,4,4,0,0,1,0,9,8,9,8,0,0,0,15061507.71
GRANT.LEWIS,20082009,ATL,15.483333333333333,0,0,0,0,0,0,0,0,0,1,3,0,0,0,0,15,11,14,9,1,0,0,15061507.3
GREG.DE VRIES,20082009,NSH,1074.45,1,2,1,3,4,3,0,0,0,38,108,58,45,10,25,771,1021,692,821,30,42,0,30123098.425
GREG.ZANON,20082009,NSH,1708.65,4,4,3,7,11,8,0,0,0,54,132,153,53,10,19,1207,1821,1076,1275,43,45,0,30123147.424999997
GREGORY.CAMPBELL,20082009,FLA,1292.3666666666668,13,13,4,17,30,26,508,1016,508,135,213,202,36,26,29,1008,1493,823,1025,41,41,0.5,30123162.78
GREGORY.STEWART,20082009,MTL,189.18333333333334,0,1,0,1,1,1,1,1,0,18,27,41,4,10,11,162,184,157,180,4,11,1,30123034.64
GUILLAUME.LATENDRESSE,20082009,MTL,809.3666666666667,14,7,5,12,26,21,1,2,1,122,236,154,60,15,18,825,698,651,656,30,26,0.5,30123088.865000002
HAL.GILL,20082009,PIT,1555.0500000000002,2,0,9,9,11,2,0,0,0,55,142,99,54,12,28,1167,1622,1080,1176,50,46,0,30123129.445
HENRIK.SEDIN,20082009,VAN,1784.6833333333334,26,34,32,66,92,60,755,1523,768,159,251,22,48,31,24,2000,1303,1197,1030,65,35,0.49573210768220616,30123173.21
HENRIK.TALLINDER,20082009,BUF,1215.5166666666667,1,6,4,10,11,7,0,0,0,35,80,48,29,11,18,885,1209,782,838,38,42,0,30123098.91
HENRIK.ZETTERBERG,20082009,DET,2019.0166666666667,41,34,21,55,96,75,875,1613,738,386,642,93,127,51,23,2397,1502,1488,1083,64,49,0.5424674519528828,30123173.285
IAN.LAPERRIERE,20082009,COL,1023.9833333333333,7,10,2,12,19,17,196,446,250,61,110,103,17,24,41,680,1103,615,689,24,21,0.43946188340807174,30123110.48
IAN.WHITE,20082009,TOR,1604.9666666666667,10,7,6,13,23,17,0,0,0,156,313,108,93,26,20,1559,1563,1169,1111,53,49,0,30123122.16
ILJA.ZUBOV,20082009,OTT,102.76666666666665,0,1,1,2,2,1,0,1,1,11,19,11,3,1,0,92,74,71,69,1,2,0,30123020.935000002
ILYA.KOVALCHUK,20082009,ATL,1721.6999999999998,43,30,18,48,91,73,5,14,9,275,587,43,180,28,20,1782,1324,937,1094,56,62,0.35714285714285715,30123160.73
IVAN.VISHNEVSKIY,20082009,DAL,58.66666666666667,0,1,1,2,2,1,0,0,0,9,17,1,4,0,1,70,36,45,30,1,0,0,15061509.475
J-F.JACQUES,20082009,EDM,51.6,1,0,0,0,1,1,0,0,0,3,5,13,2,2,3,34,56,34,55,3,3,0,30123020.619999997
J-P.DUMONT,20082009,NSH,1434.3833333333332,16,27,22,49,65,43,3,6,3,176,NA,33,NA,19,11,NA,NA,NA,NA,58,45,0.5,NA
JACK.HILLEN,20082009,NYI,608.4333333333334,1,3,2,5,6,4,0,0,0,47,89,28,23,4,8,526,581,425,525,16,22,0,30123071.240000002
JACK.JOHNSON,20082009,L.A,831.3333333333334,6,4,1,5,11,10,0,0,0,50,103,68,36,11,19,707,815,500,641,21,34,0,30123088.034999996
JACK.SKILLE,20082009,CHI,75.5,1,0,0,0,1,1,0,0,0,14,18,9,1,6,1,54,66,54,59,1,4,0,30123020.96
JACOB.DOWELL,20082009,CHI,13.616666666666667,0,0,0,0,0,0,8,12,4,0,0,2,0,0,1,8,9,8,8,1,0,0.6666666666666666,15061507.67
JAIME.SIFERS,20082009,TOR,295.01666666666665,0,1,1,2,2,1,0,0,0,25,52,29,13,5,6,260,274,237,228,9,13,0,30123035.375
JAKUB.PETRUZALEK,20082009,CAR,16.15,0,1,0,1,1,1,4,7,3,0,2,1,2,0,0,12,11,10,9,1,0,0.5714285714285714,15061507.81
JAKUB.VORACEK,20082009,CBJ,1060.9,9,18,12,30,39,27,0,3,3,113,172,37,37,13,22,1043,725,774,666,46,31,0,30123088.58
JAMAL.MAYERS,20082009,TOR,743.3666666666667,7,6,2,8,15,13,246,426,180,72,143,65,33,17,21,572,903,506,602,18,25,0.5774647887323944,30123092.66
JAMES.NEAL,20082009,DAL,1221.8833333333334,24,8,5,13,37,32,11,31,20,170,281,194,50,34,24,1127,934,795,781,34,39,0.3548387096774194,30123113.205
JAMES.SHEPPARD,20082009,MIN,1244.5833333333335,5,14,5,19,24,19,361,870,509,88,143,69,19,36,16,1008,1146,805,933,31,44,0.4149425287356322,30123146.275
JAMES.VANDERMEER,20082009,CGY,820.3666666666667,1,2,5,7,8,3,0,0,0,33,91,100,33,24,30,729,726,685,575,33,36,0,30123064.165
JAMES.WISNIEWSKI,20082009,ANA,600.6333333333333,2,9,2,11,13,11,0,0,0,35,87,75,32,7,13,534,544,404,390,19,15,0,30123054.42
JAMES.WISNIEWSKI,20082009,CHI,596.8166666666667,2,7,4,11,13,9,0,0,0,70,140,51,44,6,7,613,456,458,311,15,11,0,30123038.560000002
JAMIE.FRASER,20082009,NYI,11,0,0,0,0,0,0,0,0,0,0,0,0,0,0,0,9,10,9,10,0,0,0,15061507.8
JAMIE.FRITSCH,20082009,PHI,4.566666666666666,0,0,0,0,0,0,0,0,0,0,0,1,0,0,0,6,3,6,3,2,1,0,15061506.6
JAMIE.HEWARD,20082009,T.B,153.56666666666666,0,0,2,2,2,0,0,0,0,11,22,5,8,0,2,124,156,102,123,2,3,0,30123026.35
JAMIE.LANGENBRUNNER,20082009,N.J,1530.8999999999999,31,30,11,41,72,61,10,26,16,245,416,102,90,24,26,1744,1158,1092,854,55,32,0.38461538461538464,30123121.365000002
JAMIE.LUNDMARK,20082009,CGY,391.7166666666667,8,4,4,8,16,12,64,126,62,50,85,15,18,9,7,375,272,278,254,13,14,0.5079365079365079,30123047.25
JAMIE.MCGINN,20082009,S.J,312.25,4,1,1,2,6,5,6,7,1,27,45,50,10,1,1,232,270,223,263,6,12,0.8571428571428571,30123044.325
JAN.HEJDA,20082009,CBJ,1886.0333333333333,3,4,12,16,19,7,0,1,1,67,177,174,79,13,20,1294,1929,1122,1247,63,57,0,30123134.88
JANIS.SPRUKTS,20082009,FLA,12.316666666666666,0,0,0,0,0,0,0,0,0,1,2,0,0,0,0,6,11,6,11,0,0,0,15061508.15
JANNE.NISKALA,20082009,T.B,82.21666666666667,1,0,2,2,3,1,0,0,0,10,18,5,5,0,3,86,69,59,59,2,1,0,30123020.15
JANNE.PESONEN,20082009,PIT,52.18333333333334,0,0,0,0,0,0,0,3,3,3,6,3,2,1,0,30,47,26,46,0,3,0,30123019.11
JANNIK.HANSEN,20082009,VAN,709.3499999999999,6,8,7,15,21,14,2,13,11,63,124,27,29,14,12,549,667,500,496,27,25,0.15384615384615385,30123069.245
JARED.BOLL,20082009,CBJ,672.7,4,4,6,10,14,8,0,4,4,74,134,155,31,45,42,524,518,512,509,20,28,0,30123072.700000003
JARED.ROSS,20082009,PHI,102.35,1,0,0,0,1,1,41,76,35,15,23,4,4,2,1,66,89,59,86,1,5,0.5394736842105263,30123025.66
JARKKO.RUUTU,20082009,OTT,913.3833333333334,7,8,5,13,20,15,2,8,6,89,143,148,24,42,53,663,866,608,662,26,27,0.25,30123097.675
JAROME.IGINLA,20082009,CGY,1876.7833333333333,38,36,19,55,93,74,283,534,251,304,542,93,121,48,14,2131,1365,1341,1160,64,61,0.5299625468164794,30123168.025
JAROSLAV.SPACEK,20082009,BUF,1781.0333333333333,8,14,22,36,44,22,0,0,0,130,288,77,109,9,19,1806,1511,1170,1019,59,52,0,30123107.04
JARRET.STOLL,20082009,L.A,1264.25,18,9,13,22,40,27,599,1047,448,155,281,160,52,13,29,1314,1088,745,713,30,30,0.5721107927411653,30123118.065
JASON.ARNOTT,20082009,NSH,1229.2833333333333,33,14,10,24,57,47,525,1036,511,196,NA,34,NA,12,18,NA,NA,NA,NA,51,42,0.5067567567567568,NA
JASON.BLAKE,20082009,TOR,1412.4833333333333,24,28,10,38,62,52,36,77,41,297,440,54,69,31,13,1565,1287,1096,983,47,50,0.4675324675324675,30123140.5
JASON.CHIMERA,20082009,CBJ,849.4166666666667,8,8,6,14,22,16,18,42,24,126,203,66,40,14,19,737,734,518,494,31,19,0.42857142857142855,30123071.810000002
JASON.GARRISON,20082009,FLA,11.950000000000001,0,0,0,0,0,0,0,0,0,0,2,1,2,0,0,16,7,9,7,0,0,0,15061507.05
JASON.JAFFRAY,20082009,VAN,126.9,2,2,0,2,4,4,31,65,34,11,15,7,1,9,4,104,105,76,89,4,3,0.47692307692307695,30123027.43
JASON.KROG,20082009,VAN,40.93333333333333,1,0,0,0,1,1,14,24,10,5,9,3,1,0,1,42,23,24,19,0,0,0.5833333333333334,30123016.46
JASON.POMINVILLE,20082009,BUF,1619.1666666666665,20,21,25,46,66,41,24,66,42,239,406,44,89,13,8,1655,1474,945,966,45,44,0.36363636363636365,30123133.615000002
JASON.SMITH,20082009,OTT,1105.1,1,0,0,0,1,1,0,1,1,53,119,123,49,9,12,806,1217,721,865,32,40,0,30123100.34
JASON.SPEZZA,20082009,OTT,1614.5333333333333,32,28,13,41,73,60,787,1476,689,245,412,26,74,31,32,1792,1217,1083,1030,50,54,0.5331978319783198,30123177.965
JASON.STRUDWICK,20082009,EDM,896.4166666666667,2,3,3,6,8,5,0,0,0,32,67,73,23,12,18,596,955,559,759,25,31,0,30123099.895
JASON.WARD,20082009,T.B,9.516666666666667,0,0,0,0,0,0,0,0,0,1,4,2,1,0,1,6,9,6,8,0,0,0,15061507.7
JASON.WILLIAMS,20082009,ATL,659.1,7,5,6,11,18,12,187,381,194,79,119,16,24,10,4,575,545,399,491,16,25,0.49081364829396323,30123081.78
JASON.WILLIAMS,20082009,CBJ,666.3333333333333,12,13,5,18,30,25,112,267,155,79,147,30,38,2,9,683,446,421,388,27,14,0.41947565543071164,30123068.775
JASSEN.CULLIMORE,20082009,FLA,1142.3166666666666,2,4,4,8,10,6,0,0,0,51,121,58,52,3,17,851,1225,805,965,34,40,0,30123114.130000003
JAY.BEAGLE,20082009,WSH,36.96666666666667,0,0,0,0,0,0,6,16,10,6,8,7,2,0,1,29,32,29,32,0,4,0.375,30123017.439999998
JAY.BOUWMEESTER,20082009,FLA,2213.0166666666664,15,13,13,26,41,28,0,0,0,182,361,115,106,10,34,1946,2234,1218,1493,55,55,0,30123185.325
JAY.HARRISON,20082009,TOR,120.83333333333334,0,1,0,1,1,1,0,0,0,6,31,8,11,1,4,135,118,109,99,4,7,0,30123022.11
JAY.LEACH,20082009,N.J,356.1333333333333,0,1,0,1,1,1,0,0,0,5,17,7,7,4,6,252,308,229,258,6,9,0,30123040.54
JAY.MCCLEMENT,20082009,STL,1427.3166666666666,12,7,6,13,25,19,798,1531,733,144,248,40,36,23,15,906,1581,774,926,20,41,0.5212279555845852,30123156.35
JAY.MCKEE,20082009,STL,1254.3,1,2,5,7,8,3,0,2,2,44,86,71,27,12,21,782,1426,694,942,36,29,0,30123118.395
JAY.PANDOLFO,20082009,N.J,1021.3166666666666,6,3,2,5,11,9,6,24,18,71,126,48,30,11,5,644,1023,604,717,16,33,0.25,30123095.2
JED.ORTMEYER,20082009,NSH,22.03333333333333,0,0,0,0,0,0,0,0,0,4,4,3,0,0,0,14,13,13,11,0,0,0,30123014.700000003
JEFF.CARTER,20082009,PHI,1840.65,47,23,15,38,85,70,884,1851,967,372,629,57,136,23,37,1835,1927,1161,1308,62,51,0.4775796866558617,30123232.515
JEFF.FINGER,20082009,TOR,1328.9333333333334,6,6,10,16,22,12,0,0,0,67,160,133,58,14,20,1168,1455,987,1057,50,54,0,30123121.240000002
JEFF.HALPERN,20082009,T.B,884.4833333333333,7,9,0,9,16,16,433,821,388,60,116,28,23,11,15,624,890,412,526,17,26,0.5274056029232643,30123096.08
JEFF.HOGGAN,20082009,ARI,48,0,1,0,1,1,1,0,2,2,7,10,13,3,2,2,47,42,42,42,1,2,0,30123018.42
JEFF.SCHULTZ,20082009,WSH,1277.45,1,4,7,11,12,5,0,0,0,41,100,53,47,4,9,1071,1305,950,883,47,40,0,30123091.215
JEFF.TAFFE,20082009,PIT,68.05,0,1,1,2,2,1,21,40,19,4,8,3,1,0,1,42,49,31,39,0,2,0.525,30123019.365000002
JEFF.TAMBELLINI,20082009,NYI,852.2,7,2,5,7,14,9,3,5,2,98,168,98,37,12,16,791,826,703,771,18,34,0.6,30123099.615000002
JEFF.WOYWITKA,20082009,STL,1276.4,3,5,10,15,18,8,0,0,0,74,160,23,54,9,20,1081,987,778,869,39,30,0,30123103.39
JEFFREY.HAMILTON,20082009,TOR,194.26666666666665,3,1,2,3,6,4,3,11,8,30,59,6,16,1,2,206,188,151,182,9,6,0.2727272727272727,30123034.48
JERE.LEHTINEN,20082009,DAL,911.25,8,8,8,16,24,16,2,7,5,119,199,25,31,5,4,896,708,551,473,25,23,0.2857142857142857,30123065.93
JEREMY.COLLITON,20082009,NYI,66.31666666666666,0,1,0,1,1,1,45,70,25,4,5,18,0,2,1,39,81,35,56,1,3,0.6428571428571429,30123021.72
JEREMY.ROENICK,20082009,S.J,562.4,4,8,2,10,14,12,115,242,127,61,92,68,21,9,10,563,415,468,390,18,18,0.47520661157024796,30123059.939999998
JEREMY.WILLIAMS,20082009,TOR,147.78333333333333,5,1,1,2,7,6,0,1,1,21,32,10,6,1,1,144,106,108,102,7,4,0,30123026.835
JERRED.SMITHSON,20082009,NSH,1134.7,4,8,0,8,12,12,380,722,342,74,121,140,24,11,21,675,1106,616,741,26,32,0.5263157894736842,30123113.810000002
JESSE.BOULERICE,20082009,EDM,7.416666666666667,0,0,0,0,0,0,0,0,0,0,0,0,0,0,0,5,10,5,10,0,0,0,30123014.75
JESSE.JOENSUU,20082009,NYI,84.68333333333334,1,1,1,2,3,2,0,0,0,9,21,7,8,3,1,72,78,70,75,3,4,0,30123021.555
JESSE.WINCHESTER,20082009,OTT,804.6500000000001,3,4,11,15,18,7,113,199,86,114,162,116,25,21,12,622,694,584,624,21,22,0.5678391959798995,30123087.005
JIM.SLATER,20082009,ATL,674.8333333333333,8,3,7,10,18,11,245,462,217,94,152,84,27,20,19,476,759,420,473,19,19,0.5303030303030303,30123080.475
JIRI.HUDLER,20082009,DET,1416.2166666666667,27,23,19,42,69,50,16,36,20,190,307,32,53,20,13,1786,851,1140,791,50,38,0.4444444444444444,30123105.165
JIRI.NOVOTNY,20082009,CBJ,559.65,4,3,0,3,7,7,155,293,138,56,91,74,14,9,7,421,424,360,329,11,12,0.5290102389078498,30123054.84
JIRI.TLUSTY,20082009,TOR,177.89999999999998,0,2,2,4,4,2,1,3,2,22,39,5,6,0,0,177,148,144,145,4,5,0.3333333333333333,30123028.990000002
JOAKIM.LINDSTROM,20082009,ARI,653.9333333333334,9,5,6,11,20,14,5,14,9,77,133,35,33,11,13,587,640,409,511,21,25,0.35714285714285715,30123077.41
JOCHEN.HECHT,20082009,BUF,1216.3666666666668,12,9,6,15,27,21,234,537,303,173,261,29,39,13,14,1026,1156,823,815,28,46,0.43575418994413406,30123122.04
JODY.SHELLEY,20082009,S.J,435.2,2,0,2,2,4,2,3,7,4,44,64,126,8,23,33,328,317,326,313,6,12,0.42857142857142855,30123051.15
JOE.CALLAHAN,20082009,NYI,269.95000000000005,0,0,2,2,2,0,0,1,1,6,28,39,16,1,2,205,297,192,240,10,5,0,30123036.810000002
JOE.CORVO,20082009,CAR,2400.0333333333333,15,10,18,28,43,25,0,0,0,262,537,55,161,16,11,2561,2098,1627,1516,59,70,0,30123158.810000002
JOE.MOTZKO,20082009,ATL,69.91666666666667,1,0,0,0,1,1,1,3,2,8,14,1,2,2,0,71,67,58,63,3,0,0.3333333333333333,30123020.509999998
JOE.PAVELSKI,20082009,S.J,1633.2166666666667,25,20,15,35,60,45,757,1358,601,282,472,93,90,34,22,1739,1315,1103,891,40,36,0.5574374079528719,30123142.345
JOE.SAKIC,20082009,COL,271.7,2,4,6,10,12,6,117,216,99,46,79,7,20,5,3,257,203,133,161,7,14,0.5416666666666666,30123037.58
JOE.THORNTON,20082009,S.J,1711.35,26,40,25,65,91,66,770,1389,619,156,285,86,70,44,25,2050,1206,1283,1030,58,47,0.5543556515478761,30123161.965
JOEL.LUNDQVIST,20082009,DAL,464.79999999999995,1,2,3,5,6,3,29,76,47,32,72,116,15,8,10,338,412,312,361,8,16,0.3815789473684211,30123055.865000002
JOEL.PERRAULT,20082009,ARI,90.08333333333334,2,0,1,1,3,2,34,76,42,15,21,5,5,1,2,88,76,67,68,2,1,0.4473684210526316,30123023.595
JOEL.RECHLICZ,20082009,NYI,82.69999999999999,0,0,1,1,1,0,0,0,0,7,14,25,4,8,17,49,95,48,95,2,3,0,30123027.505
JOEL.WARD,20082009,NSH,1265.2,17,14,4,18,35,31,20,46,26,133,227,65,33,20,12,996,1130,793,803,34,34,0.43478260869565216,30123113.9
JOFFREY.LUPUL,20082009,PHI,1341.8166666666666,26,17,9,26,52,43,12,24,12,208,378,86,97,26,26,1395,1255,1006,1128,49,48,0.5,30123153.765
JOHAN.FRANZEN,20082009,DET,1716.9833333333333,46,24,10,34,80,70,158,281,123,314,478,137,62,25,26,1993,1136,1321,928,66,39,0.5622775800711743,30123138.02
JOHN-MICHAEL.LILES,20082009,COL,1615.2166666666667,12,11,16,27,39,23,0,0,0,146,315,58,96,10,15,1619,1331,1045,1134,40,55,0,30123136.25
JOHN.ERSKINE,20082009,WSH,1102.5833333333333,0,2,2,4,4,2,0,0,0,58,146,167,51,15,34,1012,1020,946,843,30,32,0,30123089.9
JOHN.MADDEN,20082009,N.J,1376.4833333333333,7,10,7,17,24,17,673,1297,624,150,239,70,51,16,15,915,1447,828,954,27,41,0.5188897455666923,30123148.805
JOHN.MITCHELL,20082009,TOR,1048.8666666666668,12,14,3,17,29,26,NA,668,NA,98,184,88,46,25,15,954,1058,747,807,23,40,NA,NA
JOHN.NEGRIN,20082009,CGY,29.96666666666667,0,0,1,1,1,0,0,0,0,3,8,0,3,0,1,48,30,45,30,1,3,0,30123015.525
JOHN.SCOTT,20082009,MIN,184.73333333333332,0,1,0,1,1,1,0,0,0,6,14,17,5,9,6,128,178,123,170,6,8,0,30123033.04
JOHN.ZEILER,20082009,L.A,176.93333333333334,0,1,0,1,1,1,3,5,2,3,9,47,0,10,11,93,145,93,142,2,4,0.6,30123032.37
JOHNNY.BOYCHUK,20082009,BOS,14.799999999999999,0,0,0,0,0,0,0,0,0,0,1,3,1,0,0,11,13,9,12,0,0,0,15061507.95
JOHNNY.ODUYA,20082009,N.J,1853.9,7,8,11,19,26,15,0,0,0,116,260,59,84,9,16,1723,1658,1429,1171,71,52,0,30123112.865000002
JON.SIM,20082009,NYI,595.9666666666667,9,4,2,6,15,13,1,6,5,90,149,44,31,15,18,524,617,407,577,19,28,0.16666666666666666,30123088.44
JONAS.FROGREN,20082009,TOR,550.9333333333334,1,0,3,3,4,1,0,1,1,12,31,74,13,6,14,452,624,402,454,13,16,0,30123061.335
JONAS.JUNLAND,20082009,STL,12.466666666666667,0,0,0,0,0,0,0,0,0,0,0,0,0,0,1,11,10,4,10,0,0,0,15061508.2
JONATHAN.CHEECHOO,20082009,S.J,1071.9333333333334,13,14,4,18,31,27,1,4,3,169,307,115,55,15,22,1133,731,827,638,30,29,0.25,30123084.240000002
JONATHAN.ERICSSON,20082009,DET,747.8499999999999,5,2,5,7,12,7,0,0,0,58,120,67,38,9,17,687,623,628,515,26,21,0,30123060.265
JONATHAN.TOEWS,20082009,CHI,1803.1499999999999,41,25,16,41,82,66,849,1530,681,238,341,62,50,33,31,1918,1086,1189,881,55,49,0.5549019607843138,30123156.54
JONATHON.KALINSKI,20082009,PHI,91.33333333333334,1,0,2,2,3,1,21,46,25,7,11,12,3,3,0,48,79,45,76,3,5,0.45652173913043476,30123024.02
JONI.PITKANEN,20082009,CAR,2211.4166666666665,7,19,15,34,41,26,0,0,0,191,397,84,113,12,37,2443,1975,1714,1443,68,56,0,30123148.795
JORDAN.HENDRY,20082009,CHI,90.89999999999999,0,0,0,0,0,0,0,0,0,1,10,4,7,2,1,51,91,47,60,1,3,0,30123019.17
JORDAN.LAVALLEE-SMOTHERMAN,20082009,ATL,13.316666666666666,0,0,0,0,0,0,0,0,0,1,2,3,0,0,0,6,12,6,12,0,1,0,15061508.3
JORDAN.LEOPOLD,20082009,CGY,537.3666666666667,1,3,0,3,4,4,0,0,0,30,65,30,16,1,7,509,506,388,362,18,21,0,30123048.21
JORDAN.LEOPOLD,20082009,COL,1162.3,6,8,6,14,20,14,0,0,0,82,169,45,57,7,9,1099,960,795,790,34,44,0,30123093.17
JORDAN.STAAL,20082009,PIT,2070.083333333333,26,21,11,32,58,47,728,1554,826,224,392,200,79,36,20,1663,1995,1193,1233,50,50,0.46846846846846846,30123198.605
JORDIN.TOOTOO,20082009,NSH,870.3333333333333,4,5,7,12,16,9,9,16,7,137,245,129,55,47,43,767,777,687,747,19,32,0.5625,30123100.205
JOSEF.MELICHAR,20082009,CAR,129.88333333333333,0,1,3,4,4,1,0,0,0,3,18,12,10,0,4,115,127,110,104,7,8,0,30123022.575
JOSEF.MELICHAR,20082009,T.B,407.3333333333333,0,4,1,5,5,4,0,0,0,16,31,27,14,4,12,313,427,281,310,12,12,0,30123046.965
JOSEPH.CRABB,20082009,ATL,354.1333333333333,4,3,2,5,9,7,13,33,20,33,51,53,8,6,7,241,350,221,253,11,14,0.3939393939393939,30123045.78
JOSH.BAILEY,20082009,NYI,422.68333333333334,5,3,2,5,10,8,130,323,193,34,59,22,13,2,4,452,381,270,348,11,18,0.4024767801857585,30123064.57
JOSH.GORGES,20082009,MTL,1725.5,4,8,12,20,24,12,0,1,1,65,171,98,60,10,20,1437,1703,1122,1207,59,52,0,30123135.1
JOSH.GRATTON,20082009,PHI,118.51666666666665,1,2,0,2,3,3,0,0,0,14,22,20,3,13,15,71,99,68,98,5,7,0,30123028.48
JOSH.GREEN,20082009,ANA,29.433333333333337,0,0,0,0,0,0,1,3,2,2,6,2,2,2,0,12,32,12,32,0,0,0.3333333333333333,30123017.61
JOSH.HENNESSY,20082009,OTT,13.666666666666666,0,0,0,0,0,0,2,7,5,0,0,1,0,0,0,14,6,12,5,0,0,0.2857142857142857,15061507.13
JOSHUA.BAILEY,20082009,NYI,630.0833333333333,2,10,3,13,15,12,202,482,280,40,72,25,10,5,5,601,549,404,491,14,16,0.4190871369294606,30123085.255000003
JUSSI.JOKINEN,20082009,CAR,630.5833333333333,8,10,4,14,22,18,179,321,142,62,91,34,18,14,5,570,578,469,448,19,22,0.557632398753894,30123072.4
JUSSI.JOKINEN,20082009,T.B,719.2833333333333,6,5,5,10,16,11,266,509,243,64,110,17,22,4,8,576,708,399,448,15,20,0.5225933202357563,30123076.455
JUSTIN.ABDELKADER,20082009,DET,88.25,2,1,0,1,3,3,21,46,25,13,22,35,3,1,0,79,58,79,57,3,1,0.45652173913043476,30123020.85
JUSTIN.WILLIAMS,20082009,CAR,484.43333333333334,3,3,4,7,10,6,6,20,14,80,132,30,19,9,4,543,377,405,336,10,14,0.3,30123048.68
JUSTIN.WILLIAMS,20082009,L.A,214.18333333333334,1,2,1,3,4,3,1,2,1,28,52,10,11,4,3,196,179,130,131,6,4,0.5,30123027.905
KAMIL.KREPS,20082009,FLA,922.2833333333333,4,9,6,15,19,13,439,870,431,77,135,43,28,8,9,651,1036,560,703,20,22,0.5045977011494253,30123114.39
KARL.ALZNER,20082009,WSH,582.55,1,2,1,3,4,3,0,0,0,31,65,22,25,3,1,538,581,484,379,19,20,0,30123043.155
KARLIS.SKRASTINS,20082009,FLA,1644.8833333333332,4,4,9,13,17,8,0,0,0,55,151,39,55,5,15,1207,1961,1101,1360,50,48,0,30123157.425
KEITH.AUCOIN,20082009,WSH,123.81666666666666,2,0,4,4,6,2,33,83,50,15,22,4,5,4,2,143,90,124,87,7,2,0.39759036144578314,30123023.509999998
KEITH.BALLARD,20082009,FLA,1835.3,6,17,11,28,34,23,0,1,1,106,235,172,75,29,26,1670,1773,1224,1284,61,51,0,30123148.415
KEITH.TKACHUK,20082009,STL,1413.5166666666667,25,16,8,24,49,41,509,1002,493,192,304,138,41,29,32,1556,970,860,814,33,36,0.5079840319361277,30123142.65
KEITH.YANDLE,20082009,ARI,1131.9166666666665,4,17,8,25,29,21,0,0,0,117,238,46,76,16,17,1132,964,802,842,38,39,0,30123103.91
KEN.KLEE,20082009,ANA,50.86666666666667,0,0,0,0,0,0,0,0,0,4,5,5,0,0,2,29,49,26,33,2,2,0,30123017.35
KEN.KLEE,20082009,ARI,1028.2833333333333,1,2,7,9,10,3,0,0,0,46,104,97,45,6,12,751,1019,699,774,34,26,0,30123089.285
KENNDAL.MCARDLE,20082009,FLA,22.5,0,0,0,0,0,0,0,0,0,1,1,3,0,0,1,11,20,11,19,0,1,0,30123016
KENT.HUSKINS,20082009,ANA,620.0166666666667,2,2,2,4,6,4,0,1,1,20,49,29,20,8,12,446,613,354,436,22,15,0,30123060.479999997
KEVIN.BIEKSA,20082009,VAN,1909.2,11,17,20,37,48,28,0,0,0,167,381,120,128,37,44,1780,1523,1088,1042,47,45,0,30123123.02
KEVIN.KLEIN,20082009,NSH,797.8666666666667,4,3,4,7,11,7,0,0,0,41,97,57,34,4,8,691,681,618,619,26,22,0,30123074.490000002
KEVIN.PORTER,20082009,ARI,463.4666666666667,5,1,4,5,10,6,28,95,67,39,61,37,13,7,2,368,431,289,366,15,16,0.29473684210526313,30123059.490000002
KEVIN.QUICK,20082009,T.B,80.33333333333333,0,0,1,1,1,0,0,0,0,7,12,1,4,0,0,75,72,54,65,2,3,0,30123020.075000003
KEVIN.WESTGARTH,20082009,L.A,45.349999999999994,0,0,0,0,0,0,0,1,1,1,3,7,2,1,3,17,33,17,33,1,0,0,30123017.71
KIM.JOHNSSON,20082009,MIN,1987.1333333333332,2,13,9,22,24,15,0,0,0,93,210,36,64,15,22,1447,1880,1113,1336,45,55,0,30123159.225
KIMMO.TIMONEN,20082009,PHI,2046.35,3,21,19,40,43,24,0,2,2,114,265,72,95,9,29,1885,2004,1035,1193,49,49,0,30123144.415
KIRK.MALTBY,20082009,DET,888.3666666666666,5,5,1,6,11,10,4,10,6,68,123,88,34,30,14,629,716,603,546,20,30,0.4,30123069.535
KRIS.CHUCKO,20082009,CGY,14.05,0,0,0,0,0,0,0,1,1,0,0,1,0,0,1,5,17,3,17,0,0,0,15061509.35
KRIS.DRAPER,20082009,DET,1003,8,5,4,9,17,13,NA,1057,NA,98,150,114,27,12,20,688,971,631,657,23,39,NA,NA
KRIS.LETANG,20082009,PIT,1993.6499999999999,14,9,22,31,45,23,0,1,1,188,366,140,106,27,18,2010,1675,1323,1277,71,61,0,30123141.17
KRIS.NEWBURY,20082009,TOR,4.916666666666667,0,0,0,0,0,0,1,3,2,0,0,2,0,1,1,2,7,2,7,0,0,0.3333333333333333,15061507.95
KRIS.RUSSELL,20082009,CBJ,1130.6166666666668,3,11,9,20,23,14,0,0,0,91,172,51,47,20,11,1140,727,751,613,26,28,0,30123072.175
KRIS.VERSTEEG,20082009,CHI,1604.6333333333332,26,17,21,38,64,43,145,324,179,165,279,58,57,30,22,1466,1247,1006,868,41,40,0.44753086419753085,30123127.175
KRISTIAN.HUSELIUS,20082009,CBJ,1515.8666666666666,22,20,16,36,58,42,13,48,35,223,366,23,72,17,21,1613,1033,1028,876,51,52,0.2708333333333333,30123118.740000002
KRYS.BARCH,20082009,DAL,464.76666666666665,4,2,3,5,9,6,2,7,5,26,40,122,6,27,32,305,369,297,365,17,16,0.2857142857142857,30123060.675
KRYSTOFER.KOLANOS,20082009,MIN,222.63333333333333,3,1,2,3,6,4,59,115,56,30,48,37,8,4,6,201,184,140,168,6,3,0.5130434782608696,30123037.05
KURT.SAUER,20082009,ARI,1384.3166666666666,1,2,3,5,6,3,0,1,1,33,92,91,26,8,14,862,1547,756,1100,29,41,0,30123138.355
KURTIS.FOSTER,20082009,MIN,135.86666666666667,1,1,4,5,6,2,0,0,0,10,31,8,13,0,3,130,106,91,95,7,4,0,30123022.7
KURTIS.MCLEAN,20082009,NYI,42.25,1,0,0,0,1,1,0,1,1,5,9,7,2,2,1,39,39,39,39,1,0,0,30123018.119999997
KYLE.BRODZIAK,20082009,EDM,1005.1333333333333,11,10,6,16,27,21,489,945,456,99,168,60,31,10,8,650,1140,573,757,29,31,0.5174603174603175,30123127.21
KYLE.CALDER,20082009,L.A,974.3166666666666,8,12,7,19,27,20,1,3,2,93,161,55,28,18,19,1054,761,823,737,29,27,0.3333333333333333,30123094.845
KYLE.CHIPCHURA,20082009,MTL,133.91666666666666,0,1,1,2,2,1,47,106,59,5,12,8,4,2,1,84,141,81,118,3,8,0.44339622641509435,30123029.625
KYLE.CUMISKEY,20082009,COL,51.233333333333334,0,0,0,0,0,0,0,0,0,2,4,2,2,0,0,56,40,52,39,1,2,0,30123016.4
KYLE.GREENTREE,20082009,CGY,18.583333333333332,0,0,0,0,0,0,0,0,0,3,5,1,1,2,0,16,20,12,19,0,1,0,30123015.770000003
KYLE.OKPOSO,20082009,NYI,1170.65,18,13,8,21,39,31,5,15,10,165,314,63,90,23,16,1147,1016,692,773,27,31,0.3333333333333333,30123108.98
KYLE.QUINCEY,20082009,L.A,1510.7833333333333,4,22,12,34,38,26,0,0,0,150,360,116,126,12,30,1679,1140,1057,870,43,40,0,30123093.72
KYLE.TURRIS,20082009,ARI,797.6333333333333,8,8,4,12,20,16,236,548,312,89,141,33,30,19,8,736,712,491,642,17,33,0.4306569343065693,30123107.58
KYLE.WELLWOOD,20082009,VAN,1156.0500000000002,19,9,5,14,33,28,395,712,317,100,165,20,27,15,6,1127,848,657,758,32,28,0.5547752808988764,30123122.075
LADISLAV.SMID,20082009,EDM,897.2666666666667,0,5,6,11,11,5,0,0,0,33,67,93,20,17,24,619,865,580,753,29,33,0,30123098.72
LANDON.WILSON,20082009,DAL,249.21666666666664,2,5,1,6,8,7,0,3,3,34,64,47,14,3,9,189,195,174,193,10,6,0,30123037.605
LASSE.KUKKONEN,20082009,PHI,235.75,0,1,1,2,2,1,0,1,1,10,14,15,4,4,5,198,235,185,187,7,9,0,30123032.615000002
LAURI.KORPIKOSKI,20082009,NYR,834.2666666666667,6,9,1,10,16,15,94,237,143,68,116,100,25,20,7,643,795,585,684,22,29,0.39662447257383965,30123099.884999998
LAWRENCE.NYCHOLAT,20082009,COL,52.733333333333334,0,0,0,0,0,0,0,0,0,1,6,1,3,1,0,45,38,41,34,0,2,0,30123016.16
LAWRENCE.NYCHOLAT,20082009,VAN,136.05,0,1,0,1,1,1,0,0,0,8,18,10,6,2,3,101,128,88,125,7,4,0,30123027.32
LEE.STEMPNIAK,20082009,STL,272.6,3,7,2,9,12,10,0,1,1,43,81,20,28,7,1,291,228,153,175,6,7,0,30123035.520000003
LEE.STEMPNIAK,20082009,TOR,967.75,11,8,11,19,30,19,4,12,8,128,254,87,76,15,15,1057,861,747,762,30,33,0.3333333333333333,30123096.634999998
LIAM.REDDOX,20082009,EDM,481.65,5,6,1,7,12,11,11,25,14,39,66,61,12,7,5,306,529,281,429,16,22,0.44,30123069.835
LOUI.ERIKSSON,20082009,DAL,1624.6666666666665,36,12,15,27,63,48,2,11,9,178,282,31,44,24,6,1537,1265,1012,913,53,43,0.18181818181818182,30123128.695
LUBOMIR.VISNOVSKY,20082009,EDM,1150.7666666666667,8,8,15,23,31,16,0,0,0,86,200,27,60,9,15,1246,868,810,735,36,25,0,30123086.615000002
LUCA.CAPUTI,20082009,PIT,51.349999999999994,1,0,0,0,1,1,0,0,0,7,13,3,4,0,2,37,50,34,47,2,2,0,30123019.3
LUCA.SBISA,20082009,PHI,687.1833333333334,0,3,4,7,7,3,0,0,0,38,96,46,39,7,19,612,650,469,580,17,20,0,30123075.42
LUKAS.KASPAR,20082009,S.J,118.78333333333333,2,2,0,2,4,4,0,4,4,14,24,18,5,5,4,126,78,113,75,4,4,0,30123021.8
LUKAS.KRAJICEK,20082009,T.B,1392.8333333333335,2,8,8,16,18,10,0,0,0,66,136,54,47,0,25,1016,1366,838,946,35,51,0,30123114.65
LUKE.RICHARDSON,20082009,OTT,25.5,0,0,0,0,0,0,0,0,0,0,1,2,1,0,1,19,27,19,16,0,3,0,15061508.2
LUKE.SCHENN,20082009,TOR,1489.3166666666666,2,7,4,11,13,9,0,0,0,100,225,203,87,16,24,1279,1717,1144,1219,46,58,0,30123133.509999998
MANNY.MALHOTRA,20082009,CBJ,1458.2166666666667,11,12,12,24,35,23,NA,1454,NA,119,212,81,44,15,13,1115,1336,872,860,39,35,NA,NA
MARC-ANDRE.BERGERON,20082009,MIN,1214.9166666666665,14,8,10,18,32,22,0,0,0,139,306,30,107,7,15,1310,870,852,776,37,29,0,30123089.92
MARC-ANDRE.GRAGNANI,20082009,BUF,61.55,0,0,0,0,0,0,0,0,0,3,7,3,2,0,1,50,62,43,43,4,2,0,15061510.45
MARC-ANTOINE.POULIOT,20082009,EDM,724.8333333333334,8,6,6,12,20,14,102,210,108,94,157,42,30,9,10,671,660,571,624,24,26,0.4857142857142857,30123090.47
MARC-EDOUARD.VLASIC,20082009,S.J,2084.116666666667,6,11,19,30,36,17,0,0,0,109,270,65,105,15,17,2066,1819,1445,1264,57,53,0,30123126.375
MARC.METHOT,20082009,CBJ,1249.9166666666665,4,3,10,13,17,7,0,0,0,59,124,144,33,12,22,995,974,921,749,50,45,0,30123078.92
MARC.SAVARD,20082009,BOS,1799.3166666666666,31,41,27,68,99,72,730,1460,730,229,383,26,86,32,30,1989,1556,1264,1181,69,41,0.5,30123195.945
MARC.STAAL,20082009,NYR,1883.4833333333331,4,6,5,11,15,10,0,0,0,100,225,209,78,22,24,1656,1769,1410,1218,48,63,0,30123122.095
MARCEL.GOC,20082009,S.J,828.6833333333334,2,5,4,9,11,7,350,606,256,111,191,90,38,16,10,656,642,601,486,15,23,0.5775577557755776,30123069.36
MARCO.STURM,20082009,BOS,290.18333333333334,7,5,1,6,13,12,2,3,1,44,64,12,6,5,4,297,230,160,158,10,3,0.6666666666666666,30123037.405
MAREK.MALIK,20082009,T.B,804.8833333333333,0,4,0,4,4,4,0,0,0,22,55,14,25,3,18,615,813,528,611,21,25,0,30123077.880000003
MAREK.SVATOS,20082009,COL,904.2666666666667,14,13,7,20,34,27,0,3,3,140,235,37,54,18,16,870,715,587,644,25,31,0,30123096.105
MAREK.ZIDLICKY,20082009,MIN,1680.3,12,13,17,30,42,25,0,0,0,147,319,74,109,16,37,1630,1315,1093,1018,37,42,0,30123119.535
MARIAN.GABORIK,20082009,MIN,339.8833333333333,13,7,3,10,23,20,0,5,5,68,100,15,23,7,0,303,262,197,212,15,12,0,30123046.645000003
MARIAN.HOSSA,20082009,DET,1727.15,46,24,14,38,84,70,7,25,18,401,658,125,125,41,31,2119,1157,1381,950,73,36,0.28,30123129.64
MARK.EATON,20082009,PIT,1628.0166666666667,8,4,4,8,16,12,1,1,0,49,116,52,37,7,23,1238,1657,1064,1181,51,41,1,30123138.31
MARK.FISTRIC,20082009,DAL,573.3166666666666,0,2,1,3,3,2,0,0,0,35,60,114,13,2,16,418,556,378,387,17,18,0,30123053.495
MARK.GIORDANO,20082009,CGY,919.4,2,6,11,17,19,8,0,0,0,82,177,54,60,15,25,1059,650,791,535,37,29,0,30123053.174999997
MARK.MANCARI,20082009,BUF,92.83333333333334,1,0,1,1,2,1,4,7,3,21,32,8,3,1,2,106,58,70,52,1,5,0.5714285714285714,30123019.445
MARK.PARRISH,20082009,DAL,495.9166666666667,8,3,2,5,13,11,1,5,4,46,93,30,15,4,9,421,428,298,413,12,14,0.2,30123067.78
MARK.RECCHI,20082009,BOS,481.16666666666663,13,5,3,8,21,18,3,3,0,51,67,51,3,7,2,450,390,274,335,13,12,1,30123062.615000002
MARK.RECCHI,20082009,T.B,1047.1666666666665,13,19,12,31,44,32,22,54,32,97,164,78,37,17,10,957,901,550,630,26,33,0.4074074074074074,30123099.4
MARK.STREIT,20082009,NYI,1866.0333333333333,16,22,18,40,56,38,0,0,0,150,328,114,105,16,31,1941,1639,1187,1178,55,52,0,30123143.81
MARK.STUART,20082009,BOS,1444.5666666666666,5,4,9,13,18,9,0,0,0,68,191,117,83,19,29,1157,1340,1088,1111,55,30,0,30123119.365
MARKUS.NASLUND,20082009,NYR,1521.3833333333332,25,9,14,23,48,34,1,3,2,225,400,66,88,24,32,1735,1116,1203,1003,39,40,0.3333333333333333,30123124.630000003
MARTIN.ERAT,20082009,NSH,1318.0333333333333,17,13,19,32,49,30,11,38,27,149,254,36,50,24,23,1368,1019,893,815,38,39,0.2894736842105263,30123110.755
MARTIN.HANZAL,20082009,ARI,1200.1333333333332,11,10,9,19,30,21,515,1064,549,96,175,130,40,34,17,876,1207,700,770,24,35,0.48402255639097747,30123128.265
MARTIN.HAVLAT,20082009,CHI,1659.1666666666665,34,40,18,58,92,74,2,8,6,283,406,25,68,30,16,1708,1052,1170,910,70,50,0.25,30123135.08
MARTIN.SKOULA,20082009,MIN,1616.9666666666667,4,3,7,10,14,7,0,0,0,55,108,57,28,6,5,1148,1658,1035,1186,41,57,0,30123137.835
MARTIN.ST. LOUIS,20082009,T.B,1745.45,30,26,23,49,79,56,14,30,16,261,451,17,69,32,7,1841,1435,1054,1026,58,46,0.4666666666666667,30123147.755000003
MARTIN.ST. PIERRE,20082009,BOS,159.6,2,2,0,2,4,4,43,101,58,15,26,8,4,5,2,127,132,105,100,4,6,0.42574257425742573,30123028.12
MARTINS.KARSUMS,20082009,BOS,58.46666666666667,0,1,0,1,1,1,0,1,1,6,6,11,0,1,0,51,56,51,54,1,4,0,30123019.81
MARTINS.KARSUMS,20082009,T.B,210.11666666666667,1,4,0,4,5,5,2,2,0,22,31,36,6,4,3,168,171,146,162,5,8,1,30123033.32
MARTY.REASONER,20082009,ATL,1209.2666666666667,14,9,6,15,29,23,603,1140,537,131,221,41,43,26,16,830,1352,732,821,32,28,0.5289473684210526,30123134.03
MASON.RAYMOND,20082009,VAN,1124.4499999999998,12,4,9,13,25,16,17,51,34,160,267,60,47,23,14,958,930,707,727,27,25,0.3333333333333333,30123099.235
MATHIEU.DANDENAULT,20082009,MTL,566.2,4,7,1,8,12,11,2,5,3,54,86,47,18,7,7,481,572,443,422,19,16,0.4,30123059.775
MATHIEU.SCHNEIDER,20082009,ATL,925.1,4,5,6,11,15,9,0,0,0,81,170,57,52,2,25,919,797,655,631,30,37,0,30123076.92
MATHIEU.SCHNEIDER,20082009,MTL,519.65,5,6,6,12,17,11,0,0,0,51,118,20,31,2,8,576,460,310,357,11,11,0,30123056.270000003
MATS.SUNDIN,20082009,VAN,803.5,12,20,4,24,36,32,377,687,310,97,190,19,51,8,15,832,594,493,509,23,23,0.5487627365356623,30123092.71
MATT.BELESKEY,20082009,ANA,22.316666666666666,0,0,0,0,0,0,0,2,2,0,5,0,2,0,0,14,12,14,11,1,1,0,15061507.35
MATT.BRADLEY,20082009,WSH,1037.7833333333333,7,7,2,9,16,14,11,26,15,113,195,155,52,24,16,853,947,803,804,25,27,0.4230769230769231,30123100.23
MATT.CARKNER,20082009,OTT,4.133333333333334,0,0,0,0,0,0,0,0,0,0,0,2,0,0,0,1,3,1,3,0,0,0,15061507.15
MATT.CARLE,20082009,PHI,1495.5333333333333,4,11,11,22,26,15,0,0,0,85,174,43,68,9,10,1576,1344,1138,1145,52,52,0,30123125.865000002
MATT.CARLE,20082009,T.B,263.5333333333333,1,1,0,1,2,2,0,0,0,13,24,4,5,2,3,204,240,150,155,6,4,0,30123029.97
MATT.COOKE,20082009,PIT,1427.8833333333332,14,14,8,22,36,28,9,26,17,116,218,342,46,33,43,1109,1377,1001,1079,44,51,0.34615384615384615,30123143.24
MATT.CULLEN,20082009,CAR,1443.35,25,16,7,23,48,41,583,1134,551,167,300,57,74,20,15,1351,1326,993,983,42,38,0.5141093474426808,30123153.245
MATT.D'AGOSTINI,20082009,MTL,746.1333333333333,12,2,7,9,21,14,3,10,7,121,198,49,43,14,9,785,648,584,564,18,35,0.3,30123077.635
MATT.ELLIS,20082009,BUF,397.45,7,1,4,5,12,8,112,239,127,73,103,21,13,3,6,310,391,282,331,11,8,0.4686192468619247,30123061.009999998
MATT.GREENE,20082009,L.A,1618.7833333333333,2,5,5,10,12,7,1,1,0,76,182,202,42,22,42,1263,1558,1133,1064,43,42,1,30123118.535
MATT.HALISCHUK,20082009,N.J,9.783333333333333,0,0,1,1,1,0,0,0,0,0,0,0,0,0,0,1,22,1,22,1,2,0,15061509.925
MATT.HENDRICKS,20082009,COL,34.016666666666666,0,0,0,0,0,0,0,1,1,5,7,8,0,2,5,29,38,29,38,1,1,0,15061511.92
MATT.HUNWICK,20082009,BOS,901.8666666666667,5,11,9,20,25,16,0,0,0,58,114,45,39,7,14,800,806,638,676,41,25,0,30123086.295
MATT.LASHOFF,20082009,BOS,209.75,0,0,1,1,1,0,0,0,0,6,17,7,7,1,5,178,175,170,166,7,5,0,30123028.935000002
MATT.LASHOFF,20082009,T.B,285.2166666666667,0,2,4,6,6,2,0,0,0,19,33,8,10,3,5,246,244,159,200,4,8,0,30123036.58
MATT.MOULSON,20082009,L.A,101.44999999999999,1,0,0,0,1,1,0,0,0,6,11,2,3,3,1,69,87,55,65,2,5,0,30123020.93
MATT.NISKANEN,20082009,DAL,1598.5500000000002,6,13,16,29,35,19,0,0,0,111,250,87,81,12,19,1415,1267,1008,946,52,63,0,30123106.119999997
MATT.PELECH,20082009,CGY,66.35,0,0,2,2,2,0,0,0,0,4,12,5,5,2,3,81,46,75,46,4,3,0,30123016.12
MATT.PETTINGER,20082009,T.B,726.6,8,3,3,6,14,11,3,18,15,81,124,93,17,9,9,530,723,478,601,17,25,0.16666666666666666,30123088.335
MATT.SMABY,20082009,T.B,820.6333333333334,0,2,1,3,3,2,1,1,0,28,69,122,25,5,22,558,933,514,619,24,33,1,30123079.215
MATT.STAJAN,20082009,TOR,1266.0666666666666,15,18,22,40,55,33,598,1160,562,112,190,112,38,22,22,1320,1198,906,889,46,46,0.5155172413793103,30123142.240000002
MATT.WALKER,20082009,CHI,1342.2333333333331,1,6,9,15,16,7,0,0,0,98,190,93,59,21,28,1065,1270,997,930,41,43,0,30123102.134999998
MATTHEW.LOMBARDI,20082009,ARI,380.26666666666665,4,8,3,11,15,12,188,368,180,55,80,24,12,3,7,324,350,203,257,11,10,0.5108695652173914,30123056.825000003
MATTHEW.LOMBARDI,20082009,CGY,812.75,9,11,10,21,30,20,244,455,211,116,183,19,30,13,11,796,706,635,534,38,26,0.5362637362637362,30123080.439999998
MATTIAS.OHLUND,20082009,VAN,1988.5,7,10,7,17,24,17,0,0,0,142,299,119,103,14,48,1588,1875,1121,1314,65,48,0,30123154.715
MAX.PACIORETTY,20082009,MTL,429.08333333333337,3,7,1,8,11,10,1,2,1,57,95,43,18,13,12,432,400,340,380,14,15,0.5,30123059.545
MAX.TALBOT,20082009,PIT,1411.0833333333333,20,9,6,15,35,29,355,715,360,138,230,145,45,30,28,1003,1558,861,1035,42,49,0.4965034965034965,30123157.9
MAXIM.AFINOGENOV,20082009,BUF,605.1333333333334,6,6,8,14,20,12,0,3,3,92,171,20,43,19,11,654,473,463,426,18,22,0,30123059.79
MAXIM.LAPIERRE,20082009,MTL,1228.7,15,7,6,13,28,22,548,1036,488,174,275,136,56,48,33,1027,1337,880,968,38,31,0.528957528957529,30123148.450000003
MAXIM.MAYOROV,20082009,CBJ,17.2,0,0,0,0,0,0,0,0,0,1,1,1,0,0,0,11,23,11,21,0,0,0,15061509.4
MICHAEL.FROLIK,20082009,FLA,1169.8333333333335,21,13,11,24,45,34,27,67,40,158,251,46,49,22,10,1184,988,849,886,43,32,0.40298507462686567,30123124.175
MICHAEL.KOMISAREK,20082009,MTL,1436.8166666666666,2,4,5,9,11,6,0,0,0,61,170,200,86,32,59,1126,1679,1025,1148,44,50,0,30123131.145
MICHAEL.NYLANDER,20082009,WSH,1036.9833333333333,9,16,8,24,33,25,298,647,349,87,143,9,32,12,17,1218,806,922,723,38,34,0.4605873261205564,30123102.54
MICHAEL.PECA,20082009,CBJ,1051.9833333333333,4,13,4,17,21,17,434,874,440,78,144,57,32,4,21,755,984,599,615,27,32,0.4965675057208238,30123101.950000003
MICHAEL.RUPP,20082009,N.J,676.85,3,2,4,6,9,5,46,92,46,83,130,153,24,37,43,516,532,496,524,16,21,0.5,30123077.61
MICHAEL.RYAN,20082009,CAR,147.55,0,1,1,2,2,1,1,6,5,24,41,9,10,2,1,146,108,143,106,3,6,0.16666666666666666,30123022.534999996
MICHAEL.RYDER,20082009,BOS,1262.85,31,19,15,34,65,50,8,16,8,208,349,115,79,16,17,1441,926,931,811,61,25,0.5,30123114.305
MICHAEL.SAUER,20082009,NYR,28.05,0,0,0,0,0,0,0,0,0,2,4,2,0,0,0,15,30,13,28,1,2,0,30123017
MICHAEL.VERNACE,20082009,COL,235.88333333333333,0,0,0,0,0,0,0,0,0,9,19,20,8,0,4,151,220,135,171,2,8,0,30123031.95
MICHAEL.YORK,20082009,CBJ,13.25,0,0,0,0,0,0,0,0,0,1,1,1,0,0,0,17,8,12,8,0,0,0,15061507.4
MICHAEL.ZIGOMANIS,20082009,PIT,251.43333333333334,2,1,3,4,6,3,158,251,93,23,38,17,10,4,7,184,246,141,159,6,9,0.6294820717131474,30123035.384999998
MICHAL.HANDZUS,20082009,L.A,1550.1166666666668,18,17,7,24,42,35,719,1319,600,143,224,75,32,22,16,1374,1428,756,834,25,34,0.5451099317664898,30123147.305
MICHAL.REPIK,20082009,FLA,37.65,2,0,0,0,2,2,1,1,0,7,11,8,1,1,1,36,38,34,36,2,1,1,15061511.9
MICHAL.ROZSIVAL,20082009,NYR,1869.0333333333333,8,14,7,21,29,22,0,0,0,124,294,102,97,15,26,1820,1502,1200,1047,46,49,0,30123113.175
MICHEL.OUELLET,20082009,VAN,28.933333333333334,0,0,0,0,0,0,0,1,1,3,4,3,0,1,0,32,25,30,24,1,0,0,15061508.91
MIKAEL.BACKLUND,20082009,CGY,10.733333333333333,0,0,0,0,0,0,2,7,5,1,3,0,0,0,0,16,5,10,5,0,0,0.2857142857142857,15061507.28
MIKAEL.SAMUELSSON,20082009,DET,1576.6000000000001,24,9,17,26,50,33,3,12,9,333,538,133,111,26,27,1898,1014,1307,929,48,37,0.25,30123108.055
MIKE.BROWN,20082009,ANA,390.9666666666667,2,0,2,2,4,2,3,9,6,44,73,77,11,15,21,231,422,206,278,6,9,0.3333333333333333,30123049.67
MIKE.BROWN,20082009,VAN,109.71666666666667,0,0,0,0,0,0,0,2,2,6,15,30,6,17,20,49,89,49,89,0,5,0,30123027.07
MIKE.CAMMALLERI,20082009,CGY,1512.5,40,22,21,43,83,62,232,383,151,268,422,27,75,28,17,1739,1034,1118,897,54,44,0.6057441253263708,30123135.935
MIKE.COMMODORE,20082009,CBJ,1940.6,5,11,7,18,23,16,2,3,1,107,236,214,83,15,51,1373,1967,1131,1298,54,63,0.6666666666666666,30123154.355
MIKE.COMRIE,20082009,NYI,675.0333333333333,7,6,7,13,20,13,161,389,228,80,126,27,32,10,11,639,639,422,572,18,27,0.4138817480719794,30123094.965
MIKE.COMRIE,20082009,OTT,314.26666666666665,3,2,2,4,7,5,10,27,17,41,63,12,9,2,3,294,265,203,252,5,12,0.37037037037037035,30123045.67
MIKE.FISHER,20082009,OTT,1442.6333333333334,13,10,9,19,32,23,535,1044,509,181,326,211,78,25,28,1267,1257,776,875,33,33,0.5124521072796935,30123138.175
MIKE.GREEN,20082009,WSH,2102.2833333333333,32,20,27,47,79,52,0,0,0,267,552,120,173,25,40,2631,1708,1580,1189,66,54,0,30123132.025
MIKE.GRIER,20082009,S.J,993.7166666666667,10,8,5,13,23,18,15,46,31,116,186,163,19,23,10,793,947,686,656,21,21,0.32608695652173914,30123092.305
MIKE.IGGULDEN,20082009,NYI,133.38333333333333,1,3,1,4,5,4,1,2,1,16,31,16,6,0,2,128,124,121,122,6,9,0.5,30123027.515
MIKE.KNUBLE,20082009,PHI,1600.8333333333335,29,14,7,21,50,43,18,54,36,192,321,104,50,21,32,1552,1499,1018,1083,45,45,0.3333333333333333,30123155.555
MIKE.LUNDIN,20082009,T.B,416.2166666666667,0,1,1,2,2,1,0,1,1,8,24,6,9,4,2,253,464,235,287,9,12,0,30123043.515
MIKE.MODANO,20082009,DAL,1463.35,15,18,13,31,46,33,617,1175,558,197,360,35,75,24,22,1418,1165,804,781,35,41,0.5251063829787234,30123130.445
MIKE.MOTTAU,20082009,N.J,1548.7833333333333,2,6,9,15,17,8,0,0,0,72,162,47,57,14,16,1411,1267,1219,1106,57,41,0,30123112.865000002
MIKE.RIBEIRO,20082009,DAL,1717.4,22,33,22,55,77,55,564,1239,675,163,273,117,47,41,24,1806,1227,1032,938,55,56,0.4552058111380145,30123162.77
MIKE.RICHARDS,20082009,PHI,1852.9166666666665,31,39,15,54,85,70,867,1781,914,258,516,165,140,44,26,1800,1794,1059,1153,51,48,0.48680516563728243,30123203.395000003
MIKE.SANTORELLI,20082009,NSH,85.78333333333333,0,0,0,0,0,0,21,47,26,11,17,3,5,1,1,86,67,74,61,1,4,0.44680851063829785,30123019.85
MIKE.SILLINGER,20082009,NYI,98.95,2,0,0,0,2,2,71,121,50,14,24,7,5,1,0,91,106,60,89,2,5,0.5867768595041323,30123026.7
MIKE.VAN RYN,20082009,TOR,529.8,3,4,4,8,11,7,0,0,0,53,93,13,20,1,7,525,487,377,361,18,15,0,30123051.41
MIKE.WEAVER,20082009,STL,1069.2,0,2,5,7,7,2,0,0,0,38,71,45,21,11,6,743,1035,667,692,21,25,0,30123082.035
MIKE.WEBER,20082009,BUF,98.73333333333333,0,0,0,0,0,0,0,0,0,2,3,16,0,2,8,53,99,50,85,0,3,0,30123025.07
MIKHAIL.GRABOVSKI,20082009,TOR,1244.7833333333333,19,17,11,28,47,36,417,940,523,117,250,44,71,23,29,1349,1014,973,912,38,45,0.44361702127659575,30123141.185000002
MIKKEL.BOEDKER,20082009,ARI,1195.7666666666667,11,6,11,17,28,17,1,8,7,112,201,76,35,15,8,1026,1116,736,870,30,37,0.125,30123116.564999998
MIKKO.KOIVU,20082009,MIN,1695.5666666666666,20,26,20,46,66,46,855,1622,767,235,384,45,84,21,29,1618,1435,975,974,45,40,0.5271270036991369,30123167.41
MIKKO.LEHTONEN,20082009,BOS,16.233333333333334,0,0,0,0,0,0,0,0,0,1,1,0,0,0,0,11,13,10,11,0,0,0,15061507.95
MILAN.HEJDUK,20082009,COL,1633.55,27,18,14,32,59,45,72,160,88,211,351,30,80,17,8,1600,1402,989,1054,46,58,0.45,30123148.7
MILAN.JURCINA,20082009,WSH,1511.0333333333333,5,6,5,11,16,11,0,0,0,105,234,209,74,11,40,1395,1341,1313,1154,50,43,0,30123120.884999998
MILAN.LUCIC,20082009,BOS,1213.25,20,12,17,29,49,32,5,12,7,115,198,296,43,43,49,1256,1027,1048,978,59,28,0.4166666666666667,30123128.205
MILAN.MICHALEK,20082009,S.J,1537.0666666666666,23,21,13,34,57,44,14,31,17,197,303,100,35,24,22,1614,1230,1066,841,40,34,0.45161290322580644,30123117.825000003
MIROSLAV.SATAN,20082009,PIT,1180.8,17,15,8,23,40,32,6,13,7,139,262,28,65,13,17,1183,967,835,902,41,32,0.46153846153846156,30123121.82
MITCHELL.FRITZ,20082009,NYI,53.650000000000006,0,0,0,0,0,0,1,1,0,2,4,6,0,8,12,39,57,35,57,0,5,1,30123022.27
NATE.RADUNS,20082009,PHI,6.033333333333333,0,0,0,0,0,0,0,1,1,0,0,1,0,0,0,4,7,4,7,0,0,0,15061507.65
NATE.THOMPSON,20082009,NYI,519.5166666666667,2,1,1,2,4,3,216,429,213,56,93,83,21,7,13,364,645,315,429,9,21,0.5034965034965035,30123072.935000002
NATHAN.GERBE,20082009,BUF,136.11666666666667,0,1,0,1,1,1,1,1,0,24,38,11,8,4,2,138,82,105,80,4,1,1,30123020.53
NATHAN.GUENIN,20082009,PHI,13.416666666666668,0,0,0,0,0,0,0,0,0,0,0,0,0,0,0,7,11,7,11,0,0,0,15061508.05
NATHAN.HORTON,20082009,FLA,1196.3166666666666,22,11,11,22,44,33,376,862,486,131,274,95,78,18,24,1263,1025,804,873,43,39,0.4361948955916473,30123139.245
NATHAN.MCIVER,20082009,ANA,169.15,0,1,0,1,1,1,0,0,0,5,13,37,2,6,8,116,137,112,124,3,1,0,30123027.810000002
NATHAN.OYSTRICK,20082009,ATL,834.4166666666667,4,4,3,7,11,8,0,0,0,43,101,91,32,14,18,706,736,612,626,29,30,0,30123077.865000002
NATHAN.PAETSCH,20082009,BUF,280.2833333333333,2,3,1,4,6,5,0,0,0,21,36,11,9,6,7,257,232,234,211,9,7,0,30123036.035
NICK.BOYNTON,20082009,FLA,1128.6833333333334,5,8,8,16,21,13,0,0,0,104,229,52,82,12,29,1054,1096,840,883,43,39,0,30123103.37
NICK.FOLIGNO,20082009,OTT,1107.85,17,12,3,15,32,29,21,47,26,145,228,97,40,34,25,1030,779,700,709,26,34,0.44680851063829785,30123106.105
NICK.SCHULTZ,20082009,MIN,1623.55,2,3,5,8,10,5,0,1,1,48,117,78,41,9,13,1022,1722,922,1225,37,45,0,30123147.365000002
NICK.TARNASKY,20082009,FLA,267.6,1,3,1,4,5,4,0,1,1,32,49,68,10,7,8,204,277,198,273,8,12,0,30123047.195
NICK.TARNASKY,20082009,NSH,62.03333333333333,0,0,1,1,1,0,0,0,0,6,8,14,0,4,4,45,64,45,64,3,2,0,30123021.415
NICKLAS.BACKSTROM,20082009,WSH,1938.6666666666667,25,49,28,77,102,74,675,1386,711,207,370,68,83,14,27,2511,1538,1581,1238,67,54,0.487012987012987,30123187.54
NICKLAS.BERGFORS,20082009,N.J,46.383333333333326,1,0,0,0,1,1,0,0,0,6,9,0,1,0,0,33,44,31,43,1,2,0,30123019.1
NICKLAS.GROSSMANN,20082009,DAL,1428.5833333333335,2,5,5,10,12,7,0,0,0,59,139,178,48,8,24,995,1348,884,969,35,51,0,30123113.355
NICKLAS.LIDSTROM,20082009,DET,2448.483333333333,19,29,24,53,72,48,0,0,0,234,466,57,124,5,18,2711,1901,1694,1221,79,50,0,30123127
NICLAS.HAVELID,20082009,ATL,1316.8333333333333,2,7,4,11,13,9,0,0,0,41,92,36,34,8,21,851,1477,742,1008,41,46,0,30123127.18
NICLAS.HAVELID,20082009,N.J,418.41666666666663,0,3,2,5,5,3,0,0,0,18,35,8,11,1,4,427,377,288,309,12,14,0,30123045.310000002
NICLAS.WALLIN,20082009,CAR,1272.1,2,4,3,7,9,6,0,1,1,63,152,149,59,9,23,1039,1266,959,885,33,35,0,30123095.065
NIGEL.DAWES,20082009,ARI,155.9,0,2,0,2,2,2,0,0,0,18,30,11,9,0,0,143,137,91,126,3,7,0,30123028.05
NIGEL.DAWES,20082009,NYR,678.5166666666667,10,5,4,9,19,15,0,0,0,96,166,73,28,9,7,676,579,591,550,25,22,0,30123074.49
NIK.ANTROPOV,20082009,NYR,424.4,9,3,4,7,16,12,1,7,6,70,115,48,17,6,6,459,332,294,291,9,14,0.14285714285714285,30123051.55
NIK.ANTROPOV,20082009,TOR,1064.5500000000002,21,20,5,25,46,41,80,193,113,168,287,80,56,12,11,1196,901,797,693,38,45,0.41450777202072536,30123104.595
NIKITA.FILATOV,20082009,CBJ,65,4,0,0,0,4,4,0,0,0,10,13,2,3,1,0,63,43,48,39,5,2,0,30123019.060000002
NIKLAS.HAGMAN,20082009,TOR,1089.5666666666666,22,9,10,19,41,31,0,1,1,165,286,22,63,25,2,1141,976,789,770,34,38,0,30123104.95
NIKLAS.HJALMARSSON,20082009,CHI,597.35,1,0,3,3,4,1,0,0,0,25,54,24,18,2,3,392,482,366,361,17,15,0,30123046.745
NIKLAS.KRONWALL,20082009,DET,2344.133333333333,8,24,26,50,58,32,1,1,0,151,319,152,90,13,36,2454,1770,1730,1266,77,70,1,30123125.67
NIKOLAI.ZHERDEV,20082009,NYR,1467.7333333333333,23,22,13,35,58,45,1,13,12,232,416,53,94,27,19,1710,1037,1141,931,52,46,0.07692307692307693,30123118.685000002
NIKOLAY.KULEMIN,20082009,TOR,992.4333333333333,15,10,6,16,31,25,35,66,31,125,238,71,57,11,9,1019,834,784,785,36,45,0.5303030303030303,30123103.46
NOAH.WELCH,20082009,FLA,152.73333333333335,1,0,1,1,2,1,0,0,0,11,18,22,4,3,4,118,156,117,153,3,8,0,30123031.505000003
NOAH.WELCH,20082009,T.B,284.85,0,0,0,0,0,0,0,0,0,11,26,29,9,1,7,211,280,189,223,7,10,0,30123036.71
OLE-KRISTIAN.TOLLEFSEN,20082009,CBJ,196.36666666666667,0,0,1,1,1,0,0,0,0,12,23,25,6,8,10,167,156,164,133,5,10,0,30123025.855
OLLI.JOKINEN,20082009,ARI,1034.4166666666665,21,14,7,21,42,35,310,735,425,169,281,48,44,10,22,1122,890,665,762,26,29,0.4217687074829932,30123136.975
OLLI.JOKINEN,20082009,CGY,516.35,10,7,3,10,20,17,140,293,153,90,145,39,22,9,11,600,412,385,332,17,22,0.4778156996587031,30123061.765
OSCAR.MOLLER,20082009,L.A,534.7833333333333,7,3,5,8,15,10,37,86,49,81,152,46,30,8,7,572,363,369,318,13,12,0.43023255813953487,30123050.485
OSKAR.OSALA,20082009,WSH,17.45,0,0,0,0,0,0,0,0,0,1,4,0,1,1,0,20,19,20,19,0,1,0,15061508.51
OSSI.VAANANEN,20082009,PHI,849.4333333333333,1,3,6,9,10,4,0,0,0,18,41,85,10,5,11,577,962,493,657,26,24,0,30123087.4
OSSI.VAANANEN,20082009,VAN,56.08333333333333,0,0,0,0,0,0,0,0,0,2,4,5,1,0,1,34,58,34,55,3,2,0,15061512.95
OWEN.NOLAN,20082009,MIN,967.1166666666666,25,10,10,20,45,35,75,161,86,147,237,37,37,16,10,963,767,616,691,33,21,0.4658385093167702,30123112.16
P. J..AXELSSON,20082009,BOS,1354.4333333333334,6,14,10,24,30,20,18,51,33,96,178,72,43,13,9,1077,1259,786,883,24,37,0.35294117647058826,30123117
PASCAL.DUPUIS,20082009,PIT,1143.6999999999998,12,14,2,16,28,26,3,18,15,161,265,86,54,21,19,906,1241,824,849,33,36,0.16666666666666666,30123114.68
PASCAL.PELLETIER,20082009,CHI,63.93333333333333,0,0,0,0,0,0,13,33,20,7,14,2,2,3,1,65,40,60,40,1,5,0.3939393939393939,30123017.45
PATRIC.HORNQVIST,20082009,NSH,318.43333333333334,2,3,2,5,7,5,0,4,4,54,83,20,17,11,7,276,257,236,239,11,13,0,30123040.61
PATRICE.BERGERON,20082009,BOS,1330.5166666666669,8,23,11,34,42,31,650,1191,541,175,277,70,54,19,12,1176,1133,694,773,32,24,0.5457598656591099,30123132.215
PATRICE.BRISEBOIS,20082009,MTL,1001.85,5,4,8,12,17,9,0,0,0,69,167,46,73,4,8,1017,863,683,718,27,30,0,30123083.04
PATRICK.DAVIS,20082009,N.J,4.5,0,0,0,0,0,0,0,0,0,0,0,1,0,0,0,2,6,2,6,0,0,0,15061507.55
PATRICK.DWYER,20082009,CAR,120.91666666666666,1,0,1,1,2,1,6,15,9,9,18,18,3,0,0,98,122,92,72,3,4,0.4,30123020.415
PATRICK.EAVES,20082009,CAR,992.4333333333333,7,6,3,9,16,13,5,12,7,135,212,167,37,21,18,818,1008,750,751,24,19,0.4166666666666667,30123097.885
PATRICK.KALETA,20082009,BUF,454.98333333333335,4,2,3,5,9,6,1,5,4,35,63,137,8,45,28,326,407,316,351,15,13,0.2,30123057.615000002
PATRICK.KANE,20082009,CHI,1758.3000000000002,34,28,22,50,84,62,14,34,20,286,439,27,75,34,24,1914,1123,1222,987,51,55,0.4117647058823529,30123141.5
PATRICK.MARLEAU,20082009,S.J,1745.7333333333331,40,17,17,34,74,57,338,645,307,261,417,107,81,23,11,1940,1422,1169,957,51,44,0.524031007751938,30123144.325
PATRICK.O'SULLIVAN,20082009,EDM,346.4666666666667,2,1,3,4,6,3,23,60,37,59,90,6,15,5,6,340,342,269,276,8,13,0.38333333333333336,30123045.695
PATRICK.O'SULLIVAN,20082009,L.A,1204.5833333333333,14,13,10,23,37,27,18,39,21,200,392,60,92,31,7,1249,1003,829,686,35,28,0.46153846153846156,30123085.83
PATRICK.RISSMILLER,20082009,NYR,18.383333333333333,0,0,0,0,0,0,0,0,0,2,3,5,1,0,0,10,20,7,17,0,1,0,30123015.65
PATRICK.SHARP,20082009,CHI,1371.3333333333335,33,11,10,21,54,44,264,583,319,225,352,63,60,26,22,1393,937,894,716,39,32,0.4528301886792453,30123119.37
PATRIK.BERGLUND,20082009,STL,1159.6333333333332,21,16,10,26,47,37,220,551,331,146,256,62,48,14,9,1119,813,672,695,41,17,0.3992740471869328,30123118.19
PATRIK.ELIAS,20082009,N.J,1555.3833333333332,32,25,23,48,80,57,31,99,68,272,437,57,84,30,17,1733,1099,1006,804,44,30,0.31313131313131315,30123122.015
PAUL.BISSONNETTE,20082009,PIT,52.85000000000001,0,0,1,1,1,0,0,0,0,4,5,15,0,7,5,21,38,21,38,1,2,0,30123019.095
PAUL.GAUSTAD,20082009,BUF,997.8499999999999,12,14,3,17,29,26,451,857,406,120,181,140,18,25,33,821,887,598,600,30,24,0.5262543757292882,30123109.715
PAUL.KARIYA,20082009,STL,199.13333333333333,2,10,3,13,15,12,0,0,0,31,69,7,20,0,1,216,140,110,113,6,3,0,30123029.875
PAUL.MARA,20082009,NYR,1544.1333333333332,6,9,6,15,21,15,1,2,1,109,243,127,66,21,38,1514,1376,1046,1017,42,40,0.5,30123118.549999997
PAUL.MARTIN,20082009,N.J,1963.3000000000002,5,14,18,32,37,19,0,0,0,116,224,47,75,13,19,1909,1592,1286,1051,56,41,0,30123108.53
PAUL.RANGER,20082009,T.B,1028.4166666666667,2,3,7,10,12,5,0,0,0,69,150,63,51,15,24,839,943,613,580,29,27,0,30123068.625
PAUL.STASTNY,20082009,COL,955.75,11,18,7,25,36,29,440,849,409,118,168,19,29,15,11,862,784,517,533,21,30,0.5182567726737338,30123101.975
PAUL.SZCZECHURA,20082009,T.B,420.1166666666667,4,3,2,5,9,7,94,231,137,51,89,30,21,7,6,323,416,276,281,10,10,0.4069264069264069,30123051.229999997
PAVEL.DATSYUK,20082009,DET,1858.5166666666669,33,40,32,72,105,73,737,1324,587,298,529,105,120,39,14,2253,1227,1394,900,77,40,0.5566465256797583,30123136.119999997
PAVEL.KUBINA,20082009,TOR,1791.8666666666668,14,13,13,26,40,27,0,0,0,183,367,89,106,15,44,1886,1579,1227,1180,52,64,0,30123139.275
PAVOL.DEMITRA,20082009,VAN,1296.4833333333333,21,19,16,35,56,40,148,263,115,150,285,25,70,9,11,1357,957,857,823,43,35,0.5627376425855514,30123117.009999998
PER.LEDIN,20082009,COL,29.816666666666666,0,0,0,0,0,0,0,0,0,2,3,3,0,1,1,18,38,18,38,0,1,0,15061511.81
PETER.HARROLD,20082009,L.A,908.8833333333333,4,4,4,8,12,8,6,16,10,95,174,36,44,11,14,912,684,587,582,13,22,0.375,30123075.6
PETER.MUELLER,20082009,ARI,1139.1833333333334,13,11,12,23,36,24,41,92,51,136,245,35,62,6,12,1191,994,762,867,34,34,0.44565217391304346,30123117.9
PETER.OLVECKY,20082009,MIN,276.6333333333333,2,1,4,5,7,3,63,158,95,19,47,14,12,1,6,220,248,188,240,9,9,0.3987341772151899,30123045.18
PETER.REGIN,20082009,OTT,115.93333333333334,1,0,1,1,2,1,41,77,36,7,19,9,7,1,1,95,76,92,72,2,2,0.5324675324675324,30123021.025
PETR.PRUCHA,20082009,ARI,334.8,2,3,4,7,9,5,1,8,7,22,58,30,18,13,3,304,258,195,208,9,10,0.125,30123036.27
PETR.PRUCHA,20082009,NYR,339.98333333333335,4,1,4,5,9,5,0,0,0,44,73,46,13,10,4,345,269,298,263,9,10,0,30123041.3
PETR.SYKORA,20082009,PIT,1321.4333333333334,25,11,11,22,47,36,5,12,7,187,332,18,74,8,18,1360,1123,824,1001,46,36,0.4166666666666667,30123141.255000003
PETR.VRANA,20082009,N.J,110.38333333333333,1,0,0,0,1,1,15,36,21,6,18,0,8,1,2,97,86,86,81,3,7,0.4166666666666667,30123021.91
PETTERI.NOKELAINEN,20082009,ANA,322.01666666666665,4,1,1,2,6,5,125,276,151,28,47,22,4,2,3,180,352,161,195,6,5,0.4528985507246377,30123044.795
PETTERI.NOKELAINEN,20082009,BOS,319.1333333333333,0,3,0,3,3,3,54,87,33,30,45,30,9,10,5,236,224,227,215,5,6,0.6206896551724138,30123037.41
PHIL.KESSEL,20082009,BOS,1319.1833333333334,41,15,14,29,70,56,41,86,45,266,468,7,105,22,11,1436,1097,1096,992,61,31,0.47674418604651164,30123137.61
PHIL.ORESKOVIC,20082009,TOR,162.28333333333336,1,0,1,1,2,1,0,0,0,12,24,22,4,4,6,131,175,129,151,3,5,0,30123030.965
PHILIPPE.BOUCHER,20082009,DAL,348.2833333333333,0,0,3,3,3,0,0,0,0,29,62,31,20,2,6,274,347,204,238,8,11,0,30123037.395
PHILIPPE.BOUCHER,20082009,PIT,570.9666666666667,3,3,2,5,8,6,0,0,0,46,92,58,25,3,14,495,508,351,401,19,13,0,30123057.83
PHILIPPE.DUPUIS,20082009,COL,76.48333333333333,0,0,0,0,0,0,26,50,24,11,14,4,3,1,2,46,64,45,64,2,2,0.52,30123021.9
PIERRE-LUC.LETOURNEAU-LEBLOND,20082009,N.J,38.733333333333334,0,1,0,1,1,1,0,0,0,3,3,12,0,4,5,19,14,19,14,3,0,0,30123015.69
PIERRE-MARC.BOUCHARD,20082009,MIN,1205.2833333333333,16,15,15,30,46,31,NA,20,NA,141,208,7,32,12,11,1260,924,842,826,37,38,NA,NA
QUINTIN.LAING,20082009,WSH,10.316666666666666,0,0,0,0,0,0,0,0,0,2,2,2,0,1,0,7,6,7,5,1,0,0,15061507.11
R.J..UMBERGER,20082009,CBJ,1604.4499999999998,29,17,3,20,49,46,405,845,440,243,373,98,62,30,21,1456,1336,957,908,42,42,0.47928994082840237,30123149.674999997
RADEK.BONK,20082009,NSH,1018.3666666666666,9,10,6,16,25,19,449,749,300,99,156,58,34,11,17,842,787,569,667,15,22,0.5994659546061415,30123108.119999997
RADEK.DVORAK,20082009,FLA,1331.25,15,9,12,21,36,24,6,17,11,136,226,55,29,29,20,1014,1476,868,1056,38,45,0.35294117647058826,30123145.38
RADEK.MARTINEK,20082009,NYI,1099.9166666666667,6,1,3,4,10,7,0,0,0,54,115,82,40,7,14,899,1411,809,969,25,37,0,30123118.495
RADEK.SMOLENAK,20082009,T.B,50.05,0,1,0,1,1,1,0,0,0,14,18,3,0,3,2,46,42,43,41,1,0,0,30123018.93
RADIM.VRBATA,20082009,T.B,255.9666666666667,3,2,0,2,5,5,1,3,2,41,69,3,17,3,4,242,198,157,164,5,7,0.3333333333333333,30123032.92
RAFFI.TORRES,20082009,CBJ,665.2,12,4,6,10,22,16,14,23,9,78,120,87,15,13,13,589,508,501,484,23,26,0.6086956521739131,30123072.689999998
RAITIS.IVANANS,20082009,L.A,484.48333333333335,2,0,0,0,2,2,0,0,0,25,50,125,8,29,46,299,389,294,382,3,11,0,30123064.29
RANDY.JONES,20082009,PHI,986.5166666666667,4,0,5,5,9,4,0,0,0,49,112,22,38,8,11,867,1046,657,773,33,29,0,30123093.305
RAY.WHITNEY,20082009,CAR,1820.4333333333334,27,40,20,60,87,67,2,5,3,273,464,30,98,26,17,2143,1351,1342,1130,52,54,0.4,30123152.39
RAYMOND.MACIAS,20082009,COL,107.9,0,1,0,1,1,1,0,0,0,4,12,2,5,1,0,92,87,75,77,2,1,0,30123021.01
RAYMOND.SAWADA,20082009,DAL,43.46666666666667,1,0,0,0,1,1,0,0,0,2,4,12,2,2,0,35,32,34,32,1,2,0,15061510.22
RENE.BOURQUE,20082009,CGY,1002,22,9,10,19,41,31,10,19,9,160,263,92,53,20,34,892,957,733,657,45,28,0.5263157894736842,30123095.45
RICH.PEVERLEY,20082009,ATL,734,13,14,8,22,35,27,290,554,264,74,125,16,25,12,9,640,740,422,536,29,20,0.5234657039711191,30123097.57
RICH.PEVERLEY,20082009,NSH,327.51666666666665,2,4,3,7,9,6,64,130,66,42,73,9,12,1,6,319,228,222,190,8,12,0.49230769230769234,30123037.395
RICHARD.PARK,20082009,NYI,1219.05,14,9,8,17,31,23,395,808,413,137,254,31,70,23,14,982,1350,727,889,27,43,0.48886138613861385,30123137.18
RICHARD.PETIOT,20082009,T.B,226.73333333333335,0,1,1,2,2,1,0,0,0,10,26,30,9,5,9,171,187,146,134,8,3,0,30123026.275
RICHARD.ZEDNIK,20082009,FLA,1090.1333333333332,17,13,3,16,33,30,0,1,1,153,253,68,48,14,22,1137,1001,853,929,42,38,0,30123127.115000002
RICK.NASH,20082009,CBJ,1733.7833333333333,40,27,14,41,81,67,5,18,13,276,492,81,105,47,25,1691,1359,1054,932,53,44,0.2777777777777778,30123139.42
RICK.RYPIEN,20082009,VAN,186.85000000000002,3,1,1,2,5,4,12,23,11,22,32,43,4,9,11,98,199,93,157,4,9,0.5217391304347826,30123037.195
RILEY.ARMSTRONG,20082009,S.J,14.866666666666667,0,0,0,0,0,0,0,0,0,1,2,1,1,1,1,11,12,7,10,0,1,0,30123014.71
RILEY.COTE,20082009,PHI,262.1166666666667,0,2,1,3,3,2,0,0,0,24,34,50,4,33,38,186,214,185,211,4,11,0,30123043.105
ROB.BLAKE,20082009,S.J,1683.9499999999998,11,12,25,37,48,23,0,0,0,224,403,74,124,11,46,1763,1497,1119,1001,48,39,0,30123116.285
ROB.DAVISON,20082009,VAN,232.06666666666666,0,2,0,2,2,2,0,0,0,15,33,28,7,9,13,175,212,170,197,7,11,0,30123036.34
ROB.NIEDERMAYER,20082009,ANA,1440.3333333333335,14,6,4,10,24,20,32,85,53,95,155,86,22,6,27,816,1523,704,953,26,43,0.3764705882352941,30123138.64
ROB.SCHREMP,20082009,EDM,54.3,0,2,1,3,3,2,1,2,1,3,6,3,1,0,2,41,45,30,42,3,2,0.5,30123019.365000002
ROB.SCUDERI,20082009,PIT,2024.0666666666666,2,3,16,19,21,5,0,0,0,58,109,79,39,2,12,1442,2211,1306,1501,69,53,0,30123166.119999997
ROBERT.LANG,20082009,MTL,843.8333333333333,18,10,11,21,39,28,374,767,393,101,181,17,38,8,18,878,759,497,521,24,24,0.4876140808344198,30123100.165
ROBERT.NILSSON,20082009,EDM,971.9166666666667,9,17,3,20,29,26,4,10,6,77,156,37,40,13,14,900,797,676,716,33,30,0.4,30123098.365000002
ROBYN.REGEHR,20082009,CGY,1560.8833333333332,0,0,8,8,8,0,0,0,0,79,188,122,75,14,31,1248,1482,1068,933,46,43,0,30123091.240000002
ROD.BRIND'AMOUR,20082009,CAR,1776.0833333333335,17,17,19,36,53,34,1027,1717,690,162,266,83,51,20,22,1737,1573,1132,1122,31,57,0.598136284216657,30123171.405
ROMAN.HAMRLIK,20082009,MTL,1875.5666666666666,5,16,10,26,31,21,0,0,0,151,278,109,79,9,32,1635,1941,1272,1416,57,63,0,30123167.39
ROMAN.POLAK,20082009,STL,1573.1999999999998,1,2,12,14,15,3,0,1,1,77,181,116,58,10,21,1270,1493,940,1033,37,49,0,30123117.05
RON.HAINSEY,20082009,ATL,1810.4333333333334,6,16,16,32,38,22,0,0,0,148,313,60,89,6,17,1565,1674,927,1097,38,50,0,30123136.86
ROSTISLAV.KLESLA,20082009,CBJ,798.6333333333334,1,1,5,6,7,2,0,1,1,33,79,72,34,9,16,606,741,493,481,20,16,0,30123058.715
ROSTISLAV.OLESZ,20082009,FLA,488.3833333333333,4,3,2,5,9,7,1,5,4,69,99,37,15,10,4,449,453,328,385,9,13,0.2,30123060.19
RUSLAN.FEDOTENKO,20082009,PIT,1251.5833333333335,23,16,14,30,53,39,7,29,22,174,306,152,71,20,20,1187,1071,986,969,63,35,0.2413793103448276,30123128.33
RUSLAN.SALEI,20082009,COL,1476.0333333333333,4,5,11,16,20,9,0,0,0,93,242,107,84,12,35,1309,1404,956,1084,48,48,0,30123124.895
RYAN.BAYDA,20082009,CAR,822.1833333333334,7,4,5,9,16,11,8,19,11,78,144,96,23,13,17,667,892,592,614,20,18,0.42105263157894735,30123084.075000003
RYAN.CALLAHAN,20082009,NYR,1520.3,24,10,7,17,41,34,8,14,6,256,426,290,82,36,20,1525,1388,1180,1036,40,30,0.5714285714285714,30123130.805
RYAN.CARTER,20082009,ANA,559.0333333333333,5,6,3,9,14,11,163,338,175,58,106,88,13,13,15,468,459,415,403,17,15,0.4822485207100592,30123068.125
RYAN.CRAIG,20082009,T.B,554.5833333333333,2,1,3,4,6,3,110,222,112,64,85,60,11,17,17,354,536,317,391,8,14,0.4954954954954955,30123066.045
RYAN.GETZLAF,20082009,ANA,1944.1166666666668,29,45,34,79,108,74,684,1381,697,252,442,161,85,36,61,2289,1383,1404,1139,72,55,0.4952932657494569,30123188.32
RYAN.HOLLWEG,20082009,TOR,157.8,0,0,2,2,2,0,1,3,2,12,26,37,4,6,9,137,148,136,145,3,7,0.3333333333333333,30123029.65
RYAN.JOHNSON,20082009,VAN,791.1333333333333,3,4,3,7,10,7,331,664,333,24,50,38,13,15,6,339,967,308,513,13,14,0.49849397590361444,30123091.265
RYAN.JONES,20082009,NSH,526.0333333333333,7,5,4,9,16,12,1,10,9,63,113,63,26,24,12,483,446,380,417,12,9,0.1,30123064.93
RYAN.KESLER,20082009,VAN,1782.3666666666668,28,23,11,34,62,51,566,1052,486,206,339,94,55,40,29,1520,1571,995,946,48,43,0.5380228136882129,30123156.965
RYAN.MALONE,20082009,T.B,1242.2333333333333,26,11,8,19,45,37,14,47,33,123,204,173,31,30,40,1158,1032,722,668,43,30,0.2978723404255319,30123105.31
RYAN.O'BYRNE,20082009,MTL,584.7666666666667,0,1,4,5,5,1,0,0,0,14,43,79,17,5,19,456,620,438,517,15,24,0,30123068.799999997
RYAN.PARENT,20082009,PHI,677.6333333333334,0,1,3,4,4,1,0,0,0,12,42,42,20,7,8,531,785,492,605,24,28,0,30123075.695
RYAN.POTULNY,20082009,EDM,83.91666666666667,0,1,2,3,3,1,1,10,9,9,18,5,7,0,0,73,74,72,71,4,2,0.1,30123020.490000002
RYAN.SHANNON,20082009,OTT,527.5166666666667,8,6,6,12,20,14,2,6,4,61,102,21,23,4,1,460,363,303,325,15,15,0.3333333333333333,30123054.17
RYAN.SMYTH,20082009,COL,1560.35,26,16,17,33,59,42,89,174,85,256,379,46,42,35,26,1632,1287,1015,1070,42,54,0.5114942528735632,30123159.335
RYAN.STONE,20082009,PIT,20.666666666666668,0,0,0,0,0,0,0,0,0,5,5,10,0,0,1,16,18,15,18,1,0,0,30123015.700000003
RYAN.SUTER,20082009,NSH,1989.4666666666667,7,13,19,32,39,20,0,0,0,143,NA,87,NA,20,35,NA,NA,NA,NA,50,54,0,NA
RYAN.VESCE,20082009,S.J,97.46666666666667,0,0,0,0,0,0,30,64,34,11,17,7,4,0,2,67,93,63,89,1,3,0.46875,30123025.200000003
RYAN.WHITNEY,20082009,ANA,737.9833333333333,1,3,11,14,15,4,0,0,0,38,91,29,30,5,9,639,665,467,510,20,19,0,30123065.625
RYAN.WHITNEY,20082009,PIT,687.9166666666666,2,8,3,11,13,10,0,0,0,42,93,21,30,3,8,632,630,331,474,16,22,0,30123070.505000003
RYANE.CLOWE,20082009,S.J,1372.5500000000002,23,19,11,30,53,42,56,131,75,172,277,151,56,36,23,1620,990,1068,826,40,32,0.42748091603053434,30123112.575
SAKU.KOIVU,20082009,MTL,1179.5666666666666,16,27,9,36,52,43,641,1187,546,129,229,49,53,23,18,1307,1053,751,783,37,36,0.540016849199663,30123136.895000003
SAM.GAGNER,20082009,EDM,1273.6666666666665,16,15,10,25,41,31,NA,690,NA,156,249,28,57,16,23,1225,1021,858,878,41,37,NA,NA
SAMI.LEPISTO,20082009,WSH,137.21666666666664,0,2,2,4,4,2,0,0,0,7,23,9,11,3,3,153,96,86,73,3,2,0,30123020.130000003
SAMI.SALO,20082009,VAN,1319.3333333333335,8,8,15,23,31,16,0,0,0,116,269,48,80,5,12,1184,1113,725,721,33,28,0,30123087.225
SAMUEL.PAHLSSON,20082009,ANA,962.4833333333333,5,5,5,10,15,10,568,1062,494,74,119,91,15,10,16,584,1047,390,530,16,27,0.5348399246704332,30123100.695
SAMUEL.PAHLSSON,20082009,CHI,509.2,4,3,1,4,8,7,201,378,177,25,NA,53,NA,1,3,NA,NA,NA,NA,10,14,0.5317460317460317,NA
SCOTT.GOMEZ,20082009,NYR,1760.4333333333334,18,34,11,45,63,52,745,1438,693,286,462,68,87,34,30,2108,1383,1348,1075,43,44,0.5180806675938804,30123166.314999998
SCOTT.HANNAN,20082009,COL,1811.2666666666669,1,4,4,8,9,5,0,1,1,69,142,56,43,16,12,1219,2011,1074,1419,43,63,0,30123168.41
SCOTT.HARTNELL,20082009,PHI,1571.7666666666667,31,17,14,31,62,48,20,38,18,225,357,113,60,47,63,1614,1560,1112,1235,62,52,0.5263157894736842,30123178.82
SCOTT.LEHMAN,20082009,ATL,3.05,0,0,0,0,0,0,0,0,0,0,0,0,0,0,0,1,1,1,1,0,0,0,15061506.85
SCOTT.NICHOL,20082009,NSH,476.21666666666664,4,4,2,6,10,8,195,357,162,42,61,79,11,13,16,310,475,267,313,9,11,0.5462184873949579,30123060.03
SCOTT.NIEDERMAYER,20082009,ANA,2548.366666666667,17,24,27,51,68,41,0,1,1,210,383,83,98,17,35,2265,2225,1298,1304,58,58,0,30123163.895000003
SCOTT.WALKER,20082009,CAR,738.0166666666667,6,10,6,16,22,16,4,7,3,96,160,121,29,23,20,738,599,676,565,24,28,0.5714285714285714,30123074.79
SCOTTIE.UPSHALL,20082009,ARI,336.55,8,3,1,4,12,11,4,8,4,64,91,17,12,7,11,300,278,195,238,8,6,0.5,30123048.854999997
SCOTTIE.UPSHALL,20082009,PHI,725.3833333333333,7,10,4,14,21,17,1,10,9,126,214,76,40,24,26,728,639,627,566,26,18,0.1,30123078.729999997
SEAN.AVERY,20082009,DAL,344.54999999999995,3,4,3,7,10,7,5,12,7,49,85,44,19,24,23,339,252,248,234,14,12,0.4166666666666667,30123042.215
SEAN.AVERY,20082009,NYR,407.06666666666666,5,4,4,8,13,9,6,9,3,64,128,65,38,19,21,489,337,383,316,16,14,0.6666666666666666,30123046.28
SEAN.BENTIVOGLIO,20082009,NYI,11.516666666666667,0,0,0,0,0,0,0,1,1,2,2,1,0,0,1,8,15,8,14,0,0,0,15061508.75
SEAN.BERGENHEIM,20082009,NYI,840.6333333333333,15,5,4,9,24,20,9,22,13,152,244,82,54,24,25,787,930,684,704,22,27,0.4090909090909091,30123099.2
SEAN.COLLINS,20082009,WSH,218.11666666666667,1,0,1,1,2,1,0,0,0,14,35,11,14,0,6,221,168,211,153,5,6,0,30123025.424999997
SEAN.O'DONNELL,20082009,L.A,1679.9499999999998,0,3,8,11,11,3,0,1,1,32,95,77,36,8,19,1181,1675,1059,1109,38,38,0,30123122.63
SERGEI.FEDOROV,20082009,WSH,1091.9166666666665,12,12,17,29,41,24,479,862,383,142,248,42,58,7,31,1275,820,892,639,38,29,0.5556844547563805,30123092.805
SERGEI.GONCHAR,20082009,PIT,1115.3833333333332,9,13,11,24,33,22,0,0,0,112,223,43,64,8,18,1208,944,652,631,38,26,0,30123082.905
SERGEI.KOSTITSYN,20082009,MTL,804.0166666666667,8,9,6,15,23,17,3,10,7,74,143,53,44,12,20,761,739,492,598,21,22,0.3,30123086.990000002
SERGEI.SAMSONOV,20082009,CAR,1656.9833333333333,21,20,14,34,55,41,4,7,3,183,355,46,90,18,18,1917,1387,1320,1247,50,51,0.5714285714285714,30123152.439999998
SERGEI.ZUBOV,20082009,DAL,242.91666666666666,0,3,1,4,4,3,0,0,0,15,39,6,10,2,0,222,177,140,141,8,11,0,30123027.445
SHANE.DOAN,20082009,ARI,1642.55,30,31,11,42,72,61,159,360,201,225,389,188,77,22,24,1616,1549,993,1164,49,46,0.44166666666666665,30123181.955
SHANE.HNIDY,20082009,BOS,1100.3,4,5,4,9,13,9,0,0,0,55,131,51,50,19,14,896,987,794,835,38,34,0,30123096.740000002
SHANE.O'BRIEN,20082009,T.B,14.066666666666666,0,0,0,0,0,0,0,0,0,0,1,1,1,0,0,3,23,3,13,0,1,0,15061508.4
SHANE.O'BRIEN,20082009,VAN,1244.4666666666667,1,6,5,11,12,7,0,0,0,48,118,90,40,27,65,928,1070,874,914,48,41,0,30123110.494999997
SHAONE.MORRISONN,20082009,WSH,1548.0500000000002,3,4,5,9,12,7,0,0,0,56,126,144,41,19,36,1393,1537,1261,1029,50,49,0,30123104.215
SHAWN.HORCOFF,20082009,EDM,1708.8,17,17,19,36,53,34,NA,1753,NA,178,305,30,59,29,18,1582,1621,978,970,45,38,NA,NA
SHAWN.MATTHIAS,20082009,FLA,146.63333333333333,0,2,0,2,2,2,46,91,45,11,24,8,7,1,2,111,157,109,149,4,7,0.5054945054945055,30123032.5
SHAWN.THORNTON,20082009,BOS,874.5333333333333,7,3,2,5,12,10,2,6,4,147,230,136,37,33,31,711,660,690,643,25,25,0.3333333333333333,30123085.36
SHEA.WEBER,20082009,NSH,1941.6,23,16,13,29,52,39,0,0,0,251,NA,192,NA,16,33,NA,NA,NA,NA,55,46,0,NA
SHEAN.DONOVAN,20082009,OTT,508.9166666666667,5,4,1,5,10,9,4,9,5,58,91,20,13,15,12,420,440,414,427,14,15,0.4444444444444444,30123063.634999998
SHELDON.BROOKBANK,20082009,ANA,546.9666666666667,1,0,2,2,3,1,0,0,0,27,73,48,33,13,19,450,545,440,505,19,17,0,30123064.63
SHELDON.BROOKBANK,20082009,N.J,132.65,0,0,0,0,0,0,0,0,0,6,14,11,3,4,8,107,92,106,85,4,3,0,30123021.44
SHELDON.SOURAY,20082009,EDM,2012.4666666666667,23,15,14,29,52,38,0,0,0,268,571,82,170,20,43,1907,1817,1133,1163,46,44,0,30123144.35
SIDNEY.CROSBY,20082009,PIT,2168.55,48,60,25,85,133,108,1098,2122,1024,314,501,100,80,55,36,2422,1793,1377,1406,80,58,0.5174363807728558,30123261.895
SIMON.GAGNE,20082009,PHI,1625.8333333333335,37,24,17,41,78,61,3,10,7,240,422,32,93,20,21,1628,1509,965,1054,44,42,0.3,30123158.845
SPENCER.MACHACEK,20082009,ATL,16.383333333333333,0,0,0,0,0,0,0,0,0,1,1,7,0,1,0,7,17,7,17,0,0,0,30123015.759999998
STAFFAN.KRONWALL,20082009,WSH,39.666666666666664,0,0,0,0,0,0,0,0,0,4,7,11,1,0,0,47,31,45,29,1,2,0,30123015.5
STEPHANE.ROBIDAS,20082009,DAL,1765.9666666666667,3,12,10,22,25,15,1,1,0,157,341,220,101,13,38,1630,1467,1004,1019,57,43,1,30123115.57
STEPHANE.VEILLEUX,20082009,MIN,1279.4833333333333,13,4,5,9,22,17,5,21,16,143,260,97,60,23,16,897,1305,799,945,24,43,0.23809523809523808,30123124.905
STEPHANE.YELLE,20082009,BOS,1146.05,7,5,3,8,15,12,466,891,425,85,129,127,16,13,16,714,1097,643,742,20,21,0.5230078563411896,30123118.494999997
STEPHEN.WEISS,20082009,FLA,1388.2333333333333,14,22,24,46,60,36,650,1276,626,154,257,30,46,14,10,1451,1112,898,878,50,32,0.5094043887147336,30123143.740000002
STEVE.BEGIN,20082009,DAL,208.63333333333333,1,0,1,1,2,1,23,55,32,25,39,66,8,9,6,143,233,136,143,5,6,0.41818181818181815,30123030.585
STEVE.BEGIN,20082009,MTL,455.93333333333334,6,3,1,4,10,9,42,78,36,65,108,119,22,8,9,349,492,323,375,11,14,0.5384615384615384,30123060.634999998
STEVE.BERNIER,20082009,VAN,1256.6333333333332,17,12,7,19,36,29,5,22,17,148,222,165,32,21,15,1147,968,749,873,39,33,0.22727272727272727,30123126.035
STEVE.DOWNIE,20082009,PHI,35.68333333333334,0,0,0,0,0,0,2,13,11,1,4,3,2,2,4,25,25,24,24,0,4,0.15384615384615385,30123016.799999997
STEVE.DOWNIE,20082009,T.B,208.68333333333334,3,2,1,3,6,5,3,7,4,25,36,38,5,18,17,173,186,163,183,9,6,0.42857142857142855,30123038.125
STEVE.EMINGER,20082009,FLA,142.36666666666665,1,0,0,0,1,1,0,0,0,13,20,11,3,0,3,145,130,125,124,4,3,0,30123026.6
STEVE.EMINGER,20082009,PHI,214.53333333333333,0,0,1,1,1,0,0,0,0,9,16,11,3,3,4,164,170,125,125,7,9,0,30123025.655
STEVE.EMINGER,20082009,T.B,1177,4,7,11,18,22,11,0,1,1,63,138,55,46,6,17,955,1132,714,759,39,36,0,30123092.185000002
STEVE.MACINTYRE,20082009,EDM,86.11666666666667,2,0,0,0,2,2,0,0,0,6,8,22,0,11,11,57,93,55,91,2,4,0,30123027.56
STEVE.MONTADOR,20082009,ANA,1053.5333333333333,4,7,8,15,19,11,0,0,0,99,192,84,46,24,41,987,921,809,724,50,32,0,30123085.84
STEVE.MONTADOR,20082009,BOS,421.9666666666667,1,1,2,3,4,2,0,1,1,31,58,24,15,8,11,400,325,335,275,18,10,0,30123037.78
STEVE.OTT,20082009,DAL,1124.1,19,15,12,27,46,34,80,172,92,131,231,220,36,51,45,1104,866,750,659,42,37,0.46511627906976744,30123103.21
STEVE.REGIER,20082009,STL,87.91666666666666,3,0,1,1,4,3,3,7,4,11,16,8,5,1,2,75,67,53,59,2,2,0.42857142857142855,30123021.854999997
STEVE.STAIOS,20082009,EDM,1584.0166666666669,2,9,3,12,14,11,0,0,0,78,169,98,56,28,36,1087,1787,957,1194,39,49,0,30123146.655
STEVE.SULLIVAN,20082009,NSH,758.0666666666666,11,13,8,21,32,24,0,4,4,83,NA,15,NA,9,15,NA,NA,NA,NA,27,19,0,NA
STEVE.WAGNER,20082009,STL,343.81666666666666,2,1,1,2,4,3,0,0,0,16,49,24,14,1,9,290,298,234,260,9,13,0,30123041.535
STEVEN.GOERTZEN,20082009,ARI,155.2,2,0,2,2,4,2,1,2,1,18,25,33,6,7,6,112,142,101,115,5,7,0.5,30123027.509999998
STEVEN.REINPRECHT,20082009,ARI,1148.0166666666667,14,13,13,26,40,27,406,877,471,92,177,24,41,16,11,1069,1117,691,853,44,39,0.4629418472063854,30123137.975
STEVEN.STAMKOS,20082009,T.B,1179.85,23,10,13,23,46,33,253,556,303,180,328,75,83,22,20,1165,955,735,822,32,37,0.4550359712230216,30123130.215
T.J..GALIARDI,20082009,COL,179.83333333333331,3,0,1,1,4,3,56,133,77,13,42,11,12,3,3,158,124,121,114,4,7,0.42105263157894735,30123028.745
T.J..HENSICK,20082009,COL,787.2166666666667,4,9,8,17,21,13,241,509,268,116,192,14,40,8,6,761,722,531,650,20,25,0.47347740667976423,30123101.57
T.J..OSHIE,20082009,STL,1021.2333333333333,14,15,10,25,39,29,50,113,63,107,193,70,38,21,15,883,820,535,527,30,15,0.4424778761061947,30123084.86
TANNER.GLASS,20082009,FLA,20.266666666666666,0,0,0,0,0,0,1,1,0,1,1,5,0,1,2,6,28,6,28,0,0,1,15061511
TAYLOR.CHORNEY,20082009,EDM,31.416666666666664,0,0,0,0,0,0,0,0,0,0,1,0,0,0,0,18,53,18,53,1,5,0,30123020.4
TAYLOR.PYATT,20082009,VAN,1060.5166666666667,10,6,3,9,19,16,16,33,17,105,161,91,22,16,21,751,1073,614,758,31,33,0.48484848484848486,30123108.325000003
TEDDY.PURCELL,20082009,L.A,540.6166666666666,4,6,6,12,16,10,5,29,24,68,121,13,33,5,2,583,382,375,354,13,16,0.1724137931034483,30123052.4
TEEMU.SELANNE,20082009,ANA,1268.4,31,13,16,29,60,44,122,254,132,217,358,23,58,23,16,1467,924,800,819,34,34,0.48031496062992124,30123131.46
TEPPO.NUMMINEN,20082009,BUF,996.9,2,4,10,14,16,6,0,0,0,34,78,12,38,7,11,872,891,665,698,29,32,0,30123082.67
THEO.PECKHAM,20082009,EDM,174.4,0,0,0,0,0,0,0,0,0,8,18,22,7,7,13,126,193,125,182,7,8,0,30123034.869999997
THOMAS.POCK,20082009,NYI,749.45,1,1,1,2,3,2,0,0,0,51,124,53,49,8,12,630,773,571,699,11,32,0,30123086.555
THOMAS.VANEK,20082009,BUF,1255.4166666666665,40,16,8,24,64,56,1,6,5,211,347,34,49,16,22,1343,983,764,804,46,43,0.16666666666666666,30123133.299999997
TIM.BRENT,20082009,CHI,16.683333333333334,0,0,0,0,0,0,5,10,5,0,1,4,1,0,1,14,17,14,17,0,0,0.5,15061508.8
TIM.CONBOY,20082009,CAR,163.10000000000002,0,0,1,1,1,0,0,0,0,13,21,26,6,17,13,123,147,108,133,4,7,0,30123029.395
TIM.CONNOLLY,20082009,BUF,917.55,18,18,11,29,47,36,229,544,315,126,214,17,41,9,11,942,845,526,557,36,23,0.4209558823529412,30123104.025
TIM.GLEASON,20082009,CAR,1794.3166666666666,1,7,8,15,16,8,0,0,0,72,178,228,62,33,34,1506,1901,1343,1392,54,60,0,30123151.93
TIM.JACKMAN,20082009,NYI,810.5333333333333,5,5,2,7,12,10,7,22,15,97,149,151,33,34,41,580,972,553,799,18,35,0.3181818181818182,30123116.47
TIM.KENNEDY,20082009,BUF,11.066666666666666,0,0,0,0,0,0,0,1,1,1,2,1,1,1,0,6,6,6,6,0,0,0,15061507.31
TIM.SESTITO,20082009,EDM,5.883333333333334,0,0,0,0,0,0,1,2,1,0,0,3,0,0,0,2,10,2,4,0,0,0.5,15061507.29
TIM.STAPLETON,20082009,TOR,60.36666666666667,1,0,0,0,1,1,1,5,4,9,12,2,1,0,0,67,57,45,53,1,4,0.2,30123020.240000002
TIM.WALLACE,20082009,PIT,129.88333333333333,0,1,1,2,2,1,2,3,1,17,24,37,3,4,2,86,85,85,84,4,2,0.6666666666666666,30123022.645
TOBIAS.ENSTROM,20082009,ATL,1929.3,5,12,14,26,31,17,1,2,1,86,169,29,50,26,27,1528,1812,1011,1201,62,56,0.5,30123146.1
TOBY.PETERSEN,20082009,DAL,650.6833333333334,4,7,0,7,11,11,128,283,155,80,116,52,15,12,7,449,603,409,446,21,18,0.45229681978798586,30123072.84
TODD.BERTUZZI,20082009,CGY,1314.2333333333333,16,20,9,29,45,36,26,55,29,135,219,73,37,25,38,1372,945,908,807,40,39,0.4727272727272727,30123114.365000002
TODD.FEDORUK,20082009,ARI,762.6,6,1,6,7,13,7,4,15,11,56,97,125,23,24,28,598,737,555,702,20,32,0.26666666666666666,30123097.55
TODD.MARCHANT,20082009,ANA,1305.2333333333333,6,8,6,14,20,14,431,838,407,119,174,103,17,19,20,744,1449,608,819,20,27,0.5143198090692124,30123134.630000003
TODD.WHITE,20082009,ATL,1480.8166666666666,22,31,20,51,73,53,672,1327,655,150,206,39,28,15,11,1416,1143,766,887,48,55,0.506405425772419,30123166.130000003
TOM.CAVANAGH,20082009,S.J,131.36666666666667,1,1,0,1,2,2,26,57,31,9,21,4,5,2,1,99,110,95,109,2,4,0.45614035087719296,30123027.21
TOM.GILBERT,20082009,EDM,1801.9166666666667,5,14,24,38,43,19,0,0,0,106,211,47,60,9,12,1572,1725,1137,1208,59,54,0,30123140.189999998
TOM.KOSTOPOULOS,20082009,MTL,1159.1333333333332,8,8,7,15,23,16,5,18,13,125,209,174,42,34,37,965,1221,880,930,35,37,0.2777777777777778,30123120.715
TOM.POTI,20082009,WSH,1402.8000000000002,5,6,4,10,15,11,0,0,0,61,129,36,48,11,16,1200,1435,907,853,41,39,0,30123095.41
TOM.PREISSING,20082009,L.A,368.4666666666667,3,0,4,4,7,3,0,0,0,40,80,15,21,0,3,418,269,261,212,7,13,0,30123032.9
TOM.WANDELL,20082009,DAL,155.35000000000002,1,1,1,2,3,2,57,112,55,23,33,6,6,6,2,146,129,124,119,3,4,0.5089285714285714,30123028.815
TOMAS.FLEISCHMANN,20082009,WSH,1301.3,22,14,5,19,41,36,10,40,30,153,252,28,32,16,11,1325,1024,911,757,40,37,0.25,30123105.035
TOMAS.HOLMSTROM,20082009,DET,1113.25,16,15,11,26,42,31,6,18,12,98,172,87,34,32,29,1389,655,885,603,44,26,0.3333333333333333,30123078.385
TOMAS.KABERLE,20082009,TOR,1313.6833333333334,4,10,16,26,30,14,0,0,0,93,210,29,65,5,4,1495,1058,924,844,45,48,0,30123092.200000003
TOMAS.KOPECKY,20082009,DET,892.9,6,12,2,14,20,18,37,83,46,122,189,122,32,21,25,786,710,713,637,27,35,0.4457831325301205,30123087.49
TOMAS.MOJZIS,20082009,MIN,28.849999999999998,0,0,1,1,1,0,0,0,0,2,5,4,2,1,1,26,17,14,16,0,1,0,30123015.235
TOMAS.PLEKANEC,20082009,MTL,1420.95,20,11,8,19,39,31,714,1393,679,203,345,57,71,23,25,1449,1284,888,921,36,43,0.5125628140703518,30123152.79
TOMAS.PLIHAL,20082009,S.J,648.55,5,4,4,8,13,9,131,247,116,79,131,62,22,5,11,530,524,482,419,12,18,0.5303643724696356,30123063.29
TONI.LYDMAN,20082009,BUF,1742.3833333333332,3,6,13,19,22,9,0,0,0,99,201,165,68,9,36,1352,1803,1071,1196,50,50,0,30123138.465
TORREY.MITCHELL,20082009,S.J,38.53333333333333,0,0,0,0,0,0,16,31,15,9,11,8,2,1,1,50,36,49,36,0,1,0.5161290322580645,30123017.35
TRAVIS.MOEN,20082009,ANA,936.5666666666667,4,3,4,7,11,7,2,7,5,77,124,120,16,21,24,531,932,477,654,14,30,0.2857142857142857,30123095.89
TRAVIS.MOEN,20082009,S.J,369,3,2,0,2,5,5,2,14,12,28,55,68,17,9,5,245,330,231,256,5,10,0.14285714285714285,30123043.07
TRAVIS.ZAJAC,20082009,N.J,1654.1166666666668,21,24,21,45,66,45,732,1387,655,196,314,66,66,21,16,1846,1301,1153,949,58,34,0.5277577505407354,30123146.915
TRENT.HUNTER,20082009,NYI,901.0333333333333,14,10,7,17,31,24,5,20,15,154,263,135,50,7,15,1056,783,625,616,19,24,0.25,30123090.845
TRENT.WHITFIELD,20082009,STL,33.13333333333333,0,1,0,1,1,1,18,25,7,4,4,2,0,0,0,23,27,17,23,2,0,0.72,15061509.97
TREVOR.DALEY,20082009,DAL,1650.3,7,11,7,18,25,18,0,1,1,104,195,30,51,18,31,1347,1547,1083,1076,57,51,0,30123126.105
TREVOR.LEWIS,20082009,L.A,69.58333333333333,1,0,2,2,3,1,1,4,3,10,16,4,1,1,0,73,52,71,47,3,2,0.25,30123017.9
TREVOR.SMITH,20082009,NYI,82.6,1,0,0,0,1,1,6,9,3,7,12,8,2,1,0,65,104,62,103,2,5,0.6666666666666666,30123026.4
TROY.BODIE,20082009,ANA,32.583333333333336,0,0,0,0,0,0,1,2,1,5,7,6,2,0,0,34,21,34,21,0,0,0.5,30123014.939999998
TROY.BROUWER,20082009,CHI,1241.6666666666667,10,12,4,16,26,22,14,28,14,150,248,175,45,22,25,1237,876,879,702,30,30,0.5,30123089.53
TUOMO.RUUTU,20082009,CAR,1672.2333333333336,27,15,15,30,57,42,23,46,23,206,398,282,97,44,41,1938,1376,1317,1217,54,54,0.5,30123153.635
TY.WISHART,20082009,T.B,50.583333333333336,0,0,1,1,1,0,0,0,0,2,7,3,1,0,0,39,50,38,45,1,1,0,30123018.225
TYLER.ARNASON,20082009,COL,944.3833333333333,5,13,4,17,22,18,331,718,387,108,192,6,43,15,9,835,838,720,796,27,42,0.4610027855153203,30123120.29
TYLER.KENNEDY,20082009,PIT,1235.9,20,13,11,24,44,33,55,109,54,233,387,78,88,25,13,1228,1032,1064,955,50,34,0.5045871559633027,30123120.825000003
TYLER.SLOAN,20082009,WSH,469.6333333333333,1,2,3,5,6,3,0,0,0,9,34,35,20,6,7,407,480,380,351,17,13,0,30123045.185000002
TYSON.STRACHAN,20082009,STL,403.05,0,0,2,2,2,0,0,0,0,21,53,23,18,6,11,299,361,276,274,15,9,0,30123038.759999998
VACLAV.PROSPAL,20082009,T.B,1449.9666666666667,19,15,11,26,45,34,106,201,95,193,309,126,62,14,21,1488,1166,976,983,39,52,0.527363184079602,30123136.005000003
VALTTERI.FILPPULA,20082009,DET,1675.7833333333333,14,19,19,38,52,33,537,1033,496,163,273,65,49,34,24,1604,1372,1359,1024,61,41,0.5198451113262342,30123135.845
VERNON.FIDDLER,20082009,NSH,1089.3166666666666,11,4,1,5,16,15,330,611,281,113,204,83,42,22,12,775,1069,655,748,22,36,0.5400981996726678,30123111.744999997
VIKTOR.KOZLOV,20082009,WSH,1272.65,17,16,14,30,47,33,10,36,26,176,291,53,66,18,11,1556,1018,1164,935,51,46,0.2777777777777778,30123111.58
VIKTOR.TIKHONOV,20082009,ARI,727.9,7,8,0,8,15,15,23,60,37,71,125,39,27,5,8,544,740,482,545,16,21,0.38333333333333336,30123080.42
VILLE.KOISTINEN,20082009,NSH,558.8833333333333,3,5,3,8,11,8,0,1,1,42,90,45,32,4,6,518,459,346,414,19,16,0,30123058.814999998
VILLE.LEINO,20082009,DET,226.29999999999998,5,4,2,6,11,9,9,17,8,24,49,4,17,3,2,225,142,184,137,16,7,0.5294117647058824,30123027.59
VILLE.PELTONEN,20082009,FLA,1204.9,12,11,8,19,31,23,18,64,46,120,210,60,47,21,14,862,1344,749,962,41,39,0.28125,30123132.63
VINCENT.LECAVALIER,20082009,T.B,1559.4666666666667,29,29,9,38,67,58,NA,1393,NA,290,479,109,92,25,23,1651,1292,945,950,49,48,NA,NA
VLADIMIR.MIHALIK,20082009,T.B,147.35,0,0,3,3,3,0,0,0,0,7,17,7,6,0,3,107,175,101,132,5,7,0,30123027.625
VLADIMIR.SOBOTKA,20082009,BOS,263.7,1,3,1,4,5,4,30,51,21,19,40,48,13,5,5,213,201,206,183,8,17,0.5882352941176471,30123032.425
VYACHESLAV.KOZLOV,20082009,ATL,1411.4166666666665,26,26,24,50,76,52,3,8,5,165,277,37,52,17,22,1403,1045,779,860,40,44,0.375,30123135.990000002
WADE.BELAK,20082009,FLA,66.15,0,0,0,0,0,0,0,0,0,4,8,20,1,2,7,49,57,48,57,1,2,0,30123020.62
WADE.BELAK,20082009,NSH,212.18333333333334,0,2,0,2,2,2,0,0,0,15,23,37,3,10,12,152,173,149,172,5,6,0,30123034.4
WADE.BROOKBANK,20082009,CAR,67.33333333333333,1,0,0,0,1,1,0,0,0,8,13,15,1,8,11,57,70,52,67,3,3,0,30123023.18
WADE.REDDEN,20082009,NYR,1972.0500000000002,3,7,15,22,25,10,0,0,0,173,339,104,107,8,24,2014,1656,1308,1181,43,42,0,30123122.155
WARREN.PETERS,20082009,CGY,141.45,1,0,0,0,1,1,56,95,39,15,28,32,8,2,4,112,84,109,69,4,4,0.5894736842105263,30123020.06
WAYNE.PRIMEAU,20082009,CGY,249.1,0,3,1,4,4,3,115,217,102,22,36,15,4,4,6,181,231,163,96,5,7,0.5299539170506913,30123026.115000002
WAYNE.SIMMONDS,20082009,L.A,1134.6833333333334,9,10,4,14,23,19,9,25,16,127,228,132,54,24,24,884,1010,809,831,24,31,0.36,30123109
WES.O'NEILL,20082009,COL,32.583333333333336,0,0,0,0,0,0,0,0,0,1,1,5,0,0,2,29,33,29,29,0,2,0,30123016.75
WILLIAM.THOMAS,20082009,PIT,152.31666666666666,2,1,0,1,3,3,52,101,49,17,28,14,6,3,1,81,157,69,103,2,4,0.5148514851485149,30123029.21
WILLIE.MITCHELL,20082009,VAN,2096.483333333333,3,10,10,20,23,13,0,1,1,89,220,92,92,29,38,1561,2066,1368,1349,67,48,0,30123142.439999998
WOJTEK.WOLSKI,20082009,COL,1434.45,14,16,12,28,42,30,248,515,267,169,281,55,71,19,13,1273,1353,823,1013,37,45,0.4815533980582524,30123149.060000002
YAN.STASTNY,20082009,STL,433.35,3,3,1,4,7,6,46,101,55,30,54,25,12,10,7,226,524,205,345,10,22,0.45544554455445546,30123060.465
YANNICK.WEBER,20082009,MTL,86.08333333333333,1,0,1,1,2,1,0,0,0,9,24,6,10,0,1,87,49,47,42,1,2,0,30123017.174999997
ZACH.BOGOSIAN,20082009,ATL,851.0833333333334,9,4,5,9,18,13,0,0,0,90,184,67,56,14,19,745,842,607,674,42,35,0,30123085.915
ZACH.BOYCHUK,20082009,CAR,24.1,0,0,0,0,0,0,0,1,1,0,2,3,0,0,0,16,21,16,19,1,1,0,15061508.7
ZACH.PARISE,20082009,N.J,1671.3166666666666,48,28,24,52,100,76,55,124,69,393,588,81,76,37,13,2042,1168,1289,996,64,35,0.4435483870967742,30123153.12
ZACHERY.STORTINI,20082009,EDM,379.04999999999995,6,4,1,5,11,10,7,11,4,23,39,95,7,31,37,238,355,225,350,16,19,0.6363636363636364,30123064.915
ZACK.SMITH,20082009,OTT,7.016666666666667,0,0,0,0,0,0,0,1,1,0,1,1,1,0,0,4,7,4,7,0,0,0,15061507.5
ZBYNEK.MICHALEK,20082009,ARI,1842.8666666666668,6,9,10,19,25,15,0,0,0,102,187,67,53,17,14,1324,2017,1123,1467,47,69,0,30123179.67
ZDENO.CHARA,20082009,BOS,2337.45,20,14,19,33,53,34,1,4,3,242,480,203,134,31,42,2184,2005,1426,1373,72,56,0.25,30123159.225
ZENON.KONOPKA,20082009,T.B,49.06666666666666,0,1,0,1,1,1,17,25,8,6,7,6,1,9,7,34,52,33,51,1,2,0.68,30123021.42
AARON.GAGNON,20092010,DAL,17.633333333333333,0,0,0,0,0,0,8,11,3,2,4,4,0,0,0,20,20,20,16,0,0,0.7272727272727273,15069009.07
AARON.JOHNSON,20092010,CGY,267.93333333333334,1,2,0,2,3,3,0,0,0,13,33,26,11,3,8,258,235,250,215,11,11,0,30138035.13
AARON.JOHNSON,20092010,EDM,373.7,3,1,2,3,6,4,0,0,0,23,52,44,15,5,8,293,420,215,333,7,14,0,30138056.1
AARON.ROME,20092010,VAN,753.3,0,1,3,4,4,1,0,0,0,49,121,63,48,4,9,662,688,595,592,23,31,0,30138068.015
AARON.VOROS,20092010,NYR,251.83333333333334,3,4,0,4,7,7,3,6,3,22,37,56,9,17,25,190,251,185,249,7,10,0.5,30138050.14
AARON.WARD,20092010,ANA,245.46666666666664,0,0,2,2,2,0,0,0,0,9,25,39,11,0,4,201,274,187,209,9,8,0,30138035.200000003
AARON.WARD,20092010,CAR,1062.55,1,1,9,10,11,2,0,0,0,30,87,133,41,10,25,848,1107,771,849,30,48,0,30138100.424999997
ADAM.BURISH,20092010,CHI,197.71666666666667,1,2,1,3,4,3,11,27,16,24,37,18,6,9,5,176,191,175,189,8,7,0.4074074074074074,30138037.104999997
ADAM.FOOTE,20092010,COL,1425.3833333333332,0,5,5,10,10,5,0,0,0,32,92,123,36,16,31,989,1662,910,1231,49,50,0,30138150.935000002
ADAM.MAIR,20092010,BUF,709.3333333333333,7,4,5,9,16,11,107,213,106,73,112,104,19,16,27,593,612,572,569,22,23,0.5023474178403756,30138085.165
ADAM.MCQUAID,20092010,BOS,295.6666666666667,1,0,0,0,1,1,0,0,0,13,34,38,10,5,9,228,272,223,255,5,15,0,30138042.6
ADAM.PARDY,20092010,CGY,903.5333333333333,2,4,3,7,9,6,0,0,0,40,99,54,38,15,22,859,777,807,665,25,29,0,30138074.225
ADRIAN.AUCOIN,20092010,ARI,1997.8166666666666,8,6,14,20,28,14,1,1,0,151,332,144,101,13,33,1834,1637,1268,1100,50,44,1,30138116.52
ALEC.MARTINEZ,20092010,L.A,61.63333333333334,0,0,0,0,0,0,0,0,0,6,9,6,1,0,1,59,43,56,40,1,3,0,30138018.35
ALES.HEMSKY,20092010,EDM,394.6,7,10,5,15,22,17,1,1,0,57,97,5,22,8,4,432,290,255,253,16,9,1,30138048.795
ALES.KOTALIK,20092010,CGY,379.65,3,0,2,2,5,3,5,8,3,72,114,34,26,4,9,380,273,299,247,12,10,0.625,30138038.740000002
ALES.KOTALIK,20092010,NYR,627.3166666666666,8,3,11,14,22,11,0,2,2,100,198,83,43,4,19,702,447,395,406,11,23,0,30138064.115000002
ALEX.BOLDUC,20092010,VAN,149.5,0,0,0,0,0,0,47,87,40,14,19,20,0,4,4,82,155,78,105,1,4,0.5402298850574713,30138029.57
ALEX.BURROWS,20092010,VAN,1690.7166666666667,38,23,12,35,73,61,16,44,28,235,365,122,61,49,54,1613,1522,1256,1040,70,45,0.36363636363636365,30138150.28
ALEX.EDLER,20092010,VAN,1998.6166666666668,7,23,17,40,47,30,0,2,2,186,420,111,133,11,25,2011,1748,1350,1263,58,50,0,30138140.384999998
ALEX.FROLOV,20092010,L.A,1594.1666666666667,20,21,13,34,54,41,8,13,5,191,321,66,60,21,11,1474,1221,1068,957,44,51,0.6153846153846154,30138127.655
ALEX.GIROUX,20092010,WSH,93.35000000000001,1,0,2,2,3,1,0,0,0,17,27,14,5,4,2,100,98,75,89,6,3,0,30138024.99
ALEX.GOLIGOSKI,20092010,PIT,1724.4833333333333,10,15,20,35,45,25,0,0,0,124,291,55,113,15,12,1941,1413,1288,1117,60,48,0,30138117.1
ALEX.KOVALEV,20092010,OTT,1398.3666666666668,18,20,11,31,49,38,1,3,2,165,329,34,93,28,26,1451,1088,995,961,46,54,0.3333333333333333,30138125.495
ALEX.OVECHKIN,20092010,WSH,1731.1666666666665,55,39,25,64,119,94,11,24,13,402,896,211,313,34,30,2468,1251,1484,1060,89,40,0.4583333333333333,30138126.805
ALEX.PICARD,20092010,CAR,135.61666666666667,0,0,0,0,0,0,0,0,0,7,18,15,7,2,3,107,144,93,116,7,6,0,30138026.47
ALEX.PICARD,20092010,CBJ,64.96666666666667,0,0,0,0,0,0,0,0,0,12,14,18,1,2,2,55,51,54,51,0,3,0,30138020.72
ALEX.PICARD,20092010,OTT,857.1166666666667,4,3,8,11,15,7,0,0,0,63,126,55,35,2,10,775,735,615,583,30,34,0,30138071.67
ALEX.PIETRANGELO,20092010,STL,149.16666666666666,1,0,1,1,2,1,0,0,0,7,25,4,15,1,2,155,128,104,108,2,10,0,30138024.885
ALEX.PLANTE,20092010,EDM,54.4,0,0,1,1,1,0,0,0,0,4,8,7,1,1,1,42,60,42,59,2,1,0,30138021.735
ALEX.SEMIN,20092010,WSH,1531.4,39,28,18,46,85,67,7,17,10,321,633,33,186,37,36,1994,1303,1291,1064,73,39,0.4117647058823529,30138137.5
ALEX.STEEN,20092010,STL,1106.7833333333333,24,12,11,23,47,36,30,73,43,189,336,45,87,21,14,1066,911,679,680,37,28,0.410958904109589,30138102.285
ALEX.SULZER,20092010,NSH,267.6166666666667,0,2,0,2,2,2,0,0,0,15,37,11,15,4,2,245,239,228,214,8,4,0,30138034.439999998
ALEX.TANGUAY,20092010,T.B,1263.0833333333335,10,14,13,27,37,24,11,25,14,91,175,42,40,7,16,1175,1058,895,920,43,45,0.44,30138119.085
ALEXEI.PONIKAROVSKY,20092010,PIT,386.7,3,4,7,11,14,7,0,1,1,57,89,62,13,2,5,449,232,320,209,9,12,0,30138035.545
ALEXEI.PONIKAROVSKY,20092010,TOR,1025.95,19,17,5,22,41,36,12,37,25,147,267,114,47,16,20,1256,817,927,701,46,39,0.32432432432432434,30138094.515
ANDERS.ERIKSSON,20092010,ARI,188.93333333333334,0,0,1,1,1,0,0,0,0,4,15,15,5,2,1,137,173,115,147,6,6,0,30138030.095
ANDERS.ERIKSSON,20092010,NYR,115.96666666666667,0,1,1,2,2,1,0,0,0,2,9,4,5,0,0,110,104,86,87,4,1,0,30138023.125
ANDRE.DEVEAUX,20092010,TOR,6.15,0,0,0,0,0,0,1,1,0,1,1,1,0,0,0,5,8,4,4,0,0,1,15069007.94
ANDREAS.LILJA,20092010,DET,403.84999999999997,1,1,0,1,2,2,0,0,0,25,48,59,12,2,9,288,371,271,269,10,12,0,30138042.369999997
ANDREAS.NODL,20092010,PHI,173.83333333333334,0,0,1,1,1,0,0,3,3,4,17,32,10,2,0,123,144,118,123,3,6,0,30138026.045
ANDREAS.THURESSON,20092010,NSH,219.7,1,0,2,2,3,1,3,10,7,30,49,42,7,3,2,207,176,192,170,3,7,0.3,30138032.4
ANDREI.KOSTITSYN,20092010,MTL,1214.0666666666666,18,14,9,23,41,32,1,6,5,165,323,126,75,19,23,1223,1089,873,996,41,36,0.16666666666666666,30138136.455
ANDREI.LOKTIONOV,20092010,L.A,11.866666666666665,0,0,0,0,0,0,1,8,7,1,2,0,1,0,0,12,8,11,8,0,0,0.125,15069008.39
ANDREI.MARKOV,20092010,MTL,1259.9499999999998,6,18,13,31,37,24,0,0,0,94,215,53,67,20,16,1292,1279,838,944,42,29,0,30138120.725
ANDREJ.MESZAROS,20092010,T.B,1634.7833333333333,6,8,3,11,17,14,0,0,0,145,279,112,79,7,24,1349,1458,1017,1084,36,48,0,30138129.244999997
ANDREJ.SEKERA,20092010,BUF,937.0333333333333,4,3,4,7,11,7,0,1,1,63,129,46,49,9,5,906,828,713,741,33,32,0,30138086.990000002
ANDREW.ALBERTS,20092010,CAR,922.8833333333333,2,4,4,8,10,6,0,0,0,36,103,172,44,11,27,767,892,718,704,34,30,0,30138082.86
ANDREW.ALBERTS,20092010,VAN,358.5,1,2,0,2,3,3,0,1,1,18,42,63,16,2,13,297,347,265,246,17,16,0,30138038.42
ANDREW.BODNARCHUK,20092010,BOS,36.61666666666667,0,0,0,0,0,0,0,0,0,0,5,2,3,0,1,31,42,30,38,1,3,0,30138018.75
ANDREW.BRUNETTE,20092010,MIN,1396.2166666666667,25,22,14,36,61,47,5,10,5,129,192,32,22,19,6,1452,967,935,880,46,43,0.5,30138128.44
ANDREW.COGLIANO,20092010,EDM,1162.35,10,10,8,18,28,20,163,379,216,139,239,80,53,22,14,1020,1217,883,1053,41,45,0.43007915567282323,30138146.240000002
ANDREW.EBBETT,20092010,ANA,25.816666666666666,0,0,0,0,0,0,6,17,11,1,2,2,0,0,0,16,34,10,24,0,1,0.35294117647058826,15069011.14
ANDREW.EBBETT,20092010,CHI,107.23333333333332,1,0,0,0,1,1,35,71,36,13,21,9,4,4,1,118,85,114,78,2,1,0.49295774647887325,30138023.09
ANDREW.EBBETT,20092010,MIN,641.6166666666667,8,4,2,6,14,12,232,464,232,57,109,32,24,9,3,518,626,427,506,15,22,0.5,30138084.32
ANDREW.FERENCE,20092010,BOS,1199.5,0,4,5,9,9,4,0,0,0,72,170,72,57,11,13,1009,1091,882,882,30,46,0,30138098.385
ANDREW.GORDON,20092010,WSH,13.366666666666667,0,0,0,0,0,0,0,0,0,0,0,0,0,0,0,11,16,11,16,1,3,0,15069009.2
ANDREW.LADD,20092010,CHI,1366.0333333333333,20,11,13,24,44,31,6,15,9,171,290,146,58,23,24,1364,1097,1248,1042,63,59,0.4,30138124.545
ANDREW.MACDONALD,20092010,NYI,903.3166666666666,1,3,3,6,7,4,0,1,1,43,99,36,29,5,10,774,845,620,681,26,23,0,30138084.225
ANDREW.MURRAY,20092010,CBJ,466.75,5,2,0,2,7,7,49,114,65,73,101,71,10,6,3,349,381,331,302,6,13,0.4298245614035088,30138052.869999997
ANDREW.PETERS,20092010,N.J,150.73333333333335,0,0,0,0,0,0,2,4,2,15,22,29,4,13,21,92,116,91,115,1,6,0.5,30138031.060000002
ANDY.GREENE,20092010,N.J,1932.2833333333333,7,15,15,30,37,22,0,0,0,94,228,59,74,13,10,1728,1506,1264,1195,49,38,0,30138133.205
ANDY.HILBERT,20092010,MIN,38.88333333333333,0,0,0,0,0,0,0,2,2,6,8,4,1,1,1,34,45,27,40,0,2,0,30138020.060000002
ANDY.MCDONALD,20092010,STL,1432.4,24,18,15,33,57,42,240,446,206,191,315,46,60,19,9,1514,1128,931,886,41,46,0.5381165919282511,30138133.015
ANDY.SUTTON,20092010,NYI,1100.1166666666668,4,3,5,8,12,7,0,0,0,58,113,154,30,9,26,867,1264,774,928,32,33,0,30138117.915
ANDY.SUTTON,20092010,OTT,484.1,1,0,0,0,1,1,0,0,0,22,52,66,16,3,18,407,522,365,394,12,21,0,30138056.18
ANDY.WOZNIEWSKI,20092010,BOS,18.566666666666666,0,0,0,0,0,0,0,0,0,1,5,0,4,0,0,16,21,12,17,1,1,0,15069008.75
ANSSI.SALMELA,20092010,ATL,381.98333333333335,1,2,2,4,5,3,0,0,0,27,48,39,14,2,10,349,352,337,328,20,16,0,30138047.07
ANSSI.SALMELA,20092010,N.J,129.98333333333332,1,0,0,0,1,1,0,0,0,14,28,9,5,1,0,125,106,103,98,1,7,0,30138025.06
ANTOINE.VERMETTE,20092010,CBJ,1632.55,26,21,16,37,63,47,843,1558,715,154,250,91,48,16,16,1400,1495,936,1026,51,55,0.5410783055198973,30138175.78
ANTON.KLEMENTYEV,20092010,NYI,6.333333333333333,0,0,0,0,0,0,0,0,0,0,0,1,0,0,0,4,2,4,2,0,0,0,15069007.6
ANTON.STRALMAN,20092010,CBJ,1495.7833333333333,6,7,21,28,34,13,0,0,0,121,231,63,74,11,17,1419,1048,884,855,35,48,0,30138101.035
ANTON.VOLCHENKOV,20092010,OTT,1459.1833333333334,4,4,8,12,16,8,0,0,0,71,166,166,60,16,21,1117,1584,999,1045,49,55,0,30138117.91
ANTTI.MIETTINEN,20092010,MIN,1425.6833333333334,20,19,2,21,41,39,35,82,47,174,341,87,93,11,21,1331,1091,882,820,45,41,0.4268292682926829,30138111.759999998
ANZE.KOPITAR,20092010,L.A,1912.6333333333332,36,24,26,50,86,60,646,1301,655,277,482,85,89,21,9,2052,1529,1297,1121,52,48,0.4965411222136818,30138179.200000003
ARRON.ASHAM,20092010,PHI,983.75,14,12,5,17,31,26,6,22,16,123,214,143,48,47,44,971,868,907,851,46,42,0.2727272727272727,30138113.935000002
ARTEM.ANISIMOV,20092010,NYR,1057.9666666666667,12,7,9,16,28,19,310,690,380,124,240,45,67,12,16,984,902,858,786,36,36,0.4492753623188406,30138112.095
ARTURS.KULDA,20092010,ATL,47.949999999999996,0,1,1,2,2,1,0,0,0,5,7,9,1,0,1,42,68,40,61,3,2,0,30138022.575000003
B.J..CROMBEEN,20092010,STL,1033.15,7,5,3,8,15,12,18,51,33,120,199,82,37,35,48,706,1096,641,717,21,25,0.35294117647058826,30138104.695
BARRET.JACKMAN,20092010,STL,1496.7,2,7,6,13,15,9,0,1,1,73,163,70,59,14,29,1151,1566,1006,1022,45,45,0,30138116.29
BEN.EAGER,20092010,CHI,608.3166666666666,8,5,6,11,19,13,0,1,1,81,136,93,29,25,39,557,477,550,474,27,16,0,30138069.200000003
BEN.GUITE,20092010,NSH,50.95,0,0,0,0,0,0,15,34,19,5,9,14,1,2,2,25,59,22,44,0,3,0.4411764705882353,30138021.72
BEN.LOVEJOY,20092010,PIT,199.39999999999998,0,1,2,3,3,1,0,0,0,14,28,14,9,1,1,164,188,135,150,11,2,0,30138029.310000002
BEN.MAXWELL,20092010,MTL,115.18333333333334,0,0,0,0,0,0,9,19,10,6,13,4,2,0,3,76,126,75,125,2,5,0.47368421052631576,30138030.56
BEN.WALTER,20092010,N.J,11.583333333333332,0,0,0,0,0,0,2,6,4,0,1,0,1,0,1,10,11,9,10,0,0,0.3333333333333333,30138016.23
BENN.FERRIERO,20092010,S.J,267.3,2,1,1,2,4,3,3,4,1,42,66,17,11,5,4,257,195,222,183,9,4,0.75,30138033.145
BENOIT.POULIOT,20092010,MIN,167.06666666666666,2,0,2,2,4,2,4,8,4,19,36,15,6,2,6,165,145,133,132,7,5,0.5,30138029.78
BENOIT.POULIOT,20092010,MTL,864.0666666666666,15,8,3,11,26,23,3,7,4,114,184,75,32,10,17,884,780,686,715,29,23,0.42857142857142855,30138102.445
BILL.GUERIN,20092010,PIT,1550.4499999999998,25,12,17,29,54,37,15,32,17,254,425,90,75,16,30,1949,1096,1160,969,53,51,0.46875,30138126.585
BLAIR.BETTS,20092010,PHI,1052.5833333333335,8,5,6,11,19,13,585,1142,557,78,145,125,40,4,8,555,1204,505,687,23,26,0.5122591943957968,30138119.29
BLAIR.JONES,20092010,T.B,179.73333333333335,0,0,0,0,0,0,15,28,13,26,37,22,2,7,2,139,163,127,129,2,6,0.5357142857142857,30138029.57
BLAKE.COMEAU,20092010,NYI,923.65,17,13,5,18,35,30,10,21,11,134,214,108,50,12,18,785,968,663,699,33,36,0.47619047619047616,30138103.645
BLAKE.WHEELER,20092010,BOS,1479.5666666666666,19,16,9,25,44,35,15,33,18,177,322,81,74,17,26,1485,1164,1097,932,44,53,0.45454545454545453,30138118.695
BOBBY.BUTLER,20092010,OTT,16.683333333333334,0,0,0,0,0,0,0,0,0,2,4,1,1,1,0,12,13,12,13,0,1,0,30138016.310000002
BOBBY.RYAN,20092010,ANA,1497.7666666666669,35,18,11,29,64,53,41,93,52,258,465,126,101,35,26,1599,1168,1115,1013,63,46,0.44086021505376344,30138141.165
BOBBY.SANGUINETTI,20092010,NYR,57.66666666666667,0,0,0,0,0,0,0,0,0,5,13,3,3,1,2,62,38,59,36,2,2,0,30138017.26
BORIS.VALABIK,20092010,ATL,304.18333333333334,0,0,2,2,2,0,0,0,0,22,44,15,17,9,12,263,279,246,200,10,8,0,30138031.79
BOYD.GORDON,20092010,WSH,436.5833333333333,5,4,3,7,12,9,161,258,97,51,76,26,15,3,6,321,466,284,255,11,10,0.624031007751938,30138047.795
BOYD.KANE,20092010,WSH,24.633333333333333,0,0,0,0,0,0,0,0,0,2,3,3,0,1,1,12,22,12,22,0,1,0,30138017.96
BRAD.BOYES,20092010,STL,1376.7166666666667,14,14,14,28,42,28,138,310,172,196,373,76,84,12,12,1537,1103,989,955,50,43,0.44516129032258067,30138126.189999998
BRAD.LUKOWICH,20092010,VAN,145.85,1,0,1,1,2,1,0,0,0,1,9,12,5,0,2,115,152,112,127,8,3,0,30138027.625
BRAD.MARCHAND,20092010,BOS,239.28333333333333,0,1,0,1,1,1,3,11,8,32,49,20,7,5,7,216,216,200,181,3,6,0.2727272727272727,30138034.27
BRAD.MAY,20092010,DET,278.98333333333335,0,1,0,1,1,1,0,1,1,26,43,58,9,15,17,224,245,224,245,5,10,0,30138043.05
BRAD.RICHARDS,20092010,DAL,1650.3833333333332,23,42,24,66,89,65,580,1127,547,283,568,16,145,10,7,1912,1415,1024,1151,57,59,0.5146406388642414,30138184
BRAD.RICHARDSON,20092010,L.A,1127.4166666666665,12,10,7,17,29,22,192,406,214,160,269,141,53,24,13,914,1036,825,832,36,43,0.4729064039408867,30138118.595
BRAD.STAUBITZ,20092010,S.J,284.75,3,1,2,3,6,4,0,4,4,24,42,65,9,17,32,190,214,186,212,8,8,0,30138044.12
BRAD.STUART,20092010,DET,2164.6666666666665,6,9,11,20,26,15,2,3,1,176,363,252,96,22,13,1899,2130,1569,1448,55,65,0.6666666666666666,30138152.075
BRAD.WINCHESTER,20092010,STL,580.25,3,4,1,5,8,7,3,12,9,69,109,143,20,21,33,526,452,446,436,17,14,0.25,30138065.955
BRANDON.BOCHENSKI,20092010,T.B,343.6333333333333,4,5,4,9,13,9,2,5,3,43,72,18,11,4,1,342,251,247,224,12,12,0.4,30138041.12
BRANDON.DUBINSKY,20092010,NYR,1349.3,20,18,6,24,44,38,347,675,328,163,289,129,71,25,22,1299,1260,961,926,42,38,0.5140740740740741,30138137.880000003
BRANDON.PRUST,20092010,CGY,281.6333333333333,1,2,2,4,5,3,11,29,18,23,40,29,6,22,21,266,222,262,221,12,6,0.3793103448275862,30138039.61
BRANDON.PRUST,20092010,NYR,242.56666666666666,4,4,1,5,9,8,2,2,0,21,35,42,7,12,17,223,207,214,188,10,7,1,30138038.725
BRANDON.SEGAL,20092010,DAL,215.36666666666667,5,2,3,5,10,7,0,0,0,31,53,39,10,3,6,182,214,177,207,11,8,0,30138041.355
BRANDON.SEGAL,20092010,L.A,169.41666666666669,1,0,1,1,2,1,0,3,3,24,44,55,9,3,6,146,136,143,131,5,6,0,30138028.455
BRANDON.SUTTER,20092010,CAR,1191.1833333333334,21,18,1,19,40,39,489,996,507,168,261,55,42,17,1,1050,1188,757,905,32,32,0.49096385542168675,30138155.655
BRANDON.YIP,20092010,COL,577.05,13,7,3,10,23,20,0,2,2,77,131,52,25,8,13,469,555,362,525,20,17,0,30138088.055
BRAYDEN.IRWIN,20092010,TOR,20.183333333333334,0,0,0,0,0,0,3,6,3,3,5,1,1,0,0,18,22,18,20,0,0,0.5,15069009.72
BRAYDEN.SCHENN,20092010,L.A,12.516666666666667,0,0,0,0,0,0,4,14,10,0,1,4,1,0,0,12,14,12,13,1,2,0.2857142857142857,15069009.01
BRAYDON.COBURN,20092010,PHI,2290.633333333333,6,10,6,16,22,16,0,0,0,151,359,176,125,13,38,2149,2103,1642,1548,64,69,0,30138160.28
BRENDAN.MIKKELSON,20092010,ANA,419.83333333333337,0,1,1,2,2,1,0,0,0,21,47,28,15,5,7,324,408,272,351,13,18,0,30138052.625
BRENDAN.MORRISON,20092010,WSH,1224.4666666666667,12,18,12,30,42,30,533,1035,502,111,205,38,49,13,21,1354,1078,1007,927,49,31,0.514975845410628,30138136.8
BRENDAN.WITT,20092010,NYI,628.3,2,2,1,3,5,4,0,1,1,25,55,79,22,14,18,474,756,429,542,11,29,0,30138076.615000002
BRENDEN.MORROW,20092010,DAL,1438.2333333333333,19,13,13,26,45,32,9,31,22,153,265,226,52,28,32,1470,1242,909,914,37,37,0.2903225806451613,30138128.465
BRENT.BURNS,20092010,MIN,1051.45,3,7,10,17,20,10,0,0,0,104,212,97,61,15,15,986,920,658,689,25,32,0,30138086.85
BRENT.SEABROOK,20092010,CHI,2343.6000000000004,8,15,14,29,37,23,0,0,0,168,355,289,123,17,28,2186,2068,1705,1448,85,68,0,30138143.42
BRENT.SOPEL,20092010,CHI,1491.8000000000002,2,5,7,12,14,7,0,0,0,64,146,73,47,17,21,1248,1501,1130,1006,54,53,0,30138105.445
BRETT.CARSON,20092010,CAR,937.9833333333333,2,3,7,10,12,5,0,0,0,42,107,77,41,6,6,835,926,703,770,29,28,0,30138091.485
BRETT.CLARK,20092010,COL,1242.8166666666666,3,6,9,15,18,9,0,0,0,78,165,57,55,4,14,1024,1186,728,858,35,31,0,30138105.915
BRETT.FESTERLING,20092010,ANA,525,0,0,3,3,3,0,0,0,0,25,60,127,17,7,6,380,479,365,423,17,17,0,30138057.545
BRETT.LEBDA,20092010,DET,956.3333333333333,1,5,1,6,7,6,0,0,0,62,139,39,41,5,11,860,802,821,751,34,32,0,30138083.675
BRETT.SUTTER,20092010,CGY,96.63333333333333,0,0,0,0,0,0,1,5,4,9,14,9,3,2,1,76,77,68,53,0,2,0.2,30138019.91
BRIAN.BOYLE,20092010,NYR,598.0833333333334,4,2,0,2,6,6,125,323,198,73,126,143,20,13,15,430,633,397,454,15,21,0.38699690402476783,30138076.58
BRIAN.CAMPBELL,20092010,CHI,1950.65,8,12,23,35,43,20,0,0,0,153,313,49,104,16,10,2064,1258,1530,1113,73,54,0,30138102.134999998
BRIAN.GIONTA,20092010,MTL,1687.6,37,10,14,24,61,47,14,31,17,306,535,62,114,19,19,1810,1656,1196,1195,53,44,0.45161290322580644,30138160.9
BRIAN.LEE,20092010,OTT,357.68333333333334,2,0,0,0,2,2,0,0,0,22,59,33,25,0,7,312,288,293,260,8,11,0,30138037.95
BRIAN.MCGRATTAN,20092010,CGY,116.94999999999999,1,1,2,3,4,2,0,0,0,19,31,16,7,15,18,111,101,111,101,6,3,0,30138027.85
BRIAN.POTHIER,20092010,CAR,420.16666666666663,1,1,2,3,4,2,0,0,0,24,55,35,23,3,4,355,473,280,355,6,14,0,30138053.13
BRIAN.POTHIER,20092010,WSH,740.0333333333333,4,2,4,6,10,6,0,0,0,57,119,51,43,2,5,729,657,597,576,29,15,0,30138068.57
BRIAN.RAFALSKI,20092010,DET,2177.383333333333,11,20,22,42,53,31,0,0,0,157,366,49,128,11,13,2610,1600,1706,1308,73,58,0,30138126.009999998
BRIAN.ROLSTON,20092010,N.J,1428.2166666666667,22,10,8,18,40,32,36,68,32,244,424,97,108,11,10,1265,992,862,835,36,35,0.5294117647058824,30138112.1
BRIAN.SUTHERBY,20092010,DAL,389.4666666666667,5,3,1,4,9,8,18,41,23,49,71,86,17,16,19,301,339,287,318,15,6,0.43902439024390244,30138055.205
BRIAN.WILLSIE,20092010,COL,44.35,0,0,0,0,0,0,10,18,8,2,5,2,2,0,0,26,59,24,36,1,2,0.5555555555555556,15069011.65
BROCK.TROTTER,20092010,MTL,18.083333333333332,0,0,0,0,0,0,0,0,0,6,8,0,0,3,0,20,20,18,20,0,1,0,15069009.93
BROOKS.LAICH,20092010,WSH,1566.1,27,20,14,34,61,47,165,358,193,243,396,101,68,23,18,1759,1482,1113,1032,57,43,0.46089385474860334,30138149.43
BROOKS.ORPIK,20092010,PIT,1727.5500000000002,2,13,12,25,27,15,0,0,0,74,157,302,47,23,33,1544,1701,1384,1250,63,56,0,30138135.13
BRUNO.GERVAIS,20092010,NYI,1406.15,3,6,7,13,16,9,0,0,0,83,194,63,68,5,13,1300,1539,1077,1106,40,56,0,30138122.924999997
BRYAN.ALLEN,20092010,FLA,1417.9,4,6,3,9,13,10,0,0,0,78,165,120,53,24,36,1083,1683,1012,1284,39,50,0,30138159.064999998
BRYAN.BICKELL,20092010,CHI,206.43333333333334,3,1,1,2,5,4,0,2,2,23,41,32,8,5,2,188,136,178,134,11,3,0,30138027.674999997
BRYAN.LITTLE,20092010,ATL,1244.25,13,17,3,20,33,30,68,154,86,165,273,45,59,27,10,1274,981,890,878,40,41,0.44155844155844154,30138119.665
BRYAN.MCCABE,20092010,FLA,1912.7833333333333,8,14,19,33,41,22,0,0,0,169,358,113,122,11,34,1815,1731,1157,1386,50,51,0,30138167.634999998
BRYAN.RODNEY,20092010,CAR,368.1,1,4,6,10,11,5,0,0,0,24,56,24,24,0,4,396,334,277,268,13,14,0,30138040.95
BRYCE.SALVADOR,20092010,N.J,1570.5666666666666,4,2,8,10,14,6,0,0,0,48,113,101,41,12,27,1197,1345,1081,1080,39,38,0,30138122.02
BYRON.BITZ,20092010,BOS,492.6,4,4,1,5,9,8,7,17,10,51,77,64,11,12,8,393,447,381,404,15,23,0.4117647058823529,30138062.025
BYRON.BITZ,20092010,FLA,81.36666666666667,1,1,0,1,2,2,0,1,1,7,16,19,2,2,1,77,73,64,69,3,2,0,30138023.22
CAL.CLUTTERBUCK,20092010,MIN,1055.9333333333334,13,5,3,8,21,18,3,10,7,136,246,316,51,31,22,821,985,692,786,23,29,0.3,30138110.005
CAL.O'REILLY,20092010,NSH,422.6166666666667,2,3,6,9,11,5,133,281,148,23,38,2,8,1,1,381,344,263,299,15,12,0.47330960854092524,30138054.130000003
CAM.BARKER,20092010,CHI,667.8833333333333,4,5,4,9,13,9,0,0,0,73,162,59,58,4,16,725,434,518,408,26,18,0,30138049.64
CAM.BARKER,20092010,MIN,418.59999999999997,1,2,4,6,7,3,0,0,0,31,57,16,18,0,5,342,404,238,307,15,15,0,30138048.6
CAM.JANSSEN,20092010,STL,202.46666666666664,0,0,0,0,0,0,0,1,1,11,29,73,6,26,38,153,173,152,169,6,8,0,30138037.509999998
CARL.GUNNARSSON,20092010,TOR,921.95,3,3,9,12,15,6,0,1,1,45,108,46,44,1,5,793,926,607,628,33,27,0,30138074.785
CARLO.COLAIACOVO,20092010,STL,1159.2666666666667,7,12,11,23,30,19,1,1,0,74,172,52,54,10,20,1261,789,891,681,42,33,1,30138077.315
CASEY.BORER,20092010,CAR,21.516666666666666,0,0,0,0,0,0,0,0,0,0,1,4,1,0,0,17,27,17,26,0,1,0,30138017.9
CASEY.WELLMAN,20092010,MIN,144.61666666666667,1,3,0,3,4,4,17,32,15,18,32,5,8,2,0,96,141,84,132,4,5,0.53125,30138032.65
CHAD.KOLARIK,20092010,CBJ,12.966666666666667,0,0,0,0,0,0,0,0,0,2,3,2,0,0,0,7,15,7,15,0,1,0,15069009.5
CHAD.LAROSE,20092010,CAR,862.05,11,9,8,17,28,20,2,12,10,136,217,114,37,9,11,724,897,650,677,31,34,0.16666666666666666,30138096.119999997
CHARLES.LINGLET,20092010,EDM,51.300000000000004,0,0,0,0,0,0,0,1,1,7,10,3,1,0,1,37,60,34,53,0,5,0,30138021.65
CHRIS.BOURQUE,20092010,PIT,182.18333333333334,0,2,1,3,3,2,0,0,0,19,34,24,7,2,5,164,153,130,145,3,7,0,30138031.645
CHRIS.BOURQUE,20092010,WSH,9.616666666666667,0,0,0,0,0,0,0,0,0,1,2,1,1,0,0,10,16,10,14,0,2,0,15069009
CHRIS.BUTLER,20092010,BUF,1180.7166666666667,1,8,11,19,20,9,0,0,0,61,161,49,64,10,11,1118,1039,772,771,31,40,0,30138088.525
CHRIS.CAMPOLI,20092010,OTT,1314.7,4,6,9,15,19,10,0,1,1,75,161,111,55,8,10,1150,979,919,830,35,41,0,30138092.205
CHRIS.CHELIOS,20092010,ATL,78.21666666666667,0,0,0,0,0,0,0,0,0,5,12,8,4,1,0,74,68,72,51,0,2,0,30138018.71
CHRIS.CLARK,20092010,CBJ,421.91666666666663,3,1,1,2,5,4,4,10,6,45,67,50,10,5,8,293,388,279,347,10,18,0.4,30138056.585
CHRIS.CLARK,20092010,WSH,442.75,4,6,5,11,15,10,3,10,7,59,99,36,24,9,11,445,373,384,359,15,17,0.3,30138055.285
CHRIS.CONNER,20092010,PIT,87.8,2,1,0,1,3,3,0,1,1,11,20,9,6,2,0,87,88,84,86,3,3,0,30138024.92
CHRIS.DRURY,20092010,NYR,1368.6833333333334,14,12,6,18,32,26,638,1206,568,148,267,67,52,22,14,1092,1481,753,960,26,31,0.5290215588723052,30138158.24
CHRIS.DURNO,20092010,COL,312.15,4,2,2,4,8,6,21,40,19,27,46,56,12,12,18,231,283,227,274,10,7,0.525,30138050.41
CHRIS.HIGGINS,20092010,CGY,190.29999999999998,2,1,0,1,3,3,2,7,5,28,48,19,14,4,0,175,153,148,111,3,5,0.2857142857142857,30138025.32
CHRIS.HIGGINS,20092010,NYR,985,6,4,4,8,14,10,26,63,37,137,229,111,43,10,16,870,942,678,710,20,29,0.4126984126984127,30138095.79
CHRIS.KELLY,20092010,OTT,1324.7333333333333,16,11,10,21,37,27,443,969,526,123,209,74,47,18,20,956,1332,869,859,40,50,0.45717234262125905,30138136.549999997
CHRIS.KUNITZ,20092010,PIT,1030.4833333333333,17,18,7,25,42,35,6,17,11,165,276,156,56,14,16,1258,748,934,678,42,32,0.35294117647058826,30138088.905
CHRIS.MINARD,20092010,EDM,48.7,0,1,0,1,1,1,0,0,0,4,8,3,0,0,0,29,54,21,54,0,3,0,30138022.8
CHRIS.NEIL,20092010,OTT,899.6500000000001,13,10,2,12,25,23,2,6,4,112,185,267,28,32,53,810,698,740,676,31,33,0.3333333333333333,30138099.35
CHRIS.PHILLIPS,20092010,OTT,1982.2666666666667,8,7,8,15,23,15,0,0,0,87,180,111,61,13,23,1533,2097,1305,1352,63,67,0,30138151.93
CHRIS.PRONGER,20092010,PHI,2790.0166666666664,14,21,34,55,69,35,0,0,0,216,445,152,161,20,47,2697,2472,1750,1609,80,57,0,30138174.65
CHRIS.STEWART,20092010,COL,1393.6833333333334,31,23,13,36,67,54,3,8,5,241,377,109,66,25,27,1381,1279,950,1174,65,55,0.375,30138175.845
CHRIS.THORBURN,20092010,ATL,758.6833333333334,4,7,2,9,13,11,16,29,13,63,98,103,18,22,26,481,815,444,506,20,17,0.5517241379310345,30138077.56
CHRISTIAN.EHRHOFF,20092010,VAN,2110.6,17,18,16,34,51,35,0,0,0,206,458,67,139,19,24,2202,1648,1486,1213,83,45,0,30138126.44
CHRISTIAN.HANSON,20092010,TOR,414.5333333333333,2,4,1,5,7,6,98,177,79,45,88,46,22,7,8,391,406,312,320,12,14,0.5536723163841808,30138052.465
CHRISTOPH.SCHUBERT,20092010,ATL,741.4666666666667,2,1,4,5,7,3,0,0,0,73,139,149,39,9,29,588,738,541,538,23,31,0,30138069.69
CHUCK.KOBASEW,20092010,BOS,100.56666666666666,0,0,1,1,1,0,0,0,0,13,20,7,2,0,1,88,105,77,95,2,4,0,30138025.674999997
CHUCK.KOBASEW,20092010,MIN,581.0833333333334,9,3,2,5,14,12,2,8,6,58,102,49,16,8,8,400,569,339,490,15,21,0.25,30138079.46
CLARKE.MACARTHUR,20092010,ATL,327.93333333333334,3,4,2,6,9,7,5,10,5,30,57,14,19,10,1,314,290,234,239,12,13,0.5,30138040.9
CLARKE.MACARTHUR,20092010,BUF,862.1833333333334,13,8,5,13,26,21,62,143,81,99,155,48,32,8,13,829,728,615,655,25,33,0.43356643356643354,30138098.235
CLAUDE.GIROUX,20092010,PHI,1793.4333333333334,26,30,11,41,67,56,417,874,457,191,339,103,66,32,11,1853,1450,1231,1190,49,50,0.477116704805492,30138180.425
CLAY.WILSON,20092010,FLA,22.233333333333334,0,0,0,0,0,0,0,0,0,0,1,4,0,1,0,16,27,9,19,0,4,0,15069009.91
CLAYTON.STONER,20092010,MIN,106.5,0,1,1,2,2,1,0,0,0,5,9,5,2,2,3,82,95,80,93,4,4,0,30138025.395
CODY.ALMOND,20092010,MIN,54.25,1,0,0,0,1,1,18,30,12,6,8,7,2,1,3,37,49,35,49,0,4,0.6,30138022.18
CODY.FRANSON,20092010,NSH,902.2833333333333,6,9,7,16,22,15,0,0,0,95,231,59,77,3,9,1001,640,749,601,36,17,0,30138066.555
CODY.MCCORMICK,20092010,BUF,32.06666666666666,0,0,2,2,2,0,1,1,0,4,4,12,0,0,3,25,29,25,26,2,1,1,30138018.14
CODY.MCLEOD,20092010,COL,1022.9166666666666,7,8,3,11,18,15,4,13,9,121,185,222,29,34,41,722,1023,671,851,24,41,0.3076923076923077,30138123.625
COLBY.ARMSTRONG,20092010,ATL,1168.6166666666668,15,9,5,14,29,24,10,20,10,101,175,74,38,25,22,971,1130,846,873,41,39,0.5,30138116.625
COLIN (JOHN).WHITE,20092010,N.J,388.16666666666663,1,0,2,2,3,1,0,0,0,11,26,31,9,2,2,259,323,234,247,9,9,0,30138039.37
COLIN.FRASER,20092010,CHI,697.1666666666667,7,5,6,11,18,12,223,460,237,93,136,67,22,22,13,559,589,523,423,25,21,0.48478260869565215,30138069.79
COLIN.MCDONALD,20092010,EDM,13.383333333333333,1,0,0,0,1,1,0,0,0,3,4,1,0,0,0,13,8,13,8,1,0,0,30138016.25
COLIN.WHITE,20092010,N.J,1332.6,2,3,4,7,9,5,0,0,0,37,96,126,37,11,14,979,1155,892,879,47,43,0,30138097.060000002
COLIN.WILSON,20092010,NSH,612.9166666666667,8,5,3,8,16,13,62,128,66,66,106,25,18,11,2,615,466,460,433,19,17,0.484375,30138066.365000002
COLTON.ORR,20092010,TOR,563.05,4,1,1,2,6,5,1,2,1,43,79,119,9,35,61,430,545,416,533,15,19,0.5,30138085.665
COREY.ELKINS,20092010,L.A,35.71666666666667,1,0,0,0,1,1,6,18,12,5,6,2,1,0,0,20,35,19,30,1,3,0.3333333333333333,15069012.24
COREY.LOCKE,20092010,NYR,18.9,0,0,0,0,0,0,1,7,6,2,3,0,1,1,0,8,23,8,23,1,0,0.14285714285714285,15069010.65
COREY.PERRY,20092010,ANA,1726.9499999999998,27,28,21,49,76,55,6,28,22,270,450,93,74,35,39,1871,1400,1178,1169,67,53,0.21428571428571427,30138166.915
COREY.POTTER,20092010,NYR,36.36666666666667,0,0,0,0,0,0,0,0,0,2,4,2,1,0,1,35,24,35,21,0,0,0,30138016.5
CORY.MURPHY,20092010,N.J,149.26666666666668,2,1,0,1,3,3,0,0,0,9,19,3,7,2,1,131,102,78,90,4,6,0,30138025.52
CORY.SARICH,20092010,CGY,909.0333333333333,1,2,2,4,5,3,0,0,0,46,98,116,28,6,24,776,815,707,650,27,27,0,30138076.81
CORY.STILLMAN,20092010,FLA,1018.9333333333334,15,16,6,22,37,31,18,29,11,126,249,66,49,10,10,1000,964,651,857,35,30,0.6206896551724138,30138126.42
CRAIG.ADAMS,20092010,PIT,1036.4333333333334,2,6,5,11,13,8,269,613,344,92,165,225,36,18,22,664,1125,588,696,19,24,0.43882544861337686,30138109.415
CRAIG.CONROY,20092010,CGY,854.6833333333334,3,8,2,10,13,11,453,879,426,52,100,43,27,11,11,700,867,626,587,16,26,0.515358361774744,30138093.08
CRAIG.RIVET,20092010,BUF,1508.6166666666668,2,8,6,14,16,10,0,0,0,66,160,73,65,18,35,1290,1403,981,1042,40,42,0,30138121.479999997
CURTIS.GLENCROSS,20092010,CGY,1053.2833333333333,15,10,7,17,32,25,9,24,15,117,210,78,45,18,21,976,958,785,697,26,20,0.375,30138096.015
DAINIUS.ZUBRUS,20092010,N.J,922.3166666666666,11,11,6,17,28,22,199,409,210,100,155,70,31,25,18,821,623,618,552,30,26,0.48655256723716384,30138088.409999996
DAN.BOYLE,20092010,S.J,2371.2166666666667,17,28,27,55,72,45,0,3,3,226,489,70,172,26,34,2707,1987,1685,1417,83,71,0,30138151.185
DAN.CARCILLO,20092010,PHI,1033.9833333333333,14,8,6,14,28,22,1,3,2,126,197,232,38,78,65,832,930,792,897,37,30,0.3333333333333333,30138130.27
DAN.CLEARY,20092010,DET,1280.1666666666665,17,12,7,19,36,29,70,136,66,166,269,138,54,13,15,1370,1143,1001,836,41,44,0.5147058823529411,30138108.405
DAN.GIRARDI,20092010,NYR,1761.55,6,8,7,15,21,14,0,0,0,108,227,178,81,12,20,1405,1951,1210,1345,56,63,0,30138153.345
DAN.HAMHUIS,20092010,NSH,1792.4,5,6,13,19,24,11,0,0,0,119,266,166,89,25,24,1484,1705,1310,1229,58,62,0,30138129.375
DAN.SEXTON,20092010,ANA,553.25,9,4,6,10,19,13,0,1,1,93,140,32,21,10,4,560,434,465,411,24,25,0,30138061
DANE.BYERS,20092010,NYR,31.766666666666666,1,0,0,0,1,1,0,0,0,3,4,4,0,2,5,25,24,25,24,1,0,0,30138018.82
DANIEL.ALFREDSSON,20092010,OTT,1514,22,28,29,57,79,50,14,40,26,178,339,51,90,10,12,1459,1343,874,931,45,45,0.35,30138135.635
DANIEL.BRIERE,20092010,PHI,222.86666666666667,7,2,1,3,10,9,5,10,5,36,59,4,12,8,5,312,188,211,161,8,7,0.5,30138034.505
DANIEL.PAILLE,20092010,BOS,1230.15,10,3,8,11,21,13,7,17,10,139,220,103,41,11,7,941,1169,855,872,25,31,0.4117647058823529,30138110.939999998
DANIEL.PAILLE,20092010,BUF,20.733333333333334,0,1,0,1,1,1,0,0,0,2,2,1,0,1,0,16,19,16,18,2,1,0,15069009.76
DANIEL.SEDIN,20092010,VAN,1443.0166666666669,34,41,24,65,99,75,11,35,24,263,463,13,87,9,19,1729,1022,1147,869,83,42,0.3142857142857143,30138127.83
DANIEL.WINNIK,20092010,ARI,1061.9,4,7,8,15,19,11,59,141,82,89,147,108,29,14,6,700,1231,616,727,26,27,0.41843971631205673,30138101.25
DANNY.BRIERE,20092010,PHI,1471.8999999999999,31,25,17,42,73,56,130,283,153,220,369,71,82,28,35,1697,1215,1139,1085,58,44,0.45936395759717313,30138159.405
DANNY.IRMEN,20092010,MIN,9.266666666666667,0,0,0,0,0,0,0,0,0,0,1,2,0,0,0,4,11,4,11,0,1,0,15069008.95
DANNY.SYVRET,20092010,PHI,262.05,2,0,1,1,3,2,0,0,0,14,33,6,13,2,6,239,258,221,243,12,11,0,30138039.744999997
DANY.HEATLEY,20092010,S.J,1931.1999999999998,41,36,18,54,95,77,15,39,24,325,598,95,143,21,35,2267,1682,1435,1403,75,64,0.38461538461538464,30138193.61
DARCY.HORDICHUK,20092010,VAN,337.71666666666664,1,0,1,1,2,1,0,1,1,20,34,108,9,33,30,191,302,183,297,8,15,0,30138054.505000003
DARCY.TUCKER,20092010,COL,932.2833333333333,10,9,4,13,23,19,32,49,17,77,120,98,22,18,20,719,750,530,695,19,20,0.6530612244897959,30138106.41
DARREN.HAYDAR,20092010,COL,5.366666666666666,0,0,0,0,0,0,0,0,0,2,2,0,0,0,0,6,8,6,8,0,0,0,15069008.5
DARREN.HELM,20092010,DET,1254.3333333333335,12,6,7,13,25,18,535,1047,512,181,320,231,74,31,10,1037,1290,932,883,31,40,0.5109837631327603,30138128.435000002
DARROLL.POWE,20092010,PHI,1049.1333333333332,9,5,2,7,16,14,114,246,132,131,222,248,40,30,23,787,1034,716,789,30,33,0.4634146341463415,30138112.009999998
DARRYL.SYDOR,20092010,STL,785.2833333333333,0,3,4,7,7,3,0,1,1,26,68,18,29,3,5,617,829,529,576,17,23,0,30138072.13
DAVE.BOLLAND,20092010,CHI,1087.1666666666667,14,10,8,18,32,24,401,877,476,88,144,49,34,15,24,949,1073,712,748,36,32,0.4572405929304447,30138124.939999998
DAVE.SCATCHARD,20092010,NSH,171.28333333333333,3,1,1,2,5,4,42,81,39,25,36,18,6,7,7,162,147,141,130,5,4,0.5185185185185185,30138032.424999997
DAVID.BACKES,20092010,STL,1445.6333333333332,17,18,12,30,47,35,504,1063,559,163,287,266,47,41,40,1409,1230,965,849,40,40,0.47412982126058323,30138141.22
DAVID.BOOTH,20092010,FLA,507.6833333333334,8,2,6,8,16,10,2,10,8,95,162,50,29,15,10,576,439,391,374,13,15,0.2,30138059.18
DAVID.CLARKSON,20092010,N.J,726.6833333333334,11,7,6,13,24,18,6,21,15,110,189,106,32,28,36,630,504,412,474,21,20,0.2857142857142857,30138081.42
DAVID.DESHARNAIS,20092010,MTL,50.66666666666667,0,1,0,1,1,1,16,28,12,2,8,2,3,1,0,53,46,38,42,1,2,0.5714285714285714,30138019.9
DAVID.HALE,20092010,T.B,548.15,0,4,0,4,4,4,0,0,0,25,45,56,13,5,10,393,528,364,390,15,20,0,30138056.1
DAVID.JONES,20092010,COL,412.31666666666666,10,5,1,6,16,15,2,7,5,39,59,29,9,3,2,298,438,243,324,16,17,0.2857142857142857,30138060.035
DAVID.KOCI,20092010,COL,131.2,1,0,0,0,1,1,0,0,0,6,9,33,1,12,20,78,132,78,132,3,5,0,30138034.42
DAVID.KREJCI,20092010,BOS,1613.3666666666668,21,24,14,38,59,45,621,1226,605,172,287,102,61,22,14,1656,1308,1160,1016,53,43,0.5065252854812398,30138156.21
DAVID.LALIBERTE,20092010,PHI,91.16666666666667,2,1,0,1,3,3,2,2,0,8,19,13,4,2,4,76,76,57,73,4,3,1,30138024.85
DAVID.LEGWAND,20092010,NSH,1649.4166666666665,13,18,14,32,45,31,563,1190,627,167,266,43,49,13,16,1463,1465,1111,1071,39,48,0.473109243697479,30138163.549999997
DAVID.MOSS,20092010,CGY,877.7166666666667,8,8,1,9,17,16,15,43,28,133,239,79,54,5,10,878,705,696,594,17,28,0.3488372093023256,30138078.175
DAVID.PERRON,20092010,STL,1324.7166666666667,20,19,7,26,46,39,8,21,13,165,274,78,56,36,30,1347,981,898,830,39,46,0.38095238095238093,30138119.005
DAVID.SCHLEMKO,20092010,ARI,302.95000000000005,1,4,0,4,5,5,0,0,0,19,43,10,14,1,4,342,229,273,214,12,9,0,30138034.009999998
DAVID.STECKEL,20092010,WSH,1011.3833333333333,5,6,5,11,16,11,655,1107,452,90,163,122,41,12,8,782,1069,686,618,28,21,0.5916892502258356,30138092.095
DAVIS.DREWISKE,20092010,L.A,640.3000000000001,1,4,3,7,8,5,0,0,0,32,73,30,25,7,7,545,530,496,459,15,21,0,30138058.895
DAYMOND.LANGKOW,20092010,CGY,1361.6833333333334,14,10,13,23,37,24,492,1130,638,126,229,80,46,11,15,1221,1125,860,735,31,32,0.4353982300884956,30138122.615
DEAN.ARSENE,20092010,EDM,168.31666666666666,0,0,0,0,0,0,0,0,0,4,11,18,7,5,12,106,200,100,174,3,6,0,30138036.65
DEAN.MCAMMOND,20092010,N.J,853.7333333333333,8,6,3,9,17,14,268,589,321,92,149,14,27,14,13,692,656,590,524,18,21,0.45500848896434637,30138086.535
DENIS.GREBESHKOV,20092010,EDM,1025.65,6,8,3,11,17,14,1,1,0,43,100,41,35,8,13,877,1048,676,829,24,40,1,30138109.695
DENIS.GREBESHKOV,20092010,NSH,88.61666666666667,1,2,1,3,4,3,0,0,0,4,13,7,6,1,3,85,61,71,55,7,5,0,30138020.285
DENNIS.SEIDENBERG,20092010,BOS,390.2833333333333,2,2,5,7,9,4,0,0,0,37,73,33,23,3,3,389,296,300,217,12,5,0,30138032.505
DENNIS.SEIDENBERG,20092010,FLA,1420.4666666666667,2,10,11,21,23,12,0,1,1,116,222,133,68,11,11,1258,1576,933,1129,35,36,0,30138137.585
DENNIS.WIDEMAN,20092010,BOS,2128.7833333333333,7,12,23,35,42,19,0,0,0,174,407,112,144,18,18,2076,1813,1512,1381,52,65,0,30138141.955
DEREK.ARMSTRONG,20092010,STL,41.916666666666664,0,0,0,0,0,0,7,15,8,6,9,4,1,1,1,48,29,34,29,0,2,0.4666666666666667,30138018.29
DEREK.BOOGAARD,20092010,MIN,351.0333333333333,0,1,3,4,4,1,0,0,0,25,43,83,8,19,31,254,302,247,297,8,20,0,30138051.665
DEREK.DORSETT,20092010,CBJ,545.0166666666667,4,5,5,10,14,9,9,33,24,57,90,96,18,35,36,422,439,380,403,16,11,0.2727272727272727,30138066.985
DEREK.JOSLIN,20092010,S.J,333.15,0,0,2,2,2,0,0,0,0,19,46,9,18,3,6,291,348,258,310,11,12,0,30138046.28
DEREK.MACKENZIE,20092010,CBJ,156.45,1,2,1,3,4,3,57,104,47,14,24,17,3,6,0,130,122,124,99,5,2,0.5480769230769231,30138026.865000002
DEREK.MEECH,20092010,DET,583.6833333333334,2,3,1,4,6,5,0,0,0,57,110,36,31,3,8,567,444,462,429,8,20,0,30138057.605
DEREK.MORRIS,20092010,ARI,490.7833333333333,2,1,5,6,8,3,0,0,0,46,89,24,20,4,8,472,428,317,291,16,13,0,30138043.265
DEREK.MORRIS,20092010,BOS,1276.0500000000002,3,9,12,21,24,12,0,1,1,95,208,50,70,4,11,1211,1039,859,742,30,32,0,30138082.79
DEREK.PELTIER,20092010,COL,27.016666666666666,0,0,0,0,0,0,0,0,0,1,3,1,2,0,0,22,32,21,31,1,1,0,15069010.7
DEREK.ROY,20092010,BUF,1688.6000000000001,26,31,14,45,71,57,661,1327,666,228,418,33,98,33,26,1702,1451,1108,1069,48,40,0.4981160512434062,30138176.67
DEREK.SMITH,20092010,OTT,24.666666666666668,0,0,0,0,0,0,0,0,0,4,7,2,2,0,0,27,23,26,22,0,4,0,15069009.4
DERICK.BRASSARD,20092010,CBJ,1163.6333333333332,9,20,6,26,35,29,205,494,289,124,226,96,72,20,19,1084,929,744,800,37,48,0.4149797570850202,30138120.85
DERYK.ENGELLAND,20092010,PIT,145.25,0,1,1,2,2,1,0,0,0,4,14,25,6,4,4,114,137,109,127,4,8,0,30138028.565
DEVIN.SETOGUCHI,20092010,S.J,1331.3666666666668,25,10,9,19,44,35,3,9,6,222,411,161,97,29,12,1539,1125,1099,1021,45,35,0.3333333333333333,30138129.035
DION.PHANEUF,20092010,CGY,1278.0500000000002,10,6,6,12,22,16,0,0,0,138,322,125,119,15,16,1384,1072,918,850,38,38,0,30138093.25
DION.PHANEUF,20092010,TOR,685.45,2,7,1,8,10,9,0,0,0,87,222,69,78,19,14,750,638,482,429,14,17,0,30138053.415
DJ.KING,20092010,STL,54.016666666666666,0,0,0,0,0,0,0,0,0,5,6,18,1,8,9,47,39,47,39,0,4,0,30138020.03
DMITRY.KULIKOV,20092010,FLA,1219.6666666666667,3,9,4,13,16,12,0,0,0,87,181,79,52,8,16,1129,1126,804,975,28,30,0,30138123.23
DOMINIC.MOORE,20092010,FLA,715.6833333333334,8,5,4,9,17,13,258,462,204,81,144,39,29,16,16,599,740,491,597,17,24,0.5584415584415584,30138095.98
DOMINIC.MOORE,20092010,MTL,584.8499999999999,6,4,6,10,16,10,162,335,173,58,105,41,24,10,7,430,615,404,484,20,15,0.4835820895522388,30138078.73
DONALD.BRASHEAR,20092010,NYR,225.08333333333331,0,0,1,1,1,0,0,0,0,18,30,43,7,11,18,168,230,166,226,2,11,0,30138043.035
DOUG.JANIK,20092010,DET,175.11666666666667,0,1,1,2,2,1,0,0,0,5,13,4,4,3,6,119,158,115,137,2,6,0,30138030.705
DOUG.WEIGHT,20092010,NYI,554.4333333333334,1,9,7,16,17,10,69,149,80,58,101,15,20,2,4,630,480,338,437,18,16,0.46308724832214765,30138070.955
DOUGLAS.MURRAY,20092010,S.J,1891.3666666666668,5,7,10,17,22,12,0,0,0,99,236,288,87,11,30,1728,1904,1507,1400,63,63,0,30138144.81
DRAYSON.BOWMAN,20092010,CAR,108.21666666666667,2,0,0,0,2,2,0,0,0,17,34,13,10,1,2,113,99,88,92,3,3,0,30138025.009999998
DREW.DOUGHTY,20092010,L.A,2211.5166666666664,19,23,21,44,63,42,0,0,0,155,344,169,107,21,29,2156,1656,1286,1193,58,46,0,30138144.735
DREW.LARMAN,20092010,BOS,32.333333333333336,0,0,0,0,0,0,1,2,1,5,9,3,2,0,0,37,11,37,11,0,1,0.5,30138014.79
DREW.MILLER,20092010,DET,989.7,11,3,7,10,21,14,17,47,30,106,156,115,22,15,7,748,952,674,664,25,19,0.3617021276595745,30138091.555
DREW.MILLER,20092010,T.B,171.2,0,0,0,0,0,0,0,2,2,10,20,7,7,4,1,101,118,89,80,0,3,0,30138022.29
DREW.STAFFORD,20092010,BUF,1069.7833333333333,14,15,5,20,34,29,43,89,46,188,286,63,47,13,19,1105,888,782,782,38,33,0.48314606741573035,30138113.125
DUNCAN.KEITH,20092010,CHI,2801.35,16,31,37,68,84,47,0,0,0,274,588,65,198,15,29,2908,2347,2130,1656,103,89,0,30138160.975
DUSTIN.BOYD,20092010,CGY,734.4,8,7,4,11,19,15,183,368,185,79,124,61,21,11,7,621,702,550,561,18,15,0.49728260869565216,30138088.08
DUSTIN.BOYD,20092010,NSH,247.58333333333331,3,1,1,2,5,4,70,121,51,36,55,24,8,3,2,216,207,208,186,5,5,0.5785123966942148,30138037.255
DUSTIN.BROWN,20092010,L.A,1692.1833333333334,25,24,11,35,60,49,18,44,26,263,476,319,94,78,22,1626,1374,1008,1077,39,49,0.4090909090909091,30138156.075
DUSTIN.BYFUGLIEN,20092010,CHI,1704.3,28,8,14,22,50,36,2,5,3,255,434,314,77,22,45,1886,1179,1320,1068,46,53,0.4,30138135.65
DUSTIN.JEFFREY,20092010,PIT,8.583333333333334,0,0,0,0,0,0,0,0,0,0,0,1,0,0,0,4,12,4,12,0,0,0,15069009.1
DUSTIN.KOHN,20092010,NYI,255.08333333333331,0,2,2,4,4,2,0,0,0,7,20,23,10,1,2,203,235,197,214,8,10,0,30138036.46
DUSTIN.PENNER,20092010,EDM,1507.0166666666669,32,17,14,31,63,49,201,420,219,203,353,55,67,19,18,1513,1302,1002,1005,55,44,0.4785714285714286,30138152.130000003
DWIGHT.HELMINEN,20092010,S.J,74.06666666666666,2,0,0,0,2,2,2,8,6,6,12,10,4,1,2,48,65,47,60,2,3,0.25,30138023.04
DYLAN.REESE,20092010,NYI,285.7833333333333,2,1,1,2,4,3,0,0,0,16,30,7,10,1,6,246,308,229,232,13,10,0,30138038.634999998
ED.JOVANOVSKI,20092010,ARI,1572.8666666666668,11,14,10,24,35,25,0,1,1,125,250,125,76,10,24,1371,1601,898,1021,39,51,0,30138132.15
ENVER.LISIN,20092010,NYR,637.3666666666667,6,3,5,8,14,9,2,3,1,91,176,56,42,11,8,626,547,553,527,21,22,0.6666666666666666,30138069.064999998
ERIC.BELANGER,20092010,MIN,945.1666666666667,13,16,5,21,34,29,415,721,306,120,191,36,41,16,14,872,785,575,570,25,21,0.5755894590846047,30138099.535
ERIC.BELANGER,20092010,WSH,347.91666666666663,2,3,2,5,7,5,181,316,135,37,78,13,18,2,4,355,339,306,252,8,5,0.5727848101265823,30138044.21
ERIC.BOULTON,20092010,ATL,424.66666666666663,2,4,2,6,8,6,2,4,2,39,60,96,13,25,30,328,382,322,378,14,15,0.5,30138062.08
ERIC.BREWER,20092010,STL,1265.25,8,3,3,6,14,11,0,0,0,84,184,76,59,16,20,1014,1243,832,859,32,47,0,30138103.435
ERIC.FEHR,20092010,WSH,916.6833333333334,24,10,9,19,43,34,1,2,1,165,288,46,63,22,14,1006,772,779,720,46,25,0.5,30138101.284999996
ERIC.GODARD,20092010,PIT,188.31666666666666,1,1,1,2,3,2,1,1,0,17,30,30,6,11,21,141,166,133,163,7,5,1,30138036.275
ERIC.NYSTROM,20092010,CGY,1080.4833333333336,11,2,6,8,19,13,127,279,152,91,183,117,47,20,16,793,1091,727,784,26,30,0.4551971326164875,30138108.03
ERIC.STAAL,20092010,CAR,1427.3333333333335,29,25,16,41,70,54,479,1146,667,274,500,74,119,24,26,1613,1325,1004,1024,48,40,0.4179755671902269,30138175
ERIC.TANGRADI,20092010,PIT,13.816666666666666,0,0,0,0,0,0,0,0,0,3,6,3,3,1,0,19,5,15,5,0,0,0,15069007.21
ERIK.CHRISTENSEN,20092010,ANA,103.03333333333333,0,0,0,0,0,0,21,51,30,9,19,6,7,1,1,81,79,51,67,0,3,0.4117647058823529,30138023.35
ERIK.CHRISTENSEN,20092010,NYR,756.9,8,8,10,18,26,16,308,621,313,77,153,46,38,8,12,711,639,556,581,30,17,0.49597423510466987,30138093.200000003
ERIK.COLE,20092010,CAR,655.6,11,4,1,5,16,15,4,15,11,81,147,94,29,18,14,617,683,449,550,17,25,0.26666666666666666,30138084.965
ERIK.JOHNSON,20092010,STL,1693.9166666666665,10,12,17,29,39,22,0,0,0,186,383,70,130,18,32,1801,1310,1187,1077,53,48,0,30138118.905
ERIK.KARLSSON,20092010,OTT,1361.9666666666667,6,11,14,25,31,17,0,0,0,123,274,50,100,18,14,1424,989,1017,862,33,47,0,30138093.23
ETHAN.MOREAU,20092010,EDM,1094.8666666666668,9,5,4,9,18,14,7,17,10,143,241,98,43,10,24,764,1397,711,1028,23,42,0.4117647058823529,30138144.38
EVAN.OBERG,20092010,VAN,12.566666666666666,0,0,0,0,0,0,0,0,0,0,1,0,1,0,0,10,15,10,15,0,0,0,15069009.1
EVANDER.KANE,20092010,ATL,923.55,14,8,4,12,26,22,14,26,12,128,216,97,44,38,27,777,898,700,746,40,41,0.5384615384615384,30138105.09
EVGENI.MALKIN,20092010,PIT,1659.9,32,34,20,54,86,66,238,585,347,323,571,75,129,48,51,2044,1295,1164,1075,53,62,0.40683760683760684,30138172.6
EVGENY.ARTYUKHIN,20092010,ANA,335.4666666666667,4,2,3,5,9,6,0,1,1,21,44,90,9,6,18,235,298,217,287,10,8,0,30138052.335
EVGENY.ARTYUKHIN,20092010,ATL,146.93333333333334,5,1,1,2,7,6,1,1,0,21,38,37,6,4,10,123,127,121,125,7,11,1,30138032.455
EVGENY.DADONOV,20092010,FLA,52.9,0,0,0,0,0,0,0,0,0,4,7,3,2,1,0,40,36,34,33,0,1,0,30138018.16
FABIAN.BRUNNSTROM,20092010,DAL,469.4,2,6,3,9,11,8,1,3,2,37,64,44,14,5,6,376,398,308,379,13,15,0.3333333333333333,30138060.215
FEDOR.TYUTIN,20092010,CBJ,1859.8333333333335,6,11,15,26,32,17,1,3,2,147,299,82,95,11,22,1596,1543,982,1046,49,54,0.3333333333333333,30138123.425
FERNANDO.PISANI,20092010,EDM,583.45,4,3,1,4,8,7,3,16,13,54,93,58,23,4,4,401,737,365,536,13,29,0.1875,30138080.235
FILIP.KUBA,20092010,OTT,1211.05,3,18,6,24,27,21,0,1,1,90,174,27,53,1,14,1179,1053,779,695,36,44,0,30138086.06
FRANCIS.BOUILLON,20092010,NSH,1681.2666666666667,3,6,2,8,11,9,0,0,0,89,216,178,82,18,28,1410,1537,1143,1276,37,38,0,30138145.78
FRANCIS.WATHIER,20092010,DAL,26.483333333333334,0,0,0,0,0,0,1,1,0,4,6,2,1,1,1,12,30,12,30,0,0,1,30138019.1
FRANCOIS.BEAUCHEMIN,20092010,TOR,2088.116666666667,5,6,13,19,24,11,3,4,1,170,377,88,123,22,15,2159,1981,1568,1369,47,58,0.75,30138135.215
FRANS.NIELSEN,20092010,NYI,1294.3666666666668,11,18,7,25,36,29,579,1157,578,133,244,39,54,8,4,1325,1145,829,766,31,32,0.5004321521175453,30138124.265
FRAZER.MCLAREN,20092010,S.J,138.91666666666669,1,4,1,5,6,5,0,0,0,13,19,27,1,11,11,111,130,109,123,8,2,0,30138032.035
FREDDY.MEYER,20092010,NYI,1073.0666666666666,4,5,6,11,15,9,0,0,0,56,118,178,39,14,20,929,1095,847,823,35,38,0,30138096.939999998
FREDRIK.MODIN,20092010,CBJ,352.2,2,3,1,4,6,5,7,12,5,35,68,17,17,3,6,267,307,223,229,4,8,0.5833333333333334,30138041.035
FREDRIK.MODIN,20092010,L.A,402.26666666666665,6,2,1,3,9,8,17,28,11,45,85,15,19,5,8,333,368,226,278,6,11,0.6071428571428571,30138050.905
FREDRIK.SJOSTROM,20092010,CGY,438.0333333333333,1,4,1,5,6,5,0,2,2,33,62,44,16,6,4,327,402,318,323,10,8,0,30138049.035
FREDRIK.SJOSTROM,20092010,TOR,263.3666666666667,2,3,0,3,5,5,0,5,5,31,48,31,10,2,2,196,249,178,186,5,11,0,30138036.92
GARNET.EXELBY,20092010,TOR,514.9166666666666,1,1,2,3,4,2,0,0,0,14,51,87,23,18,25,457,551,436,411,14,23,0,30138055.33
GEORGE.PARROS,20092010,ANA,342.06666666666666,4,0,0,0,4,4,1,7,6,25,34,71,2,32,29,236,326,225,319,8,5,0.14285714285714285,30138059.11
GEORGES.LARAQUE,20092010,MTL,161.45,1,0,2,2,3,1,0,0,0,2,8,21,3,6,7,91,191,89,187,3,9,0,30138039.759999998
GILBERT.BRULE,20092010,EDM,924.7166666666667,17,10,10,20,37,27,143,273,130,121,195,115,37,16,17,824,829,679,784,38,42,0.5238095238095238,30138119.380000003
GLEN.METROPOLIT,20092010,MTL,1043.5,16,8,7,15,31,24,354,726,372,128,198,38,37,11,15,1003,922,725,794,24,27,0.48760330578512395,30138128.645
GRANT.CLITSOME,20092010,CBJ,162.15,1,1,1,2,3,2,0,0,0,7,22,30,11,0,4,135,127,117,112,10,10,0,30138025.075
GREG.MAULDIN,20092010,NYI,10.033333333333333,0,0,0,0,0,0,8,11,3,2,3,1,0,1,0,11,10,11,10,0,1,0.7272727272727273,15069008.63
GREG.MOORE,20092010,CBJ,23.6,0,0,0,0,0,0,4,8,4,2,3,2,1,2,0,15,29,15,25,0,0,0.5,30138018.130000003
GREG.ZANON,20092010,MIN,1811.8833333333332,2,5,5,10,12,7,0,1,1,59,146,182,58,11,17,1277,1741,1121,1259,45,55,0,30138142.535
GREGORY.CAMPBELL,20092010,FLA,923.8333333333333,2,6,7,13,15,8,158,341,183,84,140,158,24,22,16,623,1191,568,782,19,28,0.4633431085043988,30138117.064999998
GREGORY.STEWART,20092010,MTL,20.96666666666667,0,0,0,0,0,0,0,1,1,4,5,4,1,2,4,25,24,25,24,0,3,0,30138018.07
GUILLAUME.DESBIENS,20092010,VAN,9.416666666666666,0,0,0,0,0,0,0,0,0,0,0,1,0,0,1,3,4,3,4,0,0,0,15069008.1
GUILLAUME.LATENDRESSE,20092010,MIN,905.2666666666667,25,12,0,12,37,37,1,9,8,133,224,110,41,10,6,863,777,630,692,32,28,0.1111111111111111,30138108.49
GUILLAUME.LATENDRESSE,20092010,MTL,261.06666666666666,2,1,0,1,3,3,0,0,0,26,77,47,27,5,2,265,206,206,189,4,8,0,30138032
GUILLAUME.LEFEBVRE,20092010,BOS,11.016666666666667,0,0,0,0,0,0,0,0,0,0,1,2,0,0,0,9,9,9,9,0,0,0,15069008.4
HAL.GILL,20092010,MTL,1605.6833333333334,2,4,4,8,10,6,0,1,1,49,134,94,62,7,40,1111,1877,1005,1284,35,47,0,30138155.270000003
HENRIK.SEDIN,20092010,VAN,1862.1833333333334,32,50,43,93,125,82,908,1785,877,189,297,17,62,29,27,2151,1385,1429,1106,97,54,0.5086834733893557,30138187.285
HENRIK.TALLINDER,20092010,BUF,1826.35,4,9,8,17,21,13,0,0,0,55,141,72,54,8,17,1449,1887,1288,1291,68,57,0,30138139.68
HENRIK.ZETTERBERG,20092010,DET,1730.05,30,28,27,55,85,58,631,1288,657,354,613,62,120,28,17,2083,1314,1319,1027,66,57,0.48990683229813664,30138160.695
IAN.LAPERRIERE,20092010,PHI,1147.1833333333334,3,10,8,18,21,13,31,71,40,56,110,195,27,38,41,683,1246,628,781,25,34,0.43661971830985913,30138112.17
IAN.WHITE,20092010,CGY,559.3333333333333,4,5,3,8,12,9,0,0,0,43,91,13,27,2,6,543,432,388,378,21,17,0,30138053.945
IAN.WHITE,20092010,TOR,1332.1499999999999,9,8,7,15,24,17,0,0,0,130,291,41,106,6,16,1467,1247,1203,945,49,41,0,30138093.535
ILKKA.HEIKKINEN,20092010,NYR,62.016666666666666,0,0,0,0,0,0,0,0,0,4,9,9,3,2,0,62,71,62,63,2,0,0,30138020.82
ILKKA.PIKKARAINEN,20092010,N.J,252.48333333333335,1,3,0,3,4,4,1,6,5,26,43,50,14,2,5,170,198,158,194,5,7,0.16666666666666666,30138038.009999998
ILYA.KOVALCHUK,20092010,ATL,1089.5666666666666,31,17,10,27,58,48,5,23,18,179,359,13,100,20,13,1065,811,609,686,39,33,0.21739130434782608,30138110.35
ILYA.KOVALCHUK,20092010,N.J,703.2666666666667,12,14,7,21,33,26,3,9,6,130,250,25,69,17,8,782,434,445,371,24,14,0.3333333333333333,30138059.215
IVAN.VISHNEVSKIY,20092010,DAL,33.28333333333333,0,0,0,0,0,0,0,0,0,4,6,0,1,0,0,33,33,18,28,0,1,0,30138018.35
J-F.JACQUES,20092010,EDM,548.6166666666667,4,2,4,6,10,6,2,5,3,49,80,158,15,17,19,400,582,382,557,18,30,0.4,30138084.299999997
J-P.DUMONT,20092010,NSH,1178.9333333333334,19,22,8,30,49,41,0,0,0,119,220,25,55,8,11,1212,914,880,851,46,33,0,30138117.18
JACK.HILLEN,20092010,NYI,1404.3666666666666,3,9,8,17,20,12,1,1,0,77,165,37,57,13,22,1223,1496,932,1077,41,45,1,30138130.17
JACK.JOHNSON,20092010,L.A,1951.1666666666667,8,15,19,34,42,23,0,0,0,145,354,154,119,16,26,1845,1738,1286,1348,56,76,0,30138153.235
JACK.SKILLE,20092010,CHI,45.96666666666667,1,0,1,1,2,1,0,0,0,9,13,12,2,1,0,45,24,45,24,2,5,0,30138016.985
JACOB.DOWELL,20092010,CHI,12.616666666666665,0,0,0,0,0,0,0,1,1,3,3,3,0,1,1,14,13,14,8,0,0,0,15069008.36
JAIME.SIFERS,20092010,MIN,181.83333333333331,0,0,0,0,0,0,0,0,0,9,17,19,5,0,3,131,171,120,154,7,6,0,30138031.2
JAKE.DOWELL,20092010,CHI,8.2,1,1,0,1,2,2,2,3,1,1,1,2,0,0,0,10,2,9,2,2,1,0.6666666666666666,15069008.38
JAKUB.KINDL,20092010,DET,32.483333333333334,0,0,0,0,0,0,0,0,0,1,3,0,0,0,0,17,30,15,28,0,2,0,30138018.5
JAKUB.VORACEK,20092010,CBJ,1251.4,15,21,13,34,49,36,2,6,4,151,268,62,67,18,13,1197,979,842,850,47,50,0.3333333333333333,30138116.185
JAMAL.MAYERS,20092010,CGY,248.13333333333333,1,2,3,5,6,3,64,115,51,28,45,34,9,10,12,197,224,190,198,7,6,0.5565217391304348,30138040.035
JAMAL.MAYERS,20092010,TOR,392.01666666666665,2,5,1,6,8,7,150,263,113,47,76,35,8,16,27,269,435,254,352,9,14,0.5703422053231939,30138067.485
JAMES.NEAL,20092010,DAL,1403.5333333333333,27,18,10,28,55,45,19,59,40,198,343,173,71,36,25,1423,1260,930,1030,51,55,0.3220338983050847,30138150.07
JAMES.SHEPPARD,20092010,MIN,767.3666666666667,2,2,2,4,6,4,154,342,188,64,117,87,21,19,12,607,759,550,664,20,33,0.4502923976608187,30138096.65
JAMES.VAN RIEMSDYK,20092010,PHI,1260.7833333333333,18,11,11,22,40,29,0,4,4,214,353,58,72,9,17,1387,1036,1121,980,45,47,0,30138121.415
JAMES.VANDERMEER,20092010,ARI,1095.7166666666667,4,4,2,6,10,8,0,0,0,64,145,158,55,11,23,898,1028,827,744,33,31,0,30138083.96
JAMES.WISNIEWSKI,20092010,ANA,1679.9333333333334,3,9,18,27,30,12,0,0,0,146,288,129,80,25,21,1518,1640,1075,1044,41,45,0,30138118.8
JAMES.WRIGHT,20092010,T.B,559.15,2,3,0,3,5,5,77,169,92,25,47,51,9,8,6,302,555,287,389,9,18,0.4556213017751479,30138065.41
JAMES.WYMAN,20092010,MTL,13.166666666666668,0,0,0,0,0,0,0,1,1,0,1,2,0,0,0,5,17,5,14,0,2,0,30138016.9
JAMIE.BENN,20092010,DAL,1188.3833333333332,22,7,11,18,40,29,109,236,127,180,311,183,66,28,17,1234,942,882,860,39,37,0.461864406779661,30138121.314999998
JAMIE.LANGENBRUNNER,20092010,N.J,1676.2166666666667,19,20,20,40,59,39,31,68,37,237,407,115,91,18,22,1624,1259,1087,962,46,42,0.45588235294117646,30138127.07
JAMIE.LUNDMARK,20092010,CGY,322.8666666666667,4,4,1,5,9,8,30,62,32,36,55,8,8,0,2,354,234,280,224,9,14,0.4838709677419355,30138040.525
JAMIE.LUNDMARK,20092010,TOR,173.58333333333331,1,1,1,2,3,2,15,30,15,16,26,7,5,3,7,156,144,134,133,2,5,0.5,30138031.005
JAMIE.MCBAIN,20092010,CAR,360.91666666666663,3,3,3,6,9,6,0,0,0,29,60,6,22,3,0,373,392,242,282,14,8,0,30138045.255
JAMIE.MCGINN,20092010,S.J,706.1666666666667,10,1,2,3,13,11,10,21,11,87,151,115,26,14,17,605,639,564,574,21,23,0.47619047619047616,30138081.04
JAN.HEJDA,20092010,CBJ,1259.6166666666668,3,3,6,9,12,6,1,2,1,63,121,109,35,12,17,833,1384,736,927,24,48,0.5,30138118.46
JANNIK.HANSEN,20092010,VAN,700.7,10,2,6,8,18,12,7,19,12,79,130,69,26,8,10,559,640,495,475,20,23,0.3684210526315789,30138069.21
JARED.BOLL,20092010,CBJ,480.18333333333334,4,1,2,3,7,5,0,3,3,52,82,121,12,43,36,350,388,338,377,10,17,0,30138063.43
JARED.COWEN,20092010,OTT,6.766666666666667,0,0,0,0,0,0,0,0,0,0,0,0,0,0,1,2,4,2,4,0,0,0,15069008.15
JARED.ROSS,20092010,PHI,39.78333333333334,0,0,0,0,0,0,8,14,6,6,12,4,5,1,0,38,18,38,18,0,1,0.5714285714285714,30138015.58
JARKKO.RUUTU,20092010,OTT,1204.7333333333333,14,11,3,14,28,25,5,25,20,120,188,166,35,28,47,895,1129,835,829,41,46,0.2,30138116.555
JAROME.IGINLA,20092010,CGY,1689.3333333333333,32,21,16,37,69,53,152,323,171,258,500,86,139,37,20,1823,1363,1198,1224,49,51,0.47058823529411764,30138168.950000003
JAROSLAV.SPACEK,20092010,MTL,1796.1999999999998,4,8,13,21,25,12,0,0,0,106,276,65,107,18,27,1747,1725,1309,1416,59,54,0,30138154.755
JARRET.STOLL,20092010,L.A,1366.0333333333333,17,20,11,31,48,37,670,1202,532,171,298,213,57,16,20,1271,1093,781,779,36,28,0.5574043261231281,30138134.185
JASON.ARNOTT,20092010,NSH,1285.0333333333333,21,14,13,27,48,35,581,1191,610,242,370,34,58,14,13,1436,972,942,877,47,43,0.4878253568429891,30138145.955
JASON.BLAKE,20092010,ANA,416.9666666666667,6,6,2,8,14,12,12,28,16,69,101,34,14,8,5,412,327,290,276,11,13,0.42857142857142855,30138050.76
JASON.BLAKE,20092010,TOR,886.9333333333333,10,9,7,16,26,19,19,53,34,170,286,36,66,12,12,1058,813,845,693,27,28,0.3584905660377358,30138087.155
JASON.CHIMERA,20092010,CBJ,576.3666666666667,8,4,5,9,17,12,15,23,8,92,122,28,13,6,13,429,520,381,408,20,26,0.6521739130434783,30138067.235
JASON.CHIMERA,20092010,WSH,574,8,4,8,12,20,12,7,20,13,83,133,59,22,11,14,542,536,490,468,27,17,0.35,30138068.689999998
JASON.DEMERS,20092010,S.J,954.4166666666666,5,9,12,21,26,14,0,0,0,64,143,53,48,9,13,971,746,641,627,32,24,0,30138079.59
JASON.GARRISON,20092010,FLA,590.2166666666667,2,4,2,6,8,6,0,0,0,24,54,37,17,4,10,439,629,388,512,22,18,0,30138073.04
JASON.JAFFRAY,20092010,CGY,19.966666666666665,0,0,0,0,0,0,5,14,9,4,5,4,0,0,0,17,17,17,17,0,1,0.35714285714285715,30138017.299999997
JASON.POMINVILLE,20092010,BUF,1658.0833333333335,26,22,18,40,66,48,43,124,81,268,455,60,106,24,12,1801,1432,1108,1039,50,39,0.3467741935483871,30138142.759999998
JASON.SPEZZA,20092010,OTT,1280.35,24,26,14,40,64,50,564,1116,552,189,354,29,87,19,12,1374,1086,863,896,44,42,0.5053763440860215,30138152.15
JASON.STRUDWICK,20092010,EDM,1219.4333333333334,0,3,3,6,6,3,0,0,0,19,59,58,24,21,17,790,1547,724,1128,36,53,0,30138144.585
JASON.WILLIAMS,20092010,DET,619.95,6,8,1,9,15,14,31,61,30,99,175,34,40,7,4,699,406,474,373,11,18,0.5081967213114754,30138055.085
JAY.BEAGLE,20092010,WSH,64.85,1,1,0,1,2,2,17,31,14,10,15,11,3,1,1,62,71,60,71,2,3,0.5483870967741935,30138024.34
JAY.BOUWMEESTER,20092010,CGY,2125.45,3,16,10,26,29,19,0,0,0,130,295,73,91,7,24,1773,1992,1237,1294,42,54,0,30138149.12
JAY.HARRISON,20092010,CAR,547.1166666666666,1,1,3,4,5,2,0,0,0,30,68,66,24,8,17,436,552,401,435,13,20,0,30138060.255000003
JAY.LEACH,20092010,MTL,91.26666666666667,0,0,0,0,0,0,0,0,0,4,4,3,0,1,1,55,112,50,85,2,2,0,30138025.310000002
JAY.LEACH,20092010,S.J,412.7833333333333,1,1,0,1,2,2,0,0,0,23,44,16,16,6,7,354,364,322,299,15,15,0,30138042.61
JAY.MCCLEMENT,20092010,STL,1370.6666666666667,11,13,5,18,29,24,699,1410,711,108,179,66,38,9,11,898,1563,794,921,38,36,0.4957446808510638,30138152.975
JAY.MCKEE,20092010,PIT,1016,1,4,5,9,10,5,0,1,1,43,94,63,35,8,17,857,1135,799,808,40,37,0,30138093.104999997
JAY.PANDOLFO,20092010,N.J,723.8,4,3,2,5,9,7,5,12,7,71,115,32,25,6,3,445,674,417,500,15,27,0.4166666666666667,30138072.11
JAY.ROSEHILL,20092010,TOR,93.55,1,0,1,1,2,1,1,3,2,6,8,31,2,10,17,55,112,54,107,3,5,0.3333333333333333,30138031.415
JED.ORTMEYER,20092010,S.J,891.1166666666667,8,7,5,12,20,15,5,18,13,127,203,119,33,20,17,709,839,647,636,23,25,0.2777777777777778,30138089.175
JEFF.CARTER,20092010,PHI,1643.75,38,13,17,30,68,51,754,1442,688,370,673,86,148,16,19,1929,1492,1205,1127,44,48,0.5228848821081831,30138178.395
JEFF.FINGER,20092010,TOR,537.7333333333333,2,4,3,7,9,6,0,0,0,29,68,77,21,7,7,430,622,397,480,17,27,0,30138067.845
JEFF.HALPERN,20092010,L.A,232.10000000000002,0,1,1,2,2,1,63,133,70,7,19,14,5,0,8,147,205,129,142,4,5,0.47368421052631576,30138033.545
JEFF.HALPERN,20092010,T.B,860.5333333333333,9,5,2,7,16,14,249,479,230,65,101,34,15,12,12,614,801,473,525,15,26,0.5198329853862212,30138088.979999997
JEFF.HOGGAN,20092010,ARI,28.450000000000003,0,0,0,0,0,0,0,2,2,5,9,2,2,1,1,24,23,20,18,0,1,0,30138016.91
JEFF.SCHULTZ,20092010,WSH,1588.2166666666667,3,5,14,19,22,8,0,0,0,47,120,75,53,5,18,1560,1609,1420,1166,83,37,0,30138109.5
JEFF.TAFFE,20092010,FLA,176.81666666666666,1,1,0,1,2,2,33,74,41,18,27,27,7,3,2,120,187,111,172,4,4,0.44594594594594594,30138037.8
JEFF.TAMBELLINI,20092010,NYI,412.98333333333335,7,5,2,7,14,12,0,4,4,54,88,47,19,4,8,335,437,280,383,11,17,0,30138065.89
JEFF.WOYWITKA,20092010,DAL,497.41666666666663,0,0,2,2,2,0,0,0,0,43,87,27,27,3,4,454,495,427,459,12,19,0,30138059.58
JEFFREY.PENNER,20092010,BOS,28.033333333333335,0,0,0,0,0,0,0,0,0,1,1,4,0,0,0,23,27,19,19,1,1,0,15069009.3
JERE.LEHTINEN,20092010,DAL,835.8166666666666,4,6,5,11,15,10,1,9,8,86,149,43,31,14,4,700,796,597,547,19,26,0.1111111111111111,30138071.605
JEROME.SAMSON,20092010,CAR,59.13333333333333,0,2,0,2,2,2,0,1,1,17,20,2,0,1,4,56,60,55,57,2,3,0,30138023.11
JERRED.SMITHSON,20092010,NSH,1057.6833333333334,10,3,1,4,14,13,330,595,265,59,118,94,26,11,19,728,1032,676,726,26,35,0.5546218487394958,30138106.884999998
JESSE.JOENSUU,20092010,NYI,122.73333333333333,1,0,0,0,1,1,0,1,1,13,22,10,4,3,3,136,105,122,99,5,1,0,30138024.28
JESSE.WINCHESTER,20092010,OTT,579.05,2,7,4,11,13,9,226,404,178,89,143,103,27,5,8,524,496,481,380,15,21,0.5594059405940595,30138059.54
JIM.SLATER,20092010,ATL,744.55,11,5,2,7,18,16,254,431,177,107,172,105,32,24,24,592,829,548,628,26,26,0.5893271461716937,30138099.2
JIRI.TLUSTY,20092010,CAR,226.55,1,1,4,5,6,2,2,2,0,15,41,9,12,2,3,192,224,170,209,8,4,1,30138037.6
JIRI.TLUSTY,20092010,TOR,24.433333333333334,0,0,0,0,0,0,0,0,0,2,5,1,2,0,0,31,26,28,26,0,2,0,15069009.8
JOCHEN.HECHT,20092010,BUF,1358.3166666666666,21,10,11,21,42,31,145,321,176,223,339,46,57,14,16,1265,1322,1045,956,53,43,0.4517133956386293,30138131.715
JODY.SHELLEY,20092010,NYR,149.28333333333333,2,3,1,4,6,5,0,1,1,29,39,36,3,5,10,129,119,122,113,7,4,0,30138030.525
JODY.SHELLEY,20092010,S.J,229.10000000000002,0,3,0,3,3,3,2,5,3,19,35,59,5,14,20,162,181,158,179,6,5,0.4,30138038.17
JOE.CALLAHAN,20092010,S.J,9.566666666666666,0,1,0,1,1,1,0,0,0,0,0,1,0,0,0,3,13,3,13,1,0,0,15069009.7
JOE.CORVO,20092010,CAR,828.45,4,1,5,6,10,5,0,0,0,75,170,19,57,5,5,899,683,533,426,18,20,0,30138049.275
JOE.CORVO,20092010,WSH,472.4,3,3,2,5,8,6,0,0,0,44,100,17,42,2,3,535,409,420,345,13,17,0,30138044.07
JOE.PAVELSKI,20092010,S.J,1608.85,34,23,10,33,67,57,587,1034,447,292,504,82,113,26,16,1879,1497,1188,1025,49,43,0.5676982591876208,30138155.990000002
JOE.THORNTON,20092010,S.J,1869.4666666666667,23,50,27,77,100,73,796,1474,678,175,292,136,62,35,29,2193,1532,1316,1258,73,62,0.5400271370420624,30138202.665
JOEL.PERRAULT,20092010,ARI,19.816666666666666,1,0,0,0,1,1,10,25,15,7,8,4,1,2,0,23,20,19,19,1,2,0.4,15069010.82
JOEL.RECHLICZ,20092010,NYI,16.133333333333333,0,0,0,0,0,0,0,0,0,1,1,3,0,3,5,11,15,11,15,0,2,0,30138017.53
JOEL.WARD,20092010,NSH,1365.0333333333333,15,16,7,23,38,31,35,93,58,146,266,51,53,24,10,1084,1233,843,878,33,39,0.3763440860215054,30138123.065
JOFFREY.LUPUL,20092010,ANA,366.81666666666666,10,4,0,4,14,14,1,5,4,66,106,31,23,8,9,354,317,247,267,15,11,0.2,30138051.12
JOHAN.FRANZEN,20092010,DET,715.8666666666667,16,11,12,23,39,27,18,38,20,139,219,72,45,10,19,889,476,584,424,32,25,0.47368421052631576,30138066.72
JOHAN.MOTIN,20092010,EDM,14.133333333333333,0,0,0,0,0,0,0,0,0,0,0,2,0,0,0,8,23,7,19,0,0,0,15069010
JOHN-MICHAEL.LILES,20092010,COL,1203.5166666666667,7,16,9,25,32,23,0,0,0,109,203,46,66,14,17,1123,1030,699,882,35,32,0,30138119.715
JOHN.CARLSON,20092010,WSH,477.0833333333333,2,0,8,8,10,2,0,0,0,35,81,34,25,4,4,514,457,468,387,27,13,0,30138046.240000002
JOHN.ERSKINE,20092010,WSH,798.9333333333334,1,3,1,4,5,4,0,0,0,50,108,109,40,11,23,743,793,705,679,37,21,0,30138078.535
JOHN.MADDEN,20092010,CHI,1472.1833333333334,11,8,6,14,25,19,734,1390,656,151,241,72,44,14,7,1129,1481,1014,986,38,48,0.5280575539568345,30138146.65
JOHN.MCCARTHY,20092010,S.J,36.516666666666666,0,0,0,0,0,0,0,0,0,3,5,4,1,0,0,29,33,28,33,0,3,0,30138018.55
JOHN.MITCHELL,20092010,TOR,949.4333333333334,6,6,11,17,23,12,243,476,233,90,177,87,44,14,10,937,884,721,654,20,29,0.5105042016806722,30138091.135
JOHN.SCOTT,20092010,MIN,438.76666666666665,1,1,0,1,2,2,0,0,0,22,52,62,21,15,28,374,369,362,352,14,18,0,30138051.15
JOHN.TAVARES,20092010,NYI,1459.0833333333335,24,19,11,30,54,43,526,1111,585,184,340,41,84,20,10,1629,1186,966,1036,42,51,0.4734473447344735,30138166.165
JOHNNY.BOYCHUK,20092010,BOS,1240.7666666666667,7,4,10,14,21,11,0,0,0,128,275,120,84,8,12,1213,990,980,791,35,30,0,30138082.93
JOHNNY.ODUYA,20092010,ATL,577.4166666666667,1,4,2,6,7,5,0,0,0,24,55,29,17,5,6,412,651,333,433,21,15,0,30138062.799999997
JOHNNY.ODUYA,20092010,N.J,846.8499999999999,2,1,1,2,4,3,0,0,0,44,97,33,31,2,9,764,710,633,560,29,28,0,30138063.945
JON.KALINSKI,20092010,PHI,69.56666666666666,0,2,0,2,2,2,11,30,19,9,16,11,5,0,0,60,47,59,47,2,4,0.36666666666666664,30138020.44
JON.SIM,20092010,NYI,882.6833333333334,13,3,6,9,22,16,9,18,9,128,188,118,28,30,18,754,899,680,836,28,32,0.5,30138118.96
JONAS.JUNLAND,20092010,STL,51.53333333333333,0,1,1,2,2,1,0,0,0,7,10,2,1,0,0,81,37,51,34,1,4,0,30138018.225
JONATHAN.CHEECHOO,20092010,OTT,735.7333333333333,5,3,6,9,14,8,4,10,6,117,195,79,46,16,10,747,553,647,532,23,35,0.4,30138065.47
JONATHAN.ERICSSON,20092010,DET,1207.1833333333334,4,2,8,10,14,6,0,0,0,66,164,105,59,7,23,1014,1090,929,840,36,52,0,30138091.619999997
JONATHAN.TOEWS,20092010,CHI,1982.1333333333332,32,43,21,64,96,75,1076,1854,778,260,390,81,54,39,24,2233,1393,1472,1027,76,56,0.5803667745415318,30138168.705
JONI.PITKANEN,20092010,CAR,1943.65,6,24,16,40,46,30,0,0,0,160,358,66,117,14,36,2000,1800,1316,1360,56,58,0,30138159.39
JORDAN.HENDRY,20092010,CHI,631.75,2,1,5,6,8,3,0,0,0,50,102,49,31,8,5,586,483,559,458,25,24,0,30138053.005
JORDAN.LEOPOLD,20092010,FLA,1367.6166666666668,7,5,5,10,17,12,0,0,0,69,153,59,53,8,11,1047,1531,844,1055,39,41,0,30138130.455
JORDAN.LEOPOLD,20092010,PIT,541.0999999999999,4,2,2,4,8,6,0,0,0,32,72,16,23,3,4,545,438,442,321,16,14,0,30138041.48
JORDAN.STAAL,20092010,PIT,1772.8833333333334,24,21,9,30,54,45,711,1475,764,223,383,144,85,32,25,1684,1593,1224,1027,55,44,0.48203389830508475,30138162.185
JORDIN.TOOTOO,20092010,NSH,600.6666666666667,6,8,3,11,17,14,2,8,6,106,190,83,32,28,15,613,527,587,516,20,19,0.25,30138072.185000002
JOSH.BAILEY,20092010,NYI,1089.7,15,7,11,18,33,22,171,425,254,110,201,67,47,13,11,1077,1010,777,826,37,33,0.4023529411764706,30138120.895
JOSH.GORGES,20092010,MTL,2154.7,3,5,2,7,10,8,0,0,0,57,163,110,56,17,26,1616,2378,1312,1625,50,54,0,30138189.17
JOSH.HENNESSY,20092010,OTT,23.916666666666668,0,0,0,0,0,0,8,13,5,2,4,6,2,0,0,17,14,17,14,1,2,0.6153846153846154,30138016.07
JUSSI.JOKINEN,20092010,CAR,1344.9833333333333,30,22,13,35,65,52,136,265,129,157,282,55,61,21,16,1456,1109,923,944,44,36,0.5132075471698113,30138144.325
JUSTIN.ABDELKADER,20092010,DET,612.1500000000001,4,3,1,4,8,7,183,385,202,91,160,183,29,27,27,528,468,468,435,12,22,0.4753246753246753,30138072.365
JUSTIN.FALK,20092010,MIN,22.633333333333333,0,0,0,0,0,0,0,0,0,1,2,4,1,0,0,14,27,13,21,1,1,0,30138017.25
JUSTIN.MERCIER,20092010,COL,64.7,1,0,1,1,2,1,1,1,0,5,7,15,2,1,0,44,44,41,35,2,0,1,30138018.625
JUSTIN.WILLIAMS,20092010,L.A,836.6333333333333,10,10,10,20,30,20,4,12,8,144,242,40,44,13,14,923,600,698,512,25,25,0.3333333333333333,30138069.59
KAMIL.KREPS,20092010,FLA,965.8,5,5,4,9,14,10,382,736,354,83,147,80,38,8,9,651,1141,583,831,23,31,0.5190217391304348,30138127.36
KARL.ALZNER,20092010,WSH,359.5666666666667,0,2,2,4,4,2,0,0,0,16,39,15,14,1,4,318,354,289,289,14,16,0,30138042.36
KARLIS.SKRASTINS,20092010,DAL,1521.3166666666666,2,6,5,11,13,8,0,0,0,51,134,50,54,6,12,1108,1767,1013,1232,45,51,0,30138143.785
KASPARS.DAUGAVINS,20092010,OTT,8.433333333333334,0,0,0,0,0,0,0,0,0,2,2,2,0,0,0,8,6,8,6,0,0,0,15069008.1
KEATON.ELLERBY,20092010,FLA,119.35,0,0,0,0,0,0,0,0,0,5,18,12,8,0,1,91,93,89,93,5,6,0,30138022.95
KEITH.AUCOIN,20092010,WSH,79.18333333333334,1,1,3,4,5,2,31,56,25,4,8,2,3,0,0,87,75,67,74,4,6,0.5535714285714286,30138024.314999998
KEITH.BALLARD,20092010,FLA,1837.4,8,9,10,19,27,17,0,0,0,90,189,156,55,27,34,1431,2080,1082,1474,53,57,0,30138186.97
KEITH.TKACHUK,20092010,STL,904.4333333333334,13,15,4,19,32,28,389,695,306,120,194,98,30,16,29,970,696,598,624,27,32,0.5597122302158274,30138109.72
KEITH.YANDLE,20092010,ARI,1778.5,14,15,16,31,45,29,0,0,0,162,371,42,115,27,19,1875,1330,1349,1115,57,33,0,30138119.47
KENNDAL.MCARDLE,20092010,FLA,169,1,2,0,2,3,3,0,0,0,10,18,40,3,10,7,111,176,109,175,4,8,0,30138038.200000003
KENT.HUSKINS,20092010,S.J,1610.5833333333335,3,7,11,18,21,10,0,0,0,47,148,38,56,7,25,1335,1422,1149,1100,53,46,0,30138119.145000003
KEVIN.BIEKSA,20092010,VAN,1472.1166666666668,6,9,15,24,30,15,0,0,0,115,284,92,93,24,33,1424,1222,1051,890,46,45,0,30138096.315
KEVIN.KLEIN,20092010,NSH,1720.0833333333333,1,5,7,12,13,6,0,0,0,69,172,116,57,10,12,1282,1672,1160,1238,40,59,0,30138137.475
KEVIN.PORTER,20092010,ARI,29.45,0,0,0,0,0,0,5,15,10,3,5,2,1,1,0,23,26,22,26,0,0,0.3333333333333333,30138018.259999998
KEVIN.PORTER,20092010,COL,253.88333333333335,2,1,0,1,3,3,15,29,14,20,40,23,9,0,0,181,230,163,186,5,11,0.5172413793103449,30138036.15
KIM.JOHNSSON,20092010,CHI,131.23333333333332,1,2,0,2,3,3,0,0,0,10,26,12,7,0,2,150,84,107,70,10,4,0,30138020.2
KIM.JOHNSSON,20092010,MIN,1236,6,3,5,8,14,9,0,0,0,84,183,31,62,10,13,1073,1016,750,761,36,34,0,30138089.425
KIMMO.TIMONEN,20092010,PHI,2485.5666666666666,7,17,25,42,49,24,0,0,0,165,303,110,72,21,31,2445,2245,1495,1414,55,53,0,30138162.535
KIRK.MALTBY,20092010,DET,525.5666666666667,4,1,1,2,6,5,7,13,6,43,81,83,18,13,15,342,470,318,340,7,9,0.5384615384615384,30138054.535
KRIS.DRAPER,20092010,DET,1023.5666666666666,7,9,6,15,22,16,176,338,162,102,162,112,31,14,17,930,909,897,813,31,31,0.5207100591715976,30138107.23
KRIS.LETANG,20092010,PIT,1851.5333333333333,8,13,13,26,34,21,0,0,0,195,437,134,125,33,28,2086,1487,1508,1193,65,64,0,30138118.055
KRIS.NEWBURY,20092010,DET,34.733333333333334,1,0,0,0,1,1,7,18,11,3,3,9,0,0,2,22,28,22,28,1,0,0.3888888888888889,30138019.58
KRIS.RUSSELL,20092010,CBJ,1283.0833333333333,7,6,9,15,22,13,0,0,0,107,205,97,59,13,12,1147,992,836,840,38,32,0,30138100.805
KRIS.VERSTEEG,20092010,CHI,1621.1166666666668,26,19,13,32,58,45,90,215,125,239,392,60,97,31,23,1578,1283,1197,1037,50,49,0.4186046511627907,30138139.335
KRISTIAN.HUSELIUS,20092010,CBJ,1342.6999999999998,23,25,14,39,62,48,4,14,10,159,285,15,67,12,17,1298,1005,805,871,45,52,0.2857142857142857,30138130.58
KRYS.BARCH,20092010,DAL,436.9,0,3,3,6,6,3,0,3,3,29,52,112,10,26,34,294,412,289,410,10,9,0,30138067.884999998
KURT.SAUER,20092010,ARI,16.533333333333335,0,0,0,0,0,0,0,0,0,2,2,0,0,0,0,12,17,12,8,1,0,0,15069008.05
KURTIS.FOSTER,20092010,T.B,1219.4666666666667,8,20,14,34,42,28,0,0,0,164,335,60,122,9,23,1339,937,789,791,41,38,0,30138099.14
KYLE.BRODZIAK,20092010,MIN,1257.3166666666666,9,18,4,22,31,27,483,1000,517,139,243,69,49,15,11,914,1238,778,926,35,39,0.483,30138148.67
KYLE.CALDER,20092010,ANA,197.64999999999998,0,2,0,2,2,2,1,4,3,20,30,17,2,4,3,181,153,135,137,3,8,0.25,30138030.78
KYLE.CHIPCHURA,20092010,ANA,686.4166666666667,6,4,2,6,12,10,320,669,349,43,72,55,15,19,16,473,802,426,554,15,20,0.47832585949177875,30138097.84
KYLE.CHIPCHURA,20092010,MTL,163.95,0,0,0,0,0,0,57,106,49,11,19,8,4,5,5,142,145,137,111,0,9,0.5377358490566038,30138027.43
KYLE.CUMISKEY,20092010,COL,1343.2666666666667,8,8,6,14,22,16,0,0,0,77,158,51,46,17,11,1092,1290,827,1002,42,50,0,30138126.87
KYLE.OKPOSO,20092010,NYI,1622.25,18,15,18,33,51,33,33,69,36,246,457,62,113,29,16,1709,1353,968,954,37,55,0.4782608695652174,30138125.86
KYLE.QUINCEY,20092010,COL,1997.8333333333335,6,8,15,23,29,14,0,1,1,152,334,124,115,22,39,1587,1977,1081,1408,61,49,0,30138169.195
KYLE.WELLWOOD,20092010,VAN,1228.6999999999998,16,9,7,16,32,25,459,847,388,116,176,41,25,13,10,1236,937,851,854,33,24,0.5419126328217237,30138130.765
KYLE.WILSON,20092010,WSH,19.383333333333333,0,1,1,2,2,1,4,13,9,1,6,1,3,0,0,18,18,17,18,2,1,0.3076923076923077,15069009.685
LADISLAV.SMID,20092010,EDM,978.1833333333334,1,2,6,8,9,3,0,0,0,35,63,80,19,12,15,766,1051,710,827,35,31,0,30138101.82
LARS.ELLER,20092010,STL,75.73333333333333,2,0,0,0,2,2,9,19,10,8,14,8,1,2,2,86,58,63,55,3,1,0.47368421052631576,30138022.03
LAURI.KORPIKOSKI,20092010,ARI,985.75,6,1,5,6,12,7,15,55,40,72,151,100,41,7,9,684,1029,585,722,15,30,0.2727272727272727,30138097.645
LEE.STEMPNIAK,20092010,ARI,377.9,14,5,1,6,20,19,8,18,10,62,102,29,18,5,4,414,305,306,268,20,11,0.4444444444444444,30138050.995
LEE.STEMPNIAK,20092010,TOR,1108.9166666666665,14,9,7,16,30,23,9,25,16,164,303,71,76,10,8,1261,989,868,718,25,30,0.36,30138089.634999998
LIAM.REDDOX,20092010,EDM,112.75,0,2,0,2,2,2,0,0,0,11,14,24,2,3,2,54,126,49,109,3,5,0,30138030.13
LOGAN.COUTURE,20092010,S.J,427.2833333333333,9,3,1,4,13,12,88,179,91,60,109,35,23,9,6,462,363,414,340,13,9,0.49162011173184356,30138055.585
LOUI.ERIKSSON,20092010,DAL,1601.2166666666667,28,16,25,41,69,44,4,11,7,210,348,30,55,24,11,1680,1561,1063,1165,56,59,0.36363636363636365,30138162.925
LUBOMIR.VISNOVSKY,20092010,ANA,415.9,5,4,3,7,12,9,0,0,0,52,102,5,32,5,2,495,325,293,272,8,16,0,30138044.025
LUBOMIR.VISNOVSKY,20092010,EDM,1183,10,6,15,21,31,16,0,0,0,78,194,32,70,6,8,1230,940,868,837,41,40,0,30138097.085
LUCA.CAPUTI,20092010,PIT,47.06666666666666,1,0,1,1,2,1,0,0,0,4,9,9,4,1,1,45,56,39,53,2,3,0,30138021.235
LUCA.CAPUTI,20092010,TOR,277.9333333333333,1,3,2,5,6,4,10,23,13,32,54,20,11,2,6,315,243,238,229,8,7,0.43478260869565216,30138040.17
LUCA.SBISA,20092010,ANA,101.03333333333333,0,0,0,0,0,0,0,0,0,3,13,6,7,2,3,72,99,59,83,1,1,0,30138023.92
LUKAS.KRAJICEK,20092010,PHI,678.4666666666667,1,2,1,3,4,3,0,0,0,36,70,16,22,5,12,621,662,532,617,15,22,0,30138080.924999997
LUKAS.KRAJICEK,20092010,T.B,403.0833333333333,0,0,1,1,1,0,0,0,0,17,31,21,10,5,9,301,362,262,286,12,13,0,30138043.825
LUKE.SCHENN,20092010,TOR,1333.3,5,5,7,12,17,10,0,0,0,101,246,173,94,15,19,1253,1381,1123,1089,52,52,0,30138115.125
MACGREGOR.SHARP,20092010,ANA,33.31666666666667,0,0,0,0,0,0,15,28,13,6,9,2,1,1,0,22,37,22,37,0,0,0.5357142857142857,30138020.11
MAKSIM.MAYOROV,20092010,CBJ,30.683333333333334,0,0,0,0,0,0,0,0,0,4,5,10,0,0,0,24,33,20,31,0,0,0,30138018.85
MANNY.MALHOTRA,20092010,S.J,1363,15,9,10,19,34,24,540,870,330,148,271,87,57,14,14,1267,1196,927,782,38,19,0.6206896551724138,30138108.64
MARC-ANDRE.BERGERON,20092010,MTL,1216.3666666666668,15,8,17,25,40,23,0,0,0,158,355,76,116,12,13,1343,1067,816,931,25,36,0,30138118.845
MARC-ANDRE.CLICHE,20092010,L.A,7.383333333333334,0,0,0,0,0,0,4,6,2,0,0,1,0,0,0,5,7,5,4,1,0,0.6666666666666666,15069007.76
MARC-EDOUARD.VLASIC,20092010,S.J,1742.1666666666665,3,6,10,16,19,9,0,0,0,89,212,78,65,20,13,1638,1801,1302,1262,58,39,0,30138133.5
MARC.METHOT,20092010,CBJ,1150.0166666666667,2,2,4,6,8,4,0,0,0,42,92,146,23,12,20,773,1139,714,806,35,44,0,30138099.520000003
MARC.POULIOT,20092010,EDM,447.9,7,3,4,7,14,10,104,234,130,60,98,34,22,10,9,386,495,322,428,15,16,0.4444444444444444,30138074.310000002
MARC.SAVARD,20092010,BOS,883.3,11,16,9,25,36,27,361,738,377,112,197,16,40,18,13,909,695,611,565,23,18,0.489159891598916,30138099.895
MARC.STAAL,20092010,NYR,1895.2833333333333,7,5,11,16,23,12,0,0,0,77,174,178,63,11,22,1455,1941,1232,1329,53,45,0,30138151.085
MARCEL.GOC,20092010,NSH,1168.9666666666667,12,8,10,18,30,20,510,984,474,131,227,62,52,15,8,1027,1046,920,833,41,34,0.5182926829268293,30138120.049999997
MARCO.STURM,20092010,BOS,1374.3333333333335,22,7,8,15,37,29,2,12,10,214,339,79,55,14,17,1400,1074,1012,868,36,28,0.16666666666666666,30138114.67
MAREK.SVATOS,20092010,COL,656.05,8,4,0,4,12,12,0,0,0,94,160,29,33,16,18,620,518,439,482,12,23,0,30138073.96
MAREK.ZIDLICKY,20092010,MIN,1883.1333333333332,6,15,21,36,42,21,0,0,0,115,249,80,84,19,31,1650,1627,1048,1142,48,54,0,30138138.715
MARIAN.GABORIK,20092010,NYR,1613.65,42,31,13,44,86,73,2,7,5,272,478,59,95,17,17,1712,1316,1114,1070,65,37,0.2857142857142857,30138159.775
MARIAN.HOSSA,20092010,CHI,1472.6,27,24,14,38,65,51,1,4,3,271,434,74,90,22,19,1650,1060,1188,816,58,38,0.25,30138105.71
MARIO.BLIZNAK,20092010,VAN,17.033333333333335,0,0,0,0,0,0,9,14,5,1,1,0,0,0,0,10,21,10,21,0,2,0.6428571428571429,30138017.86
MARK.EATON,20092010,PIT,1811.1166666666666,3,5,11,16,19,8,0,0,0,76,179,38,62,8,15,1526,1704,1262,1202,53,61,0,30138126.755
MARK.FISTRIC,20092010,DAL,975.8666666666667,1,1,7,8,9,2,0,0,0,45,95,170,29,16,23,813,875,766,757,40,16,0,30138087.535
MARK.FLOOD,20092010,NYI,76.25,0,0,1,1,1,0,0,0,0,5,11,6,5,0,0,71,84,69,78,4,7,0,30138022.225
MARK.FRASER,20092010,N.J,760.5666666666667,3,2,0,2,5,5,0,0,0,24,68,122,22,5,12,581,608,573,585,22,22,0,30138073.75
MARK.GIORDANO,20092010,CGY,1708.7,11,10,9,19,30,21,0,0,0,111,257,153,91,26,34,1678,1341,1177,977,48,31,0,30138106.634999998
MARK.LETESTU,20092010,PIT,134.91666666666666,1,0,1,1,2,1,51,97,46,13,34,14,10,1,1,157,108,140,107,3,6,0.5257731958762887,30138025.475
MARK.MANCARI,20092010,BUF,84.43333333333334,1,1,0,1,2,2,0,3,3,19,31,8,6,0,2,103,54,85,49,3,0,0,30138019.4
MARK.PARRISH,20092010,T.B,242.66666666666669,0,1,0,1,1,1,4,10,6,10,25,11,6,2,2,168,223,126,164,3,7,0.4,30138033.58
MARK.POPOVIC,20092010,ATL,547.3333333333334,2,2,0,2,4,4,0,0,0,24,68,60,22,6,5,453,539,425,434,19,21,0,30138057.21
MARK.RECCHI,20092010,BOS,1634.7166666666667,24,17,12,29,53,41,58,153,95,178,283,107,53,23,19,1757,1198,1239,1024,44,47,0.3790849673202614,30138135.3
MARK.STREIT,20092010,NYI,2082.0333333333333,11,23,14,37,48,34,0,1,1,186,413,77,137,12,24,2210,1843,1300,1377,60,64,0,30138161.47
MARK.STUART,20092010,BOS,1011.7333333333333,2,2,3,5,7,4,0,0,0,56,132,112,54,18,33,811,908,757,782,27,34,0,30138092.955
MARTIN.ERAT,20092010,NSH,1444.8333333333335,25,18,11,29,54,43,26,79,53,183,299,65,63,23,26,1574,1138,1077,924,46,53,0.3291139240506329,30138127.295
MARTIN.HANZAL,20092010,ARI,1626.5833333333335,11,12,13,25,36,23,632,1233,601,177,299,199,57,36,43,1487,1402,1063,969,37,38,0.5125709651257097,30138147.765
MARTIN.HAVLAT,20092010,MIN,1309.1,18,20,16,36,54,38,6,12,6,168,294,21,71,16,17,1316,1041,810,899,40,43,0.5,30138128.85
MARTIN.SKOULA,20092010,N.J,420.2166666666667,0,0,3,3,3,0,0,0,0,13,29,21,9,1,2,316,332,284,266,13,10,0,30138038.585
MARTIN.SKOULA,20092010,PIT,551.6833333333333,3,2,3,5,8,5,0,0,0,23,54,26,17,1,3,463,513,409,451,15,18,0,30138062.435000002
MARTIN.ST PIERRE,20092010,OTT,28.85,0,0,0,0,0,0,9,20,11,0,2,2,2,0,0,25,20,15,17,0,2,0.45,30138016.96
MARTIN.ST. LOUIS,20092010,T.B,1787.2333333333333,28,34,31,65,93,62,71,157,86,240,406,20,65,33,6,1954,1513,1104,1137,60,56,0.45222929936305734,30138169.045
MARTY.REASONER,20092010,ATL,1000.9,4,9,4,13,17,13,512,1006,494,86,162,33,45,14,12,659,1149,596,685,23,32,0.5089463220675944,30138111.62
MASON.RAYMOND,20092010,VAN,1632.3,28,19,10,29,57,47,8,24,16,240,388,87,70,40,23,1697,1347,1251,1012,53,52,0.3333333333333333,30138133.17
MATHIEU.CARLE,20092010,MTL,43.41666666666667,0,0,0,0,0,0,0,0,0,2,4,3,1,0,2,43,32,39,29,1,0,0,30138017.5
MATHIEU.DARCHE,20092010,MTL,383.06666666666666,5,4,2,6,11,9,3,5,2,50,73,45,12,4,2,346,342,307,331,17,14,0.6,30138053.71
MATHIEU.PERREAULT,20092010,WSH,238.36666666666667,4,4,1,5,9,8,95,210,115,27,38,7,4,10,3,228,206,198,197,9,7,0.4523809523809524,30138044.475
MATHIEU.ROY,20092010,CBJ,550.7166666666667,0,1,9,10,10,1,1,1,0,31,73,54,25,7,7,421,518,377,390,15,18,1,30138052.535
MATHIEU.SCHNEIDER,20092010,ARI,207.55,1,2,2,4,5,3,0,0,0,26,56,21,17,1,2,255,125,140,110,6,3,0,30138024.61
MATHIEU.SCHNEIDER,20092010,VAN,259.1666666666667,2,3,0,3,5,5,0,0,0,14,52,11,18,1,6,252,194,164,178,9,8,0,30138034.11
MATT.BELESKEY,20092010,ANA,839.4000000000001,11,5,2,7,18,16,8,20,12,123,198,94,35,13,13,660,870,604,699,24,33,0.4,30138100.15
MATT.BRADLEY,20092010,WSH,923.5,11,11,5,16,27,22,13,30,17,106,208,137,64,14,10,823,856,762,665,32,27,0.43333333333333335,30138084.035
MATT.CARKNER,20092010,OTT,1481.5666666666666,3,4,5,9,12,7,0,0,0,91,175,139,51,44,60,1198,1418,1107,1041,50,52,0,30138119.315
MATT.CARLE,20092010,PHI,2466.5833333333335,7,22,18,40,47,29,0,0,0,169,357,55,125,15,12,2380,2133,1751,1673,92,68,0,30138174.6
MATT.COOKE,20092010,PIT,1350.7166666666667,19,10,7,17,36,29,15,31,16,122,227,221,54,41,50,1227,1286,1039,894,51,39,0.4838709677419355,30138115.384999998
MATT.CULLEN,20092010,CAR,1122.25,12,13,15,28,40,25,437,887,450,137,271,58,74,16,13,1112,992,693,678,33,29,0.4926719278466742,30138109.765
MATT.CULLEN,20092010,OTT,516.9833333333333,7,3,6,9,16,10,165,275,110,72,128,18,33,6,4,521,482,293,313,11,22,0.6,30138055.810000002
MATT.D'AGOSTINI,20092010,MTL,398.93333333333334,2,0,2,2,4,2,2,3,1,47,84,26,23,8,13,341,393,329,379,5,16,0.6666666666666666,30138057.16
MATT.D'AGOSTINI,20092010,STL,64.55,0,0,0,0,0,0,5,7,2,6,12,7,5,1,1,57,48,54,48,0,3,0.7142857142857143,30138019.26
MATT.DUCHENE,20092010,COL,1552.3333333333335,24,19,15,34,58,43,508,1167,659,189,330,64,70,24,9,1455,1322,940,1142,49,45,0.43530419880034277,30138188.735
MATT.ELLIS,20092010,BUF,680.8333333333334,4,4,6,10,14,8,149,301,152,117,186,35,32,6,6,604,577,592,548,20,19,0.4950166112956811,30138078.17
MATT.GILROY,20092010,NYR,1125.8333333333335,4,5,6,11,15,9,1,1,0,81,151,57,49,8,5,1098,975,923,845,34,32,1,30138094.020000003
MATT.GREENE,20092010,L.A,1423.2,2,4,3,7,9,6,0,0,0,61,162,260,53,14,33,1023,1334,952,914,38,38,0,30138102.814999998
MATT.HALISCHUK,20092010,N.J,226.15,1,1,0,1,2,2,1,4,3,22,33,10,6,1,1,172,161,138,157,4,8,0.25,30138032.8
MATT.HENDRICKS,20092010,COL,577.6833333333334,9,5,2,7,16,14,35,86,51,68,104,114,17,21,22,371,624,338,474,15,18,0.4069767441860465,30138082.71
MATT.HUNWICK,20092010,BOS,1650.6333333333332,6,4,9,13,19,10,0,1,1,75,188,81,76,5,16,1467,1463,1249,1185,43,55,0,30138125.775
MATT.LASHOFF,20092010,T.B,44.45,0,0,0,0,0,0,0,0,0,2,2,3,0,0,5,26,43,26,42,0,2,0,30138020.85
MATT.MARTIN,20092010,NYI,66.18333333333334,0,2,0,2,2,2,0,0,0,10,14,15,1,4,6,91,41,45,40,1,2,0,30138020.990000002
MATT.MOULSON,20092010,NYI,1350.9833333333333,30,12,5,17,47,42,3,4,1,206,346,108,80,15,11,1462,1098,1003,979,46,41,0.75,30138132.895
MATT.NISKANEN,20092010,DAL,1335.7666666666669,3,4,7,11,14,7,0,0,0,110,259,111,93,3,9,1392,985,931,847,30,35,0,30138088.755
MATT.PETTINGER,20092010,VAN,101.01666666666667,1,2,0,2,3,3,3,13,10,8,14,14,1,2,3,70,114,66,70,4,1,0.23076923076923078,30138024.59
MATT.SMABY,20092010,T.B,444.79999999999995,0,1,0,1,1,1,0,0,0,17,37,69,12,3,12,330,474,313,375,13,18,0,30138055.08
MATT.STAJAN,20092010,CGY,517.8666666666667,3,4,9,13,16,7,212,408,196,33,52,25,12,5,1,485,442,338,365,17,20,0.5196078431372549,30138063.005
MATT.STAJAN,20092010,TOR,1033.2166666666667,16,17,8,25,41,33,478,925,447,99,167,52,34,13,15,1220,926,874,687,40,35,0.5167567567567568,30138109.299999997
MATT.WALKER,20092010,T.B,1066.4333333333334,2,2,1,3,5,4,0,0,0,54,134,82,55,18,26,746,1082,697,788,27,34,0,30138095.405
MATTHEW.CORRENTE,20092010,N.J,117.98333333333335,0,0,0,0,0,0,0,0,0,9,20,14,7,5,7,105,77,103,72,2,2,0,30138020.85
MATTHEW.LOMBARDI,20092010,ARI,1522.2833333333333,20,25,14,39,59,45,502,1010,508,193,310,70,53,17,20,1586,1195,1031,966,61,41,0.497029702970297,30138153.25
MATTIAS.OHLUND,20092010,T.B,1528.9166666666667,0,6,6,12,12,6,0,0,0,71,140,112,37,14,28,1107,1575,893,1063,39,46,0,30138130.04
MATTIAS.RITOLA,20092010,DET,66.23333333333333,0,0,0,0,0,0,0,3,3,9,12,8,3,2,0,54,36,36,34,0,0,0,30138018.47
MAX.PACIORETTY,20092010,MTL,660.4000000000001,3,1,10,11,14,4,1,7,6,74,153,68,40,12,12,607,621,550,600,14,19,0.14285714285714285,30138078.71
MAX.TALBOT,20092010,PIT,735.2,4,7,2,9,13,11,110,259,149,72,125,98,29,16,15,582,716,522,541,21,30,0.4247104247104247,30138081.71
MAXIM.AFINOGENOV,20092010,ATL,1426.2833333333333,24,20,17,37,61,44,1,3,2,181,321,32,71,25,20,1437,1172,972,1042,52,63,0.3333333333333333,30138145.715
MAXIM.LAPIERRE,20092010,MTL,1166.4333333333334,10,6,2,8,18,16,248,498,250,137,241,212,50,32,34,893,1196,842,1096,26,42,0.4979919678714859,30138158.64
MAXIM.NOREAU,20092010,MIN,7.016666666666667,0,0,0,0,0,0,0,0,0,0,0,0,0,0,0,4,3,3,2,0,0,0,15069007.65
MAXIME.FORTUNUS,20092010,DAL,121.15,0,0,0,0,0,0,0,0,0,5,13,4,4,0,2,97,123,94,105,3,9,0,30138025.549999997
MICHAEL.BLUNDEN,20092010,CBJ,65.86666666666667,0,0,0,0,0,0,10,29,19,3,9,21,4,5,7,38,59,37,49,2,1,0.3448275862068966,30138021.700000003
MICHAEL.DEL ZOTTO,20092010,NYR,1517.5833333333333,9,14,14,28,37,23,0,0,0,81,208,162,82,13,16,1663,1250,1074,1068,45,53,0,30138124.08
MICHAEL.FROLIK,20092010,FLA,1433.2333333333336,21,7,15,22,43,28,13,35,22,219,369,72,87,14,15,1454,1257,1022,1099,43,45,0.37142857142857144,30138143.235
MICHAEL.GRABNER,20092010,VAN,360.0333333333333,6,3,3,6,12,9,1,4,3,77,122,15,17,6,4,454,296,359,274,13,9,0.25,30138044.375
MICHAEL.GRIER,20092010,BUF,1033.8333333333333,9,4,6,10,19,13,20,53,33,113,184,109,32,8,5,732,1108,667,748,27,31,0.37735849056603776,30138101.880000003
MICHAEL.KOMISAREK,20092010,TOR,329.7166666666667,0,0,0,0,0,0,0,0,0,13,46,46,23,7,13,293,378,256,250,3,11,0,30138038.47
MICHAEL.RUPP,20092010,PIT,807.1833333333334,12,3,3,6,18,15,66,152,86,91,153,227,32,28,37,662,712,647,693,30,28,0.4342105263157895,30138101.595
MICHAEL.RYDER,20092010,BOS,1459.3166666666666,22,11,5,16,38,33,2,15,13,228,384,133,87,20,16,1551,1124,1145,1027,42,37,0.13333333333333333,30138128.905
MICHAL.HANDZUS,20092010,L.A,1600.0333333333333,23,15,9,24,47,38,744,1483,739,134,201,82,22,12,21,1221,1476,794,960,39,42,0.5016857720836143,30138174.655
MICHAL.REPIK,20092010,FLA,162.96666666666667,3,1,1,2,5,4,1,1,0,23,35,28,7,5,3,134,148,125,144,4,4,1,30138033.064999998
MICHAL.ROZSIVAL,20092010,NYR,1756.8666666666666,3,4,13,17,20,7,1,1,0,80,179,136,53,20,35,1532,1534,1177,1189,50,46,1,30138133.765
MICHEAL.HALEY,20092010,NYI,15.216666666666667,0,0,0,0,0,0,1,5,4,0,3,2,3,1,3,8,18,8,18,0,3,0.2,30138017.5
MIKA.PYORALA,20092010,PHI,489.41666666666663,2,1,1,2,4,3,95,207,112,41,74,12,16,5,5,404,391,346,290,11,12,0.45893719806763283,30138046.675
MIKAEL.BACKLUND,20092010,CGY,289.83333333333337,1,4,5,9,10,5,102,191,89,47,91,12,19,0,4,321,212,265,201,13,8,0.5340314136125655,30138036.755
MIKAEL.SAMUELSSON,20092010,VAN,1486.4333333333334,38,19,10,29,67,57,15,42,27,261,463,80,111,30,36,1734,980,1186,885,61,45,0.35714285714285715,30138120.4
MIKE.BLUNDEN,20092010,CBJ,258.6166666666667,2,1,1,2,4,3,19,61,42,37,45,62,5,7,11,165,208,159,198,6,5,0.3114754098360656,30138042.605
MIKE.BROWN,20092010,ANA,626.45,6,1,0,1,7,7,0,7,7,82,133,124,17,31,28,441,664,403,551,15,16,0,30138086.41
MIKE.CAMMALLERI,20092010,MTL,1661.75,39,21,9,30,69,60,38,79,41,278,486,26,128,23,11,1804,1529,1211,1328,60,51,0.4810126582278481,30138182.425
MIKE.COMMODORE,20092010,CBJ,1083.0666666666666,2,4,5,9,11,6,0,0,0,54,119,127,42,6,24,779,1126,671,809,27,41,0,30138102.785
MIKE.COMRIE,20092010,EDM,612.0666666666666,13,5,3,8,21,18,25,47,22,97,146,20,28,16,12,609,521,392,473,17,23,0.5319148936170213,30138079.335
MIKE.DUCO,20092010,FLA,77.23333333333333,0,0,0,0,0,0,0,0,0,6,11,22,2,3,10,52,77,46,70,0,3,0,30138024.73
MIKE.FISHER,20092010,OTT,1636.8,27,16,15,31,58,43,730,1407,677,225,398,238,85,25,23,1467,1552,983,1043,45,55,0.5188343994314144,30138173.125
MIKE.GREEN,20092010,WSH,2093.333333333333,19,32,27,59,78,51,0,0,0,228,515,151,180,33,33,2622,1744,1573,1269,96,58,0,30138134.905
MIKE.GRIER,20092010,BUF,228.98333333333335,3,0,0,0,3,3,0,1,1,29,39,21,4,7,3,190,198,174,143,5,5,0,30138030.52
MIKE.KNUBLE,20092010,WSH,1289.2666666666667,31,17,11,28,59,48,1,9,8,174,294,83,52,17,28,1523,1054,1100,903,59,36,0.1111111111111111,30138124.134999998
MIKE.KOMISAREK,20092010,TOR,348.1333333333333,0,2,1,3,3,2,0,0,0,22,58,39,22,2,3,378,294,355,245,14,11,0,30138031.345
MIKE.LUNDIN,20092010,T.B,1075.15,3,3,6,9,12,6,0,0,0,42,88,20,27,7,9,749,1100,622,756,24,33,0,30138097.369999997
MIKE.MODANO,20092010,DAL,828.8,14,11,4,15,29,25,418,834,416,115,193,22,41,14,11,900,679,551,572,20,23,0.5011990407673861,30138104.41
MIKE.MOTTAU,20092010,N.J,1846.9166666666665,2,8,8,16,18,10,0,0,0,75,159,79,54,14,19,1412,1557,1234,1179,57,57,0,30138126.64
MIKE.RIBEIRO,20092010,DAL,1289.3666666666668,19,23,11,34,53,42,494,1101,607,154,243,93,41,30,19,1293,1125,776,794,33,34,0.44868301544050865,30138147.235
MIKE.RICHARDS,20092010,PHI,2173.616666666667,38,30,17,47,85,68,910,1826,916,295,565,192,160,56,37,2234,1900,1392,1358,53,49,0.49835706462212487,30138219.085
MIKE.SANTORELLI,20092010,NSH,273.83333333333337,2,0,1,1,3,2,48,105,57,36,59,9,12,1,4,261,232,223,218,2,10,0.45714285714285713,30138040.705
MIKE.WEAVER,20092010,STL,1305.7833333333333,1,1,6,7,8,2,1,2,1,32,88,48,31,11,13,911,1398,828,844,33,25,0.5,30138096
MIKHAIL.GRABOVSKI,20092010,TOR,990.85,10,16,9,25,35,26,366,734,368,126,239,26,66,24,5,1290,827,959,730,37,34,0.4986376021798365,30138099.605
MIKKEL.BOEDKER,20092010,ARI,122.01666666666665,1,0,2,2,3,1,0,0,0,7,17,17,5,5,0,103,77,102,76,4,2,0,30138021.2
MIKKO.KOIVU,20092010,MIN,1659.5,22,22,26,48,70,44,864,1517,653,246,413,50,67,19,25,1563,1286,958,890,48,41,0.5695451549110085,30138153.049999997
MIKKO.LEHTONEN,20092010,BOS,7.133333333333334,0,0,0,0,0,0,0,0,0,1,2,0,1,0,0,10,2,10,2,0,1,0,15069007.2
MILAN.HEJDUK,20092010,COL,1103.9666666666667,24,12,9,21,45,36,4,14,10,157,241,33,48,6,4,1042,938,636,794,38,27,0.2857142857142857,30138122.445
MILAN.JURCINA,20092010,CBJ,290.51666666666665,1,1,1,2,3,2,0,0,0,16,31,40,8,0,4,216,240,197,186,13,10,0,30138032.625
MILAN.JURCINA,20092010,WSH,470.8833333333333,0,3,1,4,4,3,0,0,0,32,71,48,22,0,7,414,463,376,344,14,14,0,30138046.775
MILAN.LUCIC,20092010,BOS,931.4833333333333,14,8,7,15,29,22,4,15,11,96,161,183,28,18,22,904,727,817,705,33,42,0.26666666666666666,30138094.265
MILAN.MICHALEK,20092010,OTT,1217.0166666666667,22,7,5,12,34,29,4,8,4,165,270,80,44,25,8,1160,1099,787,771,32,43,0.5,30138109.384999998
MIROSLAV.SATAN,20092010,BOS,839.55,14,4,6,10,24,18,19,36,17,96,167,13,36,7,10,858,635,728,600,33,22,0.5277777777777778,30138077.73
NATE.PROSSER,20092010,MIN,58.83333333333333,0,0,1,1,1,0,0,0,0,4,8,2,1,0,3,48,42,36,35,2,0,0,30138018.725
NATE.THOMPSON,20092010,NYI,493.1166666666667,1,4,1,5,6,5,104,208,104,45,82,54,16,11,11,306,683,271,454,6,20,0.5,30138077.395000003
NATE.THOMPSON,20092010,T.B,446.78333333333336,1,2,1,3,4,3,218,383,165,44,69,62,8,5,7,252,479,227,292,7,9,0.5691906005221932,30138056.445
NATHAN.GERBE,20092010,BUF,175.73333333333335,3,3,1,4,7,6,1,5,4,35,57,9,12,2,2,151,137,120,123,8,4,0.2,30138030.535
NATHAN.GUENIN,20092010,PIT,27.06666666666667,0,0,0,0,0,0,0,0,0,1,5,10,2,1,0,32,28,27,23,0,2,0,30138016.86
NATHAN.HORTON,20092010,FLA,1357.6166666666668,20,23,14,37,57,43,48,85,37,159,303,34,87,19,15,1391,1253,880,1000,53,43,0.5647058823529412,30138139.46
NATHAN.OYSTRICK,20092010,ANA,31.73333333333333,0,0,0,0,0,0,0,0,0,1,4,5,1,0,1,22,34,20,30,2,3,0,30138018.25
NATHAN.PAETSCH,20092010,BUF,106.23333333333332,1,0,1,1,2,1,0,0,0,9,16,4,4,3,3,100,70,94,67,4,2,0,30138020.854999997
NATHAN.PAETSCH,20092010,CBJ,112.38333333333334,0,0,0,0,0,0,0,0,0,8,17,3,6,0,3,121,90,79,82,0,5,0,30138023.3
NATHAN.SMITH,20092010,MIN,70.6,0,0,0,0,0,0,26,49,23,4,9,5,3,2,3,30,86,24,58,0,4,0.5306122448979592,30138023.61
NAZEM.KADRI,20092010,TOR,17.433333333333334,0,0,0,0,0,0,2,13,11,0,1,1,0,0,0,20,5,6,3,0,1,0.15384615384615385,15069008.18
NICK.BONINO,20092010,ANA,128,1,1,0,1,2,2,34,78,44,14,21,4,3,1,3,129,117,89,108,3,3,0.4358974358974359,30138030.119999997
NICK.BOYNTON,20092010,ANA,703.6666666666667,1,2,2,4,5,3,0,0,0,39,93,61,32,7,23,561,671,472,525,23,21,0,30138069.32
NICK.BOYNTON,20092010,CHI,136.71666666666667,0,0,1,1,1,0,0,0,0,13,23,6,9,4,4,160,117,145,101,8,2,0,30138021.715
NICK.FOLIGNO,20092010,OTT,975.55,9,13,5,18,27,22,17,50,33,94,164,94,28,21,24,891,748,711,704,28,25,0.34,30138100.465
NICK.JOHNSON,20092010,PIT,60.61666666666667,1,1,0,1,2,2,1,1,0,7,10,5,2,1,1,55,58,55,58,2,4,1,30138022.1
NICK.PALMIERI,20092010,N.J,70.51666666666667,0,0,1,1,1,0,1,2,1,10,18,8,7,0,0,69,41,54,40,3,3,0.5,30138017.415
NICK.SCHULTZ,20092010,MIN,1677.4,1,4,14,18,19,5,0,0,0,83,174,84,55,8,19,1288,1599,1030,1205,43,49,0,30138140.58
NICK.SPALING,20092010,NSH,359.85,0,3,0,3,3,3,44,103,59,29,57,20,11,2,0,238,327,226,250,6,4,0.42718446601941745,30138044.28
NICK.TARNASKY,20092010,FLA,211.16666666666669,1,2,0,2,3,3,0,0,0,19,33,77,7,18,19,132,233,128,225,3,7,0,30138046.63
NICKLAS.BACKSTROM,20092010,WSH,1823.9333333333334,38,46,26,72,110,84,730,1471,741,249,402,97,68,20,23,2379,1471,1507,1140,96,49,0.49626104690686607,30138185.75
NICKLAS.BERGFORS,20092010,N.J,295.08333333333337,5,6,2,8,13,11,1,1,0,53,73,5,7,1,3,265,214,191,204,6,6,1,30138044.15
NICKLAS.GROSSMANN,20092010,DAL,1362.45,0,3,3,6,6,3,0,1,1,58,108,150,27,6,16,1063,1444,958,1090,49,54,0,30138126.485
NICKLAS.LIDSTROM,20092010,DET,2401.4666666666662,13,21,21,42,55,34,0,0,0,233,474,69,134,10,13,2659,1956,1693,1310,75,61,0,30138131.425
NICLAS.BERGFORS,20092010,ATL,445.45000000000005,8,5,4,9,17,13,4,12,8,83,107,4,12,5,0,467,351,323,313,18,17,0.3333333333333333,30138054.509999998
NICLAS.BERGFORS,20092010,N.J,508.5666666666667,8,2,3,5,13,10,4,6,2,81,120,9,23,4,2,500,349,396,327,11,18,0.6666666666666666,30138050.525
NICLAS.WALLIN,20092010,CAR,815.25,0,3,2,5,5,3,0,1,1,48,101,122,36,7,13,641,839,555,567,20,25,0,30138070.17
NICLAS.WALLIN,20092010,S.J,424.9666666666667,0,2,0,2,2,2,0,0,0,20,42,58,15,3,6,347,397,322,299,10,14,0,30138043.03
NIGEL.DAWES,20092010,CGY,959.7166666666667,14,13,5,18,32,27,0,1,1,96,195,66,49,19,8,996,709,779,665,35,34,0,30138086.765
NIK.ANTROPOV,20092010,ATL,1385.2833333333333,24,23,20,43,67,47,480,1107,627,126,205,82,39,20,22,1373,1085,891,952,62,44,0.43360433604336046,30138165.4
NIKITA.FILATOV,20092010,CBJ,105.41666666666667,2,0,0,0,2,2,2,3,1,11,24,5,7,0,4,95,87,79,81,2,2,0.6666666666666666,30138024.43
NIKLAS.HAGMAN,20092010,CGY,434.05,5,3,2,5,10,8,2,7,5,68,102,9,18,11,1,433,317,323,283,10,10,0.2857142857142857,30138046.29
NIKLAS.HAGMAN,20092010,TOR,887.8333333333333,20,6,7,13,33,26,10,31,21,148,262,26,52,26,10,988,763,761,619,37,36,0.3225806451612903,30138084.384999998
NIKLAS.HJALMARSSON,20092010,CHI,1976.4,3,12,9,21,24,15,0,0,0,79,212,73,80,14,13,1602,1737,1442,1249,58,52,0,30138124.965
NIKLAS.KRONWALL,20092010,DET,1330.9499999999998,7,10,8,18,25,17,0,0,0,83,186,105,61,11,22,1334,1112,960,820,39,33,0,30138093.560000002
NIKOLAY.KULEMIN,20092010,TOR,1276.6833333333334,16,13,7,20,36,29,27,66,39,145,266,136,60,31,8,1352,1128,1070,875,42,38,0.4090909090909091,30138106.765
NOLAN.BAUMGARTNER,20092010,VAN,179.93333333333334,1,0,1,1,2,1,0,0,0,12,17,10,1,1,1,148,196,143,187,11,4,0,30138035.634999998
OLE-KRISTIAN.TOLLEFSEN,20092010,PHI,177.46666666666664,0,0,1,1,1,0,0,0,0,12,27,17,8,10,10,164,157,160,154,9,8,0,30138029.825
OLLI.JOKINEN,20092010,CGY,1036.4166666666665,11,12,12,24,35,23,364,739,375,161,296,57,67,14,21,1155,823,798,729,35,33,0.4925575101488498,30138110.8
OLLI.JOKINEN,20092010,NYR,428.54999999999995,4,5,6,11,15,9,116,234,118,74,132,53,31,6,11,453,358,326,318,14,13,0.49572649572649574,30138055.8
OSCAR.MOLLER,20092010,L.A,291.8833333333333,4,2,1,3,7,6,32,104,72,42,71,37,14,4,3,245,213,172,190,7,13,0.3076923076923077,30138041.595
OSKAR.OSALA,20092010,CAR,6.766666666666667,0,0,0,0,0,0,0,0,0,1,3,1,1,0,0,8,5,8,5,0,0,0,15069007.75
OSKARS.BARTULIS,20092010,PHI,788.2166666666667,1,4,3,7,8,5,0,0,0,27,81,53,32,2,15,670,806,643,768,31,40,0,30138095.345
OWEN.NOLAN,20092010,MIN,1210.9833333333333,16,9,8,17,33,25,184,388,204,150,250,51,45,17,16,1087,1088,759,805,31,31,0.4742268041237113,30138121.58
P.A..PARENTEAU,20092010,NYR,301.25,3,3,2,5,8,6,4,12,8,38,58,15,13,2,2,293,231,242,208,12,14,0.3333333333333333,30138036.83
P.K..SUBBAN,20092010,MTL,330.46666666666664,1,6,3,9,10,7,0,0,0,27,67,13,29,2,4,348,282,233,201,13,8,0,30138033.395
PASCAL.DUPUIS,20092010,PIT,1355.15,20,14,11,25,45,34,15,37,22,190,323,107,70,18,10,1186,1343,1069,1018,53,47,0.40540540540540543,30138130.455
PATRIC.HORNQVIST,20092010,NSH,1281.3333333333333,30,11,11,22,52,41,5,19,14,276,417,73,65,20,20,1454,875,998,803,48,29,0.2631578947368421,30138114.125
PATRICE.BERGERON,20092010,BOS,1645.0666666666666,23,29,10,39,62,52,945,1632,687,220,380,70,69,18,15,1722,1272,1171,922,44,44,0.5790441176470589,30138148.93
PATRICK.DAVIS,20092010,N.J,100.86666666666667,1,0,0,0,1,1,4,6,2,8,13,21,4,1,0,50,99,48,98,1,3,0.6666666666666666,30138027.72
PATRICK.DWYER,20092010,CAR,725.4000000000001,7,3,2,5,12,10,78,224,146,80,142,108,31,10,3,561,781,521,564,15,20,0.3482142857142857,30138084.42
PATRICK.EAVES,20092010,DET,969.1833333333334,12,4,5,9,21,16,4,15,11,134,234,146,48,13,11,836,978,736,696,29,35,0.26666666666666666,30138091.015
PATRICK.KALETA,20092010,BUF,618.6666666666666,11,5,1,6,17,16,0,2,2,69,118,170,24,44,31,478,562,454,506,21,18,0,30138080.615000002
PATRICK.KANE,20092010,CHI,1991.0666666666666,40,43,32,75,115,83,11,29,18,325,598,22,140,46,14,2324,1297,1560,1151,82,63,0.3793103448275862,30138150
PATRICK.MARLEAU,20092010,S.J,2026.25,52,23,21,44,96,75,340,665,325,325,565,109,103,22,15,2251,1868,1388,1268,73,56,0.5112781954887218,30138191.595
PATRICK.O'SULLIVAN,20092010,EDM,1279.0166666666669,11,17,6,23,34,28,71,195,124,191,355,32,86,18,16,1180,1297,786,1006,28,54,0.3641025641025641,30138144.619999997
PATRICK.SHARP,20092010,CHI,1879.65,36,33,19,52,88,69,360,705,345,342,573,71,110,16,22,2150,1307,1456,1020,80,47,0.5106382978723404,30138145.685000002
PATRIK.BERGLUND,20092010,STL,958.6500000000001,13,6,7,13,26,19,220,503,283,129,229,70,49,8,8,1026,668,711,599,25,28,0.43737574552683894,30138090.805
PATRIK.ELIAS,20092010,N.J,1114.1666666666667,18,22,11,33,51,40,247,543,296,155,262,32,57,11,17,1114,805,751,653,44,29,0.4548802946593002,30138108.515
PAUL.BISSONNETTE,20092010,ARI,240.26666666666665,3,0,1,1,4,3,0,0,0,25,46,78,9,25,26,199,182,196,179,8,10,0,30138037.075
PAUL.GAUSTAD,20092010,BUF,1135.4666666666667,12,9,2,11,23,21,648,1141,493,118,194,130,43,29,34,1019,1008,704,688,24,31,0.567922874671341,30138115.91
PAUL.KARIYA,20092010,STL,1286.5,18,12,12,24,42,30,4,10,6,221,374,36,80,24,17,1423,1053,955,848,37,33,0.4,30138111.1
PAUL.MARA,20092010,MTL,786.5,0,5,2,7,7,5,0,0,0,30,87,50,31,5,17,671,816,499,613,15,31,0,30138082.1
PAUL.MARTIN,20092010,N.J,606.9666666666667,2,5,4,9,11,7,0,0,0,26,69,28,29,10,1,584,397,390,284,19,12,0,30138036.9
PAUL.RANGER,20092010,T.B,162.56666666666666,1,0,1,1,2,1,0,0,0,11,21,5,7,0,3,106,170,97,110,4,5,0,30138026.775
PAUL.STASTNY,20092010,COL,1855.25,21,42,21,63,84,63,919,1840,921,212,344,48,66,27,25,1772,1703,1087,1254,63,57,0.4994565217391304,30138220.255000003
PAUL.SZCZECHURA,20092010,T.B,680.6333333333333,5,1,1,2,7,6,186,403,217,83,128,45,19,9,9,448,667,409,442,10,25,0.46153846153846156,30138075.205
PAVEL.DATSYUK,20092010,DET,1853.5833333333335,33,30,19,49,82,63,718,1312,594,242,438,105,107,38,13,2166,1282,1403,1049,61,47,0.5472560975609756,30138154.975
PAVEL.KUBINA,20092010,ATL,1719.55,6,11,20,31,37,17,0,0,0,159,292,94,87,4,33,1454,1599,1054,1125,61,58,0,30138133.54
PAVOL.DEMITRA,20092010,VAN,611.4,5,7,10,17,22,12,61,123,62,70,127,27,26,7,2,618,524,417,459,22,15,0.4959349593495935,30138070.26
PERTTU.LINDGREN,20092010,DAL,8.55,0,0,0,0,0,0,2,5,3,0,0,0,0,0,0,5,2,5,2,0,0,0.4,15069007.68
PETER.HARROLD,20092010,L.A,384.6,1,0,0,0,1,1,2,14,12,24,49,23,12,1,4,297,304,277,281,8,11,0.14285714285714285,30138043.39
PETER.MUELLER,20092010,ARI,697.7166666666667,4,9,4,13,17,13,18,42,24,88,159,24,39,2,4,705,530,566,492,20,22,0.42857142857142855,30138065.740000002
PETER.MUELLER,20092010,COL,267.51666666666665,9,5,6,11,20,14,0,2,2,35,69,15,22,2,4,301,233,193,216,11,6,0,30138044.77
PETER.OLVECKY,20092010,NSH,7.883333333333334,0,0,0,0,0,0,0,0,0,0,1,0,1,0,0,4,2,4,2,0,0,0,15069007.45
PETER.REGIN,20092010,OTT,1075.5666666666666,15,10,6,16,31,25,243,545,302,145,244,82,48,17,13,1117,741,930,674,35,30,0.44587155963302755,30138095.64
PETR.KALUS,20092010,MIN,15.466666666666667,0,0,0,0,0,0,0,1,1,0,0,4,0,0,0,7,8,7,8,0,0,0,15069008.4
PETR.PRUCHA,20092010,ARI,1203.6166666666668,14,5,6,11,25,19,72,165,93,141,223,86,36,26,13,1196,859,943,808,32,30,0.43636363636363634,30138105.04
PETR.SYKORA,20092010,MIN,167.78333333333336,2,0,1,1,3,2,2,4,2,13,26,2,7,4,5,152,130,120,125,3,8,0.5,30138029.245
PETTERI.NOKELAINEN,20092010,ANA,646.4499999999999,4,5,2,7,11,9,154,354,200,70,104,57,20,8,9,427,724,348,481,14,19,0.4350282485875706,30138083.740000002
PETTERI.NOKELAINEN,20092010,ARI,218.63333333333333,1,1,0,1,2,2,52,99,47,18,30,33,8,1,4,141,207,125,159,2,6,0.5252525252525253,30138035.689999998
PHIL.KESSEL,20092010,TOR,1368.1666666666665,30,19,6,25,55,49,59,122,63,297,547,13,149,21,11,1686,1096,1110,956,51,45,0.48360655737704916,30138124.07
PHILIP.LARSEN,20092010,DAL,24.9,0,1,0,1,1,1,0,0,0,1,2,1,0,0,0,25,17,20,16,2,1,0,30138016.700000003
PHILIPPE.DUPUIS,20092010,COL,32.93333333333333,0,0,1,1,1,0,9,20,11,4,6,4,0,1,1,23,33,21,32,1,0,0.45,30138019.495
PIERRE-LUC.LETOURNEAU-LEBLOND,20092010,N.J,171.9,0,1,1,2,2,1,1,2,1,9,24,50,7,14,12,115,131,112,130,2,6,0.5,30138030.604999997
PIERRE-MARC.BOUCHARD,20092010,MIN,10.733333333333333,0,0,0,0,0,0,1,3,2,0,0,0,0,0,1,7,12,7,11,0,0,0.3333333333333333,15069009.04
QUINTIN.LAING,20092010,WSH,346.95000000000005,2,2,0,2,4,4,4,7,3,37,72,52,22,8,5,288,315,272,234,9,8,0.5714285714285714,30138037.14
R.J..UMBERGER,20092010,CBJ,367.04999999999995,4,4,3,7,11,8,64,131,67,39,63,24,9,11,6,312,362,195,233,6,17,0.48854961832061067,30138048.845
RADEK.DVORAK,20092010,FLA,1325,14,8,9,17,31,22,3,17,14,140,228,50,44,16,10,999,1522,828,1081,32,37,0.17647058823529413,30138148.555
RADEK.MARTINEK,20092010,NYI,364.75,2,0,1,1,3,2,0,0,0,24,40,19,8,3,6,284,418,241,324,7,10,0,30138052.905
RADEK.SMOLENAK,20092010,CHI,4.683333333333334,0,0,0,0,0,0,0,0,0,1,1,1,0,1,1,5,1,5,1,0,0,0,15069007.61
RADIM.VRBATA,20092010,ARI,1438.95,26,14,7,21,47,40,3,10,7,287,432,19,82,13,13,1423,1054,1025,872,37,32,0.3,30138119.875
RAFFI.TORRES,20092010,BUF,238.41666666666666,0,3,4,7,7,3,1,4,3,28,50,22,14,2,3,224,204,184,191,6,9,0.25,30138035.41
RAFFI.TORRES,20092010,CBJ,801.05,19,10,1,11,30,29,17,47,30,99,155,70,27,11,19,766,599,542,535,22,26,0.3617021276595745,30138088.915
RAITIS.IVANANS,20092010,L.A,304.68333333333334,0,0,0,0,0,0,0,0,0,18,34,77,7,21,35,191,252,190,250,1,9,0,30138048.16
RANDY.JONES,20092010,L.A,942.9666666666667,5,7,9,16,21,12,0,0,0,57,129,42,43,2,14,880,842,657,710,26,32,0,30138091.295
RAY.WHITNEY,20092010,CAR,1514.1,19,26,10,36,55,45,3,9,6,167,331,24,76,24,12,1690,1317,1047,1115,44,42,0.3333333333333333,30138150.909999996
RAYMOND.SAWADA,20092010,DAL,40.766666666666666,0,0,0,0,0,0,0,0,0,2,4,6,1,1,0,23,32,23,32,2,1,0,30138018.310000002
RENE.BOURQUE,20092010,CGY,1337.1166666666668,27,20,11,31,58,47,8,25,17,215,388,91,84,25,41,1289,1124,886,816,43,39,0.32,30138122.695
RICH.CLUNE,20092010,L.A,122.75,0,1,1,2,2,1,2,5,3,8,11,28,2,13,8,89,120,88,119,2,3,0.4,30138030.335
RICH.PEVERLEY,20092010,ATL,1530.0333333333333,22,20,13,33,55,42,646,1192,546,165,264,23,48,21,18,1504,1345,960,923,42,54,0.5419463087248322,30138151.325
RICHARD.PARK,20092010,NYI,1261.85,9,9,10,19,28,18,530,1026,496,143,229,38,42,15,14,896,1583,789,1039,39,46,0.5165692007797271,30138160.15
RICK.NASH,20092010,CBJ,1571.0666666666666,32,24,10,34,66,56,11,22,11,251,409,119,92,37,25,1479,1334,892,939,46,59,0.5,30138144.009999998
RICK.RYPIEN,20092010,VAN,532.1333333333333,4,5,0,5,9,9,75,172,97,62,98,101,16,26,33,332,487,316,446,12,14,0.436046511627907,30138079.86
RICKARD.WALLIN,20092010,TOR,758.9000000000001,2,2,5,7,9,4,225,506,281,72,118,35,25,6,9,585,755,517,523,13,23,0.44466403162055335,30138081.585
RILEY.COTE,20092010,PHI,45.416666666666664,0,0,0,0,0,0,0,0,0,7,7,13,0,6,6,38,33,38,32,0,0,0,30138019.21
RJ.UMBERGER,20092010,CBJ,1185.7,19,16,9,25,44,35,302,566,264,182,267,82,36,18,11,1089,1073,639,757,33,40,0.5335689045936396,30138130.134999998
ROB.BLAKE,20092010,S.J,1824.15,8,6,16,22,30,14,0,0,0,214,414,83,120,12,32,1829,1894,1281,1290,48,40,0,30138144.97
ROB.DAVISON,20092010,N.J,3.9833333333333334,0,0,0,0,0,0,0,0,0,0,0,0,0,0,0,2,3,2,3,0,0,0,15069007.85
ROB.NIEDERMAYER,20092010,N.J,1257.0166666666669,10,10,2,12,22,20,506,1001,495,96,150,91,23,11,24,814,1130,650,820,28,33,0.5054945054945055,30138138.7
ROB.SCHREMP,20092010,NYI,598.5833333333334,7,9,9,18,25,16,183,386,203,74,133,18,35,9,4,637,482,450,435,17,19,0.4740932642487047,30138073.185
ROB.SCUDERI,20092010,L.A,1529.9833333333333,0,6,4,10,10,6,0,0,0,42,84,78,21,8,12,1112,1420,1002,1044,46,39,0,30138119.03
ROBBIE.EARL,20092010,MIN,270.20000000000005,4,0,0,0,4,4,0,2,2,26,57,51,12,6,5,207,230,204,229,6,7,0,30138041.46
ROBERT.EARL,20092010,MIN,15.816666666666666,2,0,0,0,2,2,0,0,0,3,4,5,0,0,0,11,16,10,16,2,1,0,15069010.65
ROBERT.LANG,20092010,ARI,1000.6333333333334,9,14,6,20,29,23,383,762,379,84,167,31,38,7,14,1069,701,742,621,27,23,0.5026246719160105,30138097.240000002
ROBERT.NILSSON,20092010,EDM,884.8499999999999,11,14,2,16,27,25,1,3,2,104,183,30,51,10,11,905,764,638,711,24,37,0.3333333333333333,30138101.09
ROBYN.REGEHR,20092010,CGY,1752.9333333333334,2,6,8,14,16,8,0,1,1,78,203,125,77,9,34,1435,1761,1220,1157,45,51,0,30138123.69
ROD.BRIND'AMOUR,20092010,CAR,997.4166666666667,9,5,5,10,19,14,490,838,348,94,163,82,32,14,18,927,890,701,656,21,41,0.5847255369928401,30138099.865000002
ROD.PELLEY,20092010,N.J,523.0833333333334,2,6,2,8,10,8,99,199,100,77,103,102,13,10,12,362,374,345,368,10,14,0.49748743718592964,30138064.11
ROMAN.HAMRLIK,20092010,MTL,2140.4833333333336,6,16,11,27,33,22,0,0,0,121,276,87,99,11,33,1962,2091,1459,1552,61,61,0,30138175.785
ROMAN.POLAK,20092010,STL,1558.0666666666666,4,7,9,16,20,11,0,0,0,73,151,137,41,11,24,1174,1547,1044,1072,54,49,0,30138124.035
RON.HAINSEY,20092010,ATL,1771.6833333333334,5,7,11,18,23,12,0,0,0,120,237,42,76,8,18,1350,1886,1052,1239,55,60,0,30138145.555
ROSTISLAV.KLESLA,20092010,CBJ,522.9666666666667,2,0,5,5,7,2,0,0,0,24,55,39,22,5,11,350,618,291,382,16,24,0,30138056.725
ROSTISLAV.OLESZ,20092010,FLA,1200.8000000000002,14,11,4,15,29,25,2,9,7,178,275,80,39,22,14,1076,1140,813,900,31,33,0.2222222222222222,30138126.549999997
RUSLAN.FEDOTENKO,20092010,PIT,1228.7333333333333,11,10,9,19,30,21,12,30,18,159,287,145,66,31,21,1273,1101,1016,983,36,52,0.4,30138122.415
RUSLAN.SALEI,20092010,COL,284.7166666666667,1,1,3,4,5,2,0,0,0,22,41,23,11,1,4,229,250,182,206,8,9,0,30138037.134999998
RYAN.CALLAHAN,20092010,NYR,1494.1666666666667,19,11,7,18,37,30,17,35,18,204,368,285,74,32,17,1444,1409,877,911,25,31,0.4857142857142857,30138126.625
RYAN.CARTER,20092010,ANA,374.2,4,4,1,5,9,8,116,221,105,38,62,50,9,7,14,274,407,243,337,12,14,0.5248868778280543,30138063.485
RYAN.CRAIG,20092010,T.B,29.35,0,0,0,0,0,0,0,1,1,5,7,3,1,1,1,16,23,16,19,0,0,0,30138017.36
RYAN.GETZLAF,20092010,ANA,1430.3333333333333,19,34,15,49,68,53,533,1124,591,149,284,178,67,17,33,1515,1131,949,923,56,42,0.47419928825622776,30138157.465
RYAN.JOHNSON,20092010,VAN,649.5166666666667,1,2,1,3,4,3,298,559,261,20,46,37,11,6,7,313,822,262,456,8,13,0.5330948121645797,30138081.505
RYAN.JONES,20092010,EDM,82.75,1,0,0,0,1,1,0,0,0,9,14,8,2,5,4,65,91,54,86,1,4,0,30138026.55
RYAN.JONES,20092010,NSH,439.06666666666666,7,3,1,4,11,10,0,1,1,53,93,63,22,23,9,413,349,312,333,13,10,0,30138055.005
RYAN.KELLER,20092010,OTT,37.266666666666666,0,0,0,0,0,0,0,0,0,5,8,3,2,1,0,31,22,31,22,0,2,0,30138016.71
RYAN.KESLER,20092010,VAN,1865.0333333333333,26,34,24,58,84,60,895,1631,736,235,428,109,80,63,39,1936,1634,1259,1048,57,56,0.5487431023911711,30138173.48
RYAN.MALONE,20092010,T.B,1294.8833333333332,21,9,17,26,47,30,38,97,59,172,248,178,30,21,27,1312,1166,768,861,37,42,0.3917525773195876,30138132.055
RYAN.O'BYRNE,20092010,MTL,1004.5999999999999,1,2,1,3,4,3,0,0,0,34,90,151,37,12,33,788,1131,730,955,23,30,0,30138121.395
RYAN.O'MARRA,20092010,EDM,19.866666666666667,0,1,0,1,1,1,7,12,5,2,5,5,2,0,0,17,14,17,13,1,1,0.5833333333333334,30138016.48
RYAN.O'REILLY,20092010,COL,1460.5333333333333,9,10,8,18,27,19,510,1070,560,140,218,40,47,12,10,937,1618,821,1101,34,36,0.4766355140186916,30138170.87
RYAN.PARENT,20092010,PHI,835.8833333333333,2,1,0,1,3,3,0,1,1,30,82,58,34,14,11,618,934,586,741,16,33,0,30138094.64
RYAN.POTULNY,20092010,EDM,1041.85,15,10,7,17,32,25,388,818,430,152,241,41,46,16,13,888,1105,649,786,24,42,0.4743276283618582,30138133.805
RYAN.SHANNON,20092010,OTT,848.9333333333334,5,7,4,11,16,12,19,51,32,110,191,38,48,10,10,856,574,676,532,21,30,0.37254901960784315,30138066.810000002
RYAN.SMYTH,20092010,L.A,1430.4,23,16,16,32,55,39,31,65,34,217,315,44,34,25,24,1537,1044,959,868,44,33,0.47692307692307695,30138127.740000002
RYAN.STOA,20092010,COL,141.56666666666666,2,0,1,1,3,2,0,0,0,27,36,14,5,2,1,126,134,106,126,1,4,0,30138030.695
RYAN.STONE,20092010,EDM,293.3833333333333,0,5,1,6,6,5,7,21,14,25,56,54,16,11,14,277,265,268,236,16,14,0.3333333333333333,30138039.115000002
RYAN.SUTER,20092010,NSH,2110.9166666666665,4,15,17,32,36,19,0,1,1,141,314,66,110,8,23,2100,1729,1471,1317,66,58,0,30138135.555
RYAN.VESCE,20092010,S.J,98.56666666666668,3,1,1,2,5,4,25,50,25,20,30,13,6,1,0,90,79,78,74,6,7,0.5,30138025.134999998
RYAN.WHITE,20092010,MTL,178.41666666666669,0,1,0,1,1,1,7,10,3,5,22,47,9,5,5,117,206,106,172,1,7,0.7,30138035.68
RYAN.WHITNEY,20092010,ANA,1521.3666666666668,4,11,13,24,28,15,0,1,1,107,213,71,59,14,24,1382,1431,886,1037,47,43,0,30138129.314999998
RYAN.WHITNEY,20092010,EDM,482.2,3,3,5,8,11,6,0,0,0,44,84,18,19,1,8,455,473,293,338,23,19,0,30138052.285
RYAN.WILSON,20092010,COL,1051.1,3,4,13,17,20,7,0,0,0,48,100,91,33,13,12,763,1047,696,904,37,29,0,30138114.905
RYANE.CLOWE,20092010,S.J,1691.7666666666669,21,21,23,44,65,42,44,109,65,224,393,196,101,31,50,2012,1465,1462,1307,59,56,0.4036697247706422,30138163.745
SAKU.KOIVU,20092010,ANA,1319.0500000000002,19,18,14,32,51,37,571,1110,539,124,197,59,35,18,18,1285,1177,838,789,40,28,0.5144144144144144,30138134.770000003
SAM.GAGNER,20092010,EDM,1107.6,14,13,13,26,40,27,336,709,373,169,280,30,48,22,16,1143,934,790,849,35,38,0.47390691114245415,30138134.685000002
SAMI.LEPISTO,20092010,ARI,1313.3000000000002,2,5,4,9,11,7,1,1,0,75,147,69,49,15,29,1112,1140,999,898,40,28,1,30138099.09
SAMI.SALO,20092010,VAN,1654.0666666666666,10,8,15,23,33,18,0,0,0,137,298,63,90,10,10,1481,1514,965,979,54,43,0,30138112.975
SAMUEL.PAHLSSON,20092010,CBJ,1271.4666666666667,3,6,7,13,16,9,662,1248,586,93,159,150,32,12,15,792,1254,709,807,23,32,0.530448717948718,30138127.975
SCOTT.GOMEZ,20092010,MTL,1956.9333333333334,14,36,23,59,73,50,886,1757,871,226,378,46,87,34,32,2018,1884,1356,1383,56,53,0.504268639726807,30138215.655
SCOTT.HANNAN,20092010,COL,1911.7333333333331,2,5,7,12,14,7,2,2,0,56,128,72,46,18,22,1267,2089,1158,1493,58,60,1,30138176.385
SCOTT.HARTNELL,20092010,PHI,1646.6,22,23,16,39,61,45,2,10,8,201,344,200,64,62,72,1837,1403,1263,1242,59,53,0.2,30138170.8
SCOTT.JACKSON,20092010,T.B,13.733333333333333,0,0,0,0,0,0,0,0,0,0,0,1,0,0,0,9,11,9,11,0,0,0,15069008.7
SCOTT.NICHOL,20092010,S.J,1151.8666666666668,5,12,4,16,21,17,553,922,369,112,199,274,47,43,36,831,1186,755,843,30,37,0.5997830802603037,30138126.9
SCOTT.NIEDERMAYER,20092010,ANA,2120.3,10,13,24,37,47,23,0,1,1,168,304,58,86,10,19,2029,1981,1231,1242,53,57,0,30138146.25
SCOTT.PARSE,20092010,L.A,647.9166666666667,11,9,4,13,24,20,7,13,6,80,125,55,26,4,11,527,547,506,538,32,21,0.5384615384615384,30138080.57
SCOTT.WALKER,20092010,CAR,311.6333333333333,3,1,1,2,5,4,0,3,3,48,76,68,9,9,9,289,233,266,229,8,12,0,30138040.215
SCOTT.WALKER,20092010,WSH,89.45,2,0,1,1,3,2,0,1,1,13,23,13,6,2,3,90,75,88,73,3,2,0,30138022.845
SCOTTIE.UPSHALL,20092010,ARI,737.05,18,5,9,14,32,23,7,17,10,119,203,80,43,22,27,743,579,563,522,28,21,0.4117647058823529,30138081.175
SEAN.AVERY,20092010,NYR,923.1166666666667,11,12,8,20,31,23,4,14,10,139,233,145,51,44,51,914,752,789,718,32,30,0.2857142857142857,30138101.2
SEAN.BERGENHEIM,20092010,NYI,885.7833333333333,10,9,4,13,23,19,5,17,12,133,254,127,65,23,21,806,952,719,733,26,31,0.29411764705882354,30138098.18
SEAN.O'DONNELL,20092010,L.A,1571.9666666666667,3,5,7,12,15,8,0,1,1,46,121,90,41,12,31,1118,1537,1039,1056,46,41,0,30138120.895
SERGEI.GONCHAR,20092010,PIT,1828.7666666666667,13,23,26,49,62,36,0,0,0,159,360,73,122,12,25,2012,1496,1140,994,54,51,0,30138116.22
SERGEI.KOSTITSYN,20092010,MTL,705.9333333333334,7,8,3,11,18,15,1,7,6,64,116,28,28,9,3,551,731,468,580,22,23,0.14285714285714285,30138084.655
SERGEI.SAMSONOV,20092010,CAR,943.3499999999999,14,9,6,15,29,23,0,3,3,101,181,34,42,8,20,975,768,693,701,28,38,0,30138098.48
SERGEI.SHIROKOV,20092010,VAN,76.95,0,0,0,0,0,0,1,2,1,4,11,1,5,3,1,77,59,57,56,1,4,0.5,30138020.07
SHANE.DOAN,20092010,ARI,1610.6333333333334,18,25,13,38,56,43,74,162,88,241,424,172,90,22,21,1706,1213,1122,979,58,47,0.4567901234567901,30138129.955
SHANE.HNIDY,20092010,MIN,947.7833333333333,2,8,3,11,13,10,0,0,0,48,138,36,53,15,23,827,865,729,779,25,33,0,30138095.725
SHANE.O'BRIEN,20092010,VAN,1317.8,3,0,7,7,10,3,0,0,0,47,118,143,47,8,35,1063,1166,998,938,53,39,0,30138101.105
SHAONE.MORRISONN,20092010,WSH,1274.1166666666668,1,2,7,9,10,3,0,0,0,33,83,172,29,10,22,1141,1276,1027,962,59,52,0,30138102.125
SHAUN.HESHKA,20092010,ARI,106.51666666666667,0,2,0,2,2,2,0,0,0,3,7,6,3,0,2,88,73,83,61,3,3,0,30138020.65
SHAWN.BELLE,20092010,MTL,21.266666666666666,0,0,0,0,0,0,0,0,0,1,2,2,0,0,0,15,18,15,17,0,2,0,15069009.35
SHAWN.HORCOFF,20092010,EDM,1496.0333333333333,13,11,12,23,36,24,621,1337,716,123,230,35,56,21,23,1270,1555,855,1055,30,54,0.4644727000747943,30138173.05
SHAWN.MATTHIAS,20092010,FLA,593.8333333333333,6,3,6,9,15,9,119,313,194,66,114,57,18,8,7,493,619,434,569,15,19,0.3801916932907348,30138092.94
SHAWN.THORNTON,20092010,BOS,755.0666666666666,1,8,1,9,10,9,12,25,13,127,197,125,33,25,37,658,634,653,624,13,26,0.48,30138086.905
SHEA.WEBER,20092010,NSH,1953.8833333333332,18,14,14,28,46,32,0,0,0,236,522,183,138,12,17,2031,1539,1385,1228,61,59,0,30138135.92
SHEAN.DONOVAN,20092010,OTT,236.75,2,1,2,3,5,3,0,5,5,26,39,23,7,6,10,204,189,202,189,8,13,0,30138036.21
SHELDON.BROOKBANK,20092010,ANA,987.4,0,8,1,9,9,8,0,0,0,60,120,89,37,20,31,745,960,691,828,38,28,0,30138105.725
SHELDON.SOURAY,20092010,EDM,836.7833333333333,4,6,2,8,12,10,0,0,0,113,236,50,72,12,20,839,786,593,569,19,32,0,30138072.07
SIDNEY.CROSBY,20092010,PIT,2062.4,57,44,27,71,128,101,1147,2049,902,332,564,79,114,40,36,2603,1531,1543,1202,91,64,0.5597852611029771,30138209.555
SIMON.GAGNE,20092010,PHI,1414.1833333333334,26,16,10,26,52,42,4,8,4,235,408,68,97,12,17,1478,1233,960,977,37,37,0.5,30138135.78
STAFFAN.KRONWALL,20092010,CGY,108.98333333333333,1,1,1,2,3,2,0,0,0,6,11,12,3,0,1,102,110,91,103,3,4,0,30138026.775
STEPHANE.ROBIDAS,20092010,DAL,1978.7166666666667,10,18,12,30,40,28,0,0,0,195,386,264,114,9,28,1851,1890,1205,1270,58,66,0,30138151.29
STEPHANE.VEILLEUX,20092010,T.B,946.0666666666666,3,2,4,6,9,5,10,25,15,94,159,88,38,24,17,625,867,576,637,12,27,0.4,30138085.89
STEPHANE.YELLE,20092010,CAR,545.5833333333333,4,1,2,3,7,5,140,292,152,33,56,69,10,7,13,370,583,332,354,8,18,0.4794520547945205,30138062.17
STEPHANE.YELLE,20092010,COL,177.26666666666665,0,0,1,1,1,0,72,161,89,9,16,34,5,2,3,82,226,77,141,4,6,0.4472049689440994,30138035.675
STEPHEN.WEISS,20092010,FLA,1599.5,28,18,14,32,60,46,813,1551,738,179,318,43,66,16,20,1606,1478,1036,1130,49,47,0.5241779497098646,30138186.88
STEVE.BEGIN,20092010,BOS,1143.5666666666666,6,6,2,8,14,12,421,788,367,122,194,225,39,20,27,810,1147,726,826,18,36,0.5342639593908629,30138126.19
STEVE.BERNIER,20092010,VAN,956.0666666666666,15,9,3,12,27,24,7,35,28,112,179,129,32,12,9,920,804,601,664,25,22,0.2,30138100.075
STEVE.DOWNIE,20092010,T.B,1161.1166666666668,22,13,11,24,46,35,17,34,17,116,185,140,26,69,70,1207,903,808,813,50,32,0.5,30138126.195
STEVE.EMINGER,20092010,ANA,1225.6833333333334,4,5,5,10,14,9,0,0,0,45,113,102,35,7,15,927,1278,735,986,40,36,0,30138125.395
STEVE.MACINTYRE,20092010,EDM,6.299999999999999,0,0,0,0,0,0,0,0,0,0,0,0,0,2,2,3,6,3,6,0,0,0,30138016.07
STEVE.MACINTYRE,20092010,FLA,57.016666666666666,0,1,0,1,1,1,0,0,0,3,7,12,1,4,4,28,56,28,55,1,4,0,30138022.89
STEVE.MONTADOR,20092010,BUF,1476.8166666666666,6,4,10,14,20,10,0,1,1,140,262,75,75,16,29,1372,1307,1237,1130,48,45,0,30138122.91
STEVE.OTT,20092010,DAL,1193.2,22,9,5,14,36,31,193,342,149,144,235,250,43,35,56,1140,1170,820,926,32,44,0.564327485380117,30138143.845
STEVE.STAIOS,20092010,CGY,330.8833333333333,1,2,0,2,3,3,0,0,0,16,37,10,13,5,8,283,304,236,270,5,12,0,30138044.85
STEVE.STAIOS,20092010,EDM,753.9833333333333,0,4,3,7,7,4,0,0,0,45,92,44,26,14,25,592,875,517,647,21,35,0,30138087.715
STEVE.SULLIVAN,20092010,NSH,1577.4833333333333,17,22,15,37,54,39,2,14,12,159,272,33,59,17,16,1664,1233,1142,1066,53,45,0.14285714285714285,30138137.225
STEVEN.GOERTZEN,20092010,CAR,46.41666666666667,0,0,0,0,0,0,0,0,0,1,3,11,0,1,1,35,43,35,43,0,2,0,30138019.91
STEVEN.REINPRECHT,20092010,FLA,1319.25,16,15,7,22,38,31,471,988,517,124,206,32,36,21,9,1190,1243,816,1104,43,34,0.4767206477732793,30138176.825
STEVEN.STAMKOS,20092010,T.B,1683.7666666666667,51,26,17,43,94,77,480,1003,523,297,534,68,114,22,18,1852,1466,1002,1093,59,56,0.4785643070787637,30138193.295
STEVEN.ZALEWSKI,20092010,S.J,24.950000000000003,0,0,0,0,0,0,2,5,3,3,4,1,0,0,0,16,23,15,23,0,2,0.4,30138017.98
T.J..GALIARDI,20092010,COL,195.5,1,3,2,5,6,4,38,97,59,15,27,13,6,4,3,104,257,90,143,6,5,0.3917525773195876,30138036.46
T.J..HENSICK,20092010,COL,61.083333333333336,1,2,0,2,3,3,6,13,7,13,18,2,3,0,0,40,70,34,68,3,3,0.46153846153846156,30138025.34
T.J..OSHIE,20092010,STL,1392.2166666666667,18,18,12,30,48,36,64,153,89,158,320,149,71,19,18,1350,1170,894,785,45,40,0.41830065359477125,30138108.65
TANNER.GLASS,20092010,VAN,714.1500000000001,4,5,2,7,11,9,3,18,15,52,89,171,18,28,31,448,633,428,561,17,14,0.16666666666666666,30138086.45
TAYLOR.CHORNEY,20092010,EDM,730.45,0,2,1,3,3,2,0,0,0,35,73,36,24,3,6,484,875,427,685,15,33,0,30138094.405
TAYLOR.PYATT,20092010,ARI,1096.3666666666668,13,6,6,12,25,19,0,1,1,132,228,128,40,18,19,991,1004,871,858,39,26,0,30138110.83
TEDDY.PURCELL,20092010,L.A,466,3,1,2,3,6,4,1,3,2,55,112,28,38,4,3,449,336,366,311,9,8,0.3333333333333333,30138042.43
TEDDY.PURCELL,20092010,T.B,305.51666666666665,3,3,3,6,9,6,1,1,0,46,90,11,25,2,3,315,280,238,262,9,14,1,30138044.035
TEEMU.LAAKSO,20092010,NSH,75.6,0,0,0,0,0,0,0,0,0,5,9,6,2,0,1,45,75,41,72,1,3,0,30138023.700000003
TEEMU.SELANNE,20092010,ANA,935.3,27,18,3,21,48,45,62,131,69,173,269,14,37,8,8,1034,720,585,618,26,18,0.4732824427480916,30138110.785
THEO.PECKHAM,20092010,EDM,241.08333333333331,0,1,0,1,1,1,0,0,0,9,17,48,4,8,12,136,257,120,222,5,11,0,30138043.83
THOMAS.VANEK,20092010,BUF,1231.2333333333331,30,15,11,26,56,45,2,11,9,192,329,49,51,15,22,1325,978,789,828,44,34,0.18181818181818182,30138129.055
TIM.BRENT,20092010,TOR,13.35,0,0,0,0,0,0,4,8,4,3,3,4,0,0,0,7,13,7,13,0,0,0.5,15069009.41
TIM.CONBOY,20092010,CAR,46.33333333333333,0,0,0,0,0,0,0,0,0,5,9,9,1,7,5,32,50,31,49,0,5,0,30138021.72
TIM.CONNOLLY,20092010,BUF,1465.95,17,27,22,49,66,44,389,825,436,222,358,30,74,14,15,1554,1353,928,976,49,35,0.4715151515151515,30138156.35
TIM.GLEASON,20092010,CAR,1263.75,5,5,7,12,17,10,0,0,0,74,166,142,59,19,22,1060,1344,818,907,29,34,0,30138110.915
TIM.JACKMAN,20092010,NYI,521.0333333333333,4,5,0,5,9,9,3,7,4,51,96,114,16,22,28,373,571,366,529,16,20,0.42857142857142855,30138083.939999998
TIM.KENNEDY,20092010,BUF,1096.6166666666668,11,13,5,18,29,24,141,416,275,104,172,102,33,32,24,939,991,831,911,39,39,0.3389423076923077,30138135.985
TIM.SESTITO,20092010,N.J,110.45,0,0,1,1,1,0,34,64,30,7,12,15,3,1,1,67,94,65,88,2,4,0.53125,30138025.945
TIM.STAPLETON,20092010,ATL,71.21666666666667,2,0,0,0,2,2,22,36,14,6,14,1,4,2,1,57,83,55,82,1,0,0.6111111111111112,30138026.15
TIM.WALLACE,20092010,PIT,5.833333333333333,0,0,0,0,0,0,0,0,0,0,0,3,0,0,0,0,10,0,10,0,0,0,15069009
TJ.GALIARDI,20092010,COL,1202.1833333333334,14,10,11,21,35,24,134,243,109,113,220,84,43,19,13,854,1263,675,889,39,38,0.551440329218107,30138130.325
TJ.HENSICK,20092010,COL,5.033333333333333,0,0,0,0,0,0,0,1,1,0,0,0,0,0,0,1,9,1,9,0,0,0,15069008.85
TOBIAS.ENSTROM,20092010,ATL,1826.0666666666666,6,22,22,44,50,28,0,0,0,109,239,20,92,9,15,1816,1394,1192,1180,59,60,0,30138135.490000002
TOBY.PETERSEN,20092010,DAL,836.0999999999999,8,3,3,6,14,11,76,169,93,105,158,93,20,16,3,641,837,586,694,22,22,0.44970414201183434,30138100.725
TODD.BERTUZZI,20092010,DET,1581.0333333333333,20,24,11,35,55,44,12,29,17,235,402,136,81,21,44,1800,1210,1261,1105,54,56,0.41379310344827586,30138144.765
TODD.FEDORUK,20092010,T.B,376.01666666666665,3,3,0,3,6,6,2,2,0,22,40,58,7,11,12,240,362,235,353,7,18,1,30138060.84
TODD.MARCHANT,20092010,ANA,1233.25,9,4,9,13,22,13,284,569,285,83,134,127,20,13,16,748,1456,632,899,21,41,0.4991212653778559,30138139.365000002
TODD.WHITE,20092010,ATL,990.9666666666667,7,9,10,19,26,16,401,745,344,92,157,31,38,10,12,932,875,643,673,28,29,0.538255033557047,30138104.189999998
TOM.GILBERT,20092010,EDM,1838.55,5,14,8,22,27,19,0,0,0,98,207,55,67,6,8,1651,1839,1172,1304,53,59,0,30138151.96
TOM.KOSTOPOULOS,20092010,CAR,1018.6333333333334,8,7,6,13,21,15,10,21,11,103,184,154,44,29,33,794,1059,725,787,30,30,0.47619047619047616,30138106.439999998
TOM.POTI,20092010,WSH,1626.6999999999998,4,14,9,23,27,18,0,0,0,75,153,23,53,14,21,1530,1662,1261,1067,61,33,0,30138113.115
TOM.PREISSING,20092010,COL,52.31666666666666,0,1,0,1,1,1,0,0,0,6,11,3,2,0,0,56,41,41,38,0,5,0,30138019.2
TOM.PYATT,20092010,MTL,677.6500000000001,4,3,2,5,9,7,26,57,31,74,109,37,19,4,6,497,811,467,602,17,24,0.45614035087719296,30138087.08
TOM.SESTITO,20092010,CBJ,11.716666666666667,0,0,0,0,0,0,0,0,0,0,0,2,0,0,1,7,12,7,12,0,0,0,30138016.6
TOM.WANDELL,20092010,DAL,677.1166666666666,5,7,3,10,15,12,211,476,265,83,159,43,45,21,7,561,646,517,460,16,16,0.4432773109243697,30138073.125
TOMAS.FLEISCHMANN,20092010,WSH,1186.6,23,19,9,28,51,42,170,393,223,129,256,40,63,11,17,1316,1103,867,860,49,40,0.43256997455470736,30138129.634999998
TOMAS.HOLMSTROM,20092010,DET,1236.9499999999998,29,11,12,23,52,40,0,1,1,156,253,80,29,29,37,1553,751,991,697,44,36,0,30138099.990000002
TOMAS.KABERLE,20092010,TOR,1830.9833333333331,7,21,18,39,46,28,0,0,0,158,306,44,87,4,12,2207,1375,1437,1190,55,58,0,30138127.89
TOMAS.KANA,20092010,CBJ,52.083333333333336,0,1,1,2,2,1,0,0,0,4,7,11,2,1,1,34,41,33,40,2,0,0,30138019.735
TOMAS.KOPECKY,20092010,CHI,932,14,9,3,12,26,23,68,148,80,123,207,110,44,16,20,964,644,801,622,33,29,0.4594594594594595,30138084.305
TOMAS.PLEKANEC,20092010,MTL,2015.6666666666667,29,29,22,51,80,58,971,1996,1025,255,446,63,113,32,33,1822,2137,1171,1395,55,49,0.4864729458917836,30138237.96
TOMMY.SESTITO,20092010,CBJ,4.966666666666667,0,0,0,0,0,0,0,0,0,0,0,1,0,1,1,4,4,4,4,0,0,0,15069008.06
TONI.LYDMAN,20092010,BUF,1420.1,4,4,12,16,20,8,0,0,0,86,167,143,55,3,18,1235,1372,1032,1092,42,33,0,30138125.58
TORREY.MITCHELL,20092010,S.J,822.2666666666667,2,6,5,11,13,8,94,215,121,79,135,83,32,23,12,712,692,642,564,18,18,0.4372093023255814,30138076.165
TRAVIS.MOEN,20092010,MTL,1466.0833333333333,10,8,4,12,22,18,3,15,12,125,203,205,39,27,22,1057,1569,974,1176,33,38,0.2,30138153.990000002
TRAVIS.ZAJAC,20092010,N.J,1765.2333333333333,26,22,21,43,69,48,771,1453,682,222,350,67,61,16,12,1795,1369,1231,1034,57,34,0.5306262904335857,30138162.175
TRENT.HUNTER,20092010,NYI,909.5,11,7,8,15,26,18,2,9,7,159,298,123,78,9,9,1068,755,720,668,23,23,0.2222222222222222,30138085.92
TRENT.WHITFIELD,20092010,BOS,210.83333333333331,0,1,0,1,1,1,121,207,86,17,27,17,7,3,2,148,175,141,140,4,7,0.5845410628019324,30138032.12
TREVOR.DALEY,20092010,DAL,1689.9833333333333,6,8,7,15,21,14,0,0,0,107,208,36,55,2,11,1479,1787,1125,1341,51,51,0,30138160.145
TREVOR.FRISCHMON,20092010,CBJ,18.3,0,0,0,0,0,0,4,6,2,1,3,3,0,0,2,11,6,11,6,0,0,0.6666666666666666,30138015.76
TREVOR.GILLIES,20092010,NYI,53.483333333333334,0,0,1,1,1,0,0,0,0,6,8,14,1,8,18,40,50,40,50,2,4,0,30138023.205
TREVOR.LEWIS,20092010,L.A,45.63333333333333,0,0,0,0,0,0,0,5,5,4,6,8,1,0,0,28,48,27,44,0,3,0,30138020.55
TRISTON.GRANT,20092010,NSH,21.71666666666667,0,0,0,0,0,0,0,0,0,2,3,5,1,1,3,17,17,16,17,0,1,0,15069009.66
TROY.BODIE,20092010,ANA,494.66666666666663,5,1,1,2,7,6,0,1,1,58,103,62,16,12,19,362,543,347,469,11,20,0,30138073.994999997
TROY.BROUWER,20092010,CHI,1486.4166666666665,26,12,10,22,48,38,10,16,6,137,234,240,46,15,27,1464,1194,1078,911,49,43,0.625,30138120.3
TUOMO.RUUTU,20092010,CAR,867.7,14,9,10,19,33,23,19,47,28,118,217,152,52,26,18,943,667,638,591,26,28,0.40425531914893614,30138085.619999997
TYLER.BOZAK,20092010,TOR,711.5833333333334,8,7,12,19,27,15,358,648,290,51,93,52,28,8,3,752,615,477,455,26,24,0.5524691358024691,30138075.65
TYLER.ECKFORD,20092010,N.J,22.133333333333333,0,0,1,1,1,0,0,0,0,1,1,1,0,0,2,16,14,6,14,0,0,0,30138017.225
TYLER.ENNIS,20092010,BUF,256.25,4,5,4,9,13,9,14,35,21,43,71,5,14,2,3,271,203,190,174,10,9,0.4,30138037.38
TYLER.KENNEDY,20092010,PIT,912.1333333333333,13,11,1,12,25,24,27,70,43,193,344,83,81,12,11,997,769,921,730,36,31,0.38571428571428573,30138089.425
TYLER.MYERS,20092010,BUF,2101.15,12,18,17,35,47,30,0,0,0,121,286,104,84,23,18,1845,2004,1304,1342,68,57,0,30138156.854999997
TYLER.SLOAN,20092010,WSH,595.9,2,2,2,4,6,4,2,3,1,34,60,58,18,5,11,524,619,494,520,22,23,0.6666666666666666,30138068.380000003
TYSON.STRACHAN,20092010,STL,112.26666666666665,0,1,1,2,2,1,0,0,0,7,15,8,5,3,2,88,117,77,104,4,2,0,30138026.705
VACLAV.PROSPAL,20092010,NYR,423.08333333333337,5,12,4,16,21,17,131,259,128,47,79,20,17,1,4,475,322,302,266,17,9,0.5057915057915058,30138053.15
VALTTERI.FILPPULA,20092010,DET,1225.6833333333334,15,21,8,29,44,36,312,607,295,147,244,47,56,20,15,1321,1002,920,810,32,40,0.514003294892916,30138121.380000003
VERNON.FIDDLER,20092010,ARI,1174.6166666666668,9,14,9,23,32,23,642,1220,578,127,213,106,37,34,23,875,1338,759,777,37,31,0.5262295081967213,30138129.795
VICTOR.HEDMAN,20092010,T.B,1542.7666666666667,4,8,8,16,20,12,0,0,0,90,217,59,83,22,33,1310,1503,1041,1087,54,55,0,30138122.92
VICTOR.ORESKOVICH,20092010,FLA,444.35,2,3,1,4,6,5,1,3,2,55,80,99,14,11,11,315,476,305,449,10,17,0.3333333333333333,30138071.225
VIKTOR.STALBERG,20092010,TOR,584.35,9,2,3,5,14,11,3,9,6,117,197,64,28,15,13,652,525,492,450,12,24,0.3333333333333333,30138067.745
VILLE.KOISTINEN,20092010,FLA,133.18333333333334,1,0,2,2,3,1,0,0,0,12,22,8,7,3,4,124,98,69,92,2,1,0,30138026.08
VILLE.LEINO,20092010,DET,555,4,2,1,3,7,6,1,5,4,54,115,12,25,6,3,626,410,479,381,11,20,0.2,30138050.175
VILLE.LEINO,20092010,PHI,473.6333333333333,9,9,7,16,25,18,18,44,26,59,105,25,22,9,5,489,372,414,345,27,13,0.4090909090909091,30138055.384999998
VINCENT.LECAVALIER,20092010,T.B,1622.0166666666667,24,23,23,46,70,47,770,1445,675,295,490,79,98,22,26,1690,1346,1011,1059,48,48,0.532871972318339,30138177.495
VINNY.PROSPAL,20092010,NYR,1083.7833333333333,15,14,8,22,37,29,195,379,184,133,219,75,48,7,12,1121,855,762,713,38,27,0.5145118733509235,30138105.52
VLADIMIR.MIHALIK,20092010,T.B,46.15,0,0,0,0,0,0,0,0,0,1,3,3,1,0,1,32,34,28,30,0,3,0,30138018.15
VLADIMIR.SOBOTKA,20092010,BOS,850.3666666666667,4,7,1,8,12,11,263,485,222,78,132,176,24,19,20,728,669,690,625,17,32,0.5422680412371134,30138090.384999998
VLADIMIR.ZHARKOV,20092010,N.J,457.6166666666667,0,5,5,10,10,5,1,4,3,54,100,22,14,17,3,436,285,374,266,12,10,0.25,30138038.884999998
VYACHESLAV.KOZLOV,20092010,ATL,839.65,8,9,9,18,26,17,6,15,9,112,188,17,41,6,12,882,625,580,549,19,30,0.4,30138078.425
WADE.BELAK,20092010,NSH,169.81666666666666,0,2,0,2,2,2,0,0,0,8,15,30,3,12,14,118,152,114,148,4,4,0,30138034.17
WADE.REDDEN,20092010,NYR,1313.8833333333332,2,5,7,12,14,7,1,1,0,65,151,88,51,9,12,1107,1229,989,955,42,33,1,30138104.655
WARREN.PETERS,20092010,DAL,79.38333333333333,1,0,0,0,1,1,39,80,41,8,17,27,4,0,1,45,83,42,68,2,1,0.4875,30138025.11
WAYNE.PRIMEAU,20092010,TOR,651.7,3,3,2,5,8,6,282,511,229,47,76,58,16,8,12,524,724,496,512,17,17,0.5518590998043053,30138078.810000002
WAYNE.SIMMONDS,20092010,L.A,1214.7166666666667,18,14,11,25,43,32,3,11,8,141,262,149,62,38,45,1058,1091,990,976,52,35,0.2727272727272727,30138130.475
WES.O'NEILL,20092010,COL,19.433333333333334,0,0,0,0,0,0,0,0,0,1,2,1,0,0,1,13,16,13,14,0,0,0,15069009.15
WILLIE.MITCHELL,20092010,VAN,1085.2333333333333,4,4,4,8,12,8,0,0,0,47,104,32,40,11,17,823,1117,717,730,33,27,0,30138088.009999998
WOJTEK.WOLSKI,20092010,ARI,446.2166666666667,10,9,4,13,23,19,7,17,10,53,90,13,13,3,3,520,311,343,278,23,13,0.4117647058823529,30138049.96
WOJTEK.WOLSKI,20092010,COL,1174.6333333333332,17,15,15,30,47,32,11,23,12,156,251,30,52,15,9,1164,1031,781,852,43,26,0.4782608695652174,30138120.565
YAN.STASTNY,20092010,STL,37.983333333333334,1,0,0,0,1,1,9,15,6,7,8,9,0,0,0,25,42,25,33,1,0,0.6,30138019.810000002
YANNICK.WEBER,20092010,MTL,69.38333333333333,0,0,0,0,0,0,0,0,0,2,15,1,10,0,2,70,61,62,60,1,6,0,30138019.65
ZACH.BOGOSIAN,20092010,ATL,1734.2,10,3,9,12,22,13,0,0,0,154,338,196,102,18,25,1536,1724,1204,1308,50,67,0,30138149.155
ZACH.BOYCHUK,20092010,CAR,333.35,3,4,2,6,9,7,5,9,4,37,74,23,20,12,1,323,320,290,310,13,12,0.5555555555555556,30138048.770000003
ZACH.HAMILL,20092010,BOS,12.133333333333333,0,0,1,1,1,0,1,4,3,1,2,0,0,1,0,7,15,6,15,1,0,0.25,15069009.575
ZACH.PARISE,20092010,N.J,1704.8666666666668,39,29,18,47,86,68,19,52,33,367,542,111,73,50,15,1889,1263,1264,1066,63,37,0.36538461538461536,30138158.46
ZACHERY.STORTINI,20092010,EDM,214.9,2,1,0,1,3,3,8,23,15,12,30,36,11,11,13,167,201,140,194,6,4,0.34782608695652173,30138039.83
ZACK.SMITH,20092010,OTT,180.15,2,1,0,1,3,3,37,76,39,18,36,45,6,4,5,151,158,139,135,3,8,0.4868421052631579,30138032.17
ZACK.STORTINI,20092010,EDM,500.3833333333333,2,4,3,7,9,6,79,160,81,34,73,108,16,21,29,379,521,373,516,21,20,0.49375,30138081.545
ZBYNEK.MICHALEK,20092010,ARI,1770.0333333333333,3,5,10,15,18,8,0,0,0,114,213,91,60,11,16,1404,1913,1110,1250,57,56,0,30138143.259999998
ZDENO.CHARA,20092010,BOS,2395.5166666666664,9,25,17,42,51,34,1,2,1,275,533,190,177,33,39,2407,1925,1707,1398,63,52,0.5,30138144.645
ZENON.KONOPKA,20092010,T.B,602.2666666666667,2,2,1,3,5,4,288,462,174,41,66,108,8,55,59,410,496,374,473,12,21,0.6233766233766234,30138084.095
AARON.GAGNON,20102011,DAL,153.2,0,0,2,2,2,0,30,55,25,9,26,12,7,0,1,133,136,127,121,3,6,0.5454545454545454,30153028.5
AARON.PALUSHAJ,20102011,MTL,25.550000000000004,0,0,0,0,0,0,0,1,1,3,6,3,2,1,1,31,30,29,29,1,0,0,30153019.310000002
AARON.ROME,20102011,VAN,1157.4,2,3,1,4,6,5,0,0,0,60,134,109,46,8,30,968,1079,873,880,34,31,0,30153103.555
AARON.VOLPATTI,20102011,VAN,102.46666666666667,1,1,0,1,2,2,0,0,0,6,12,36,4,3,5,80,84,72,84,2,3,0,30153026.93
AARON.VOROS,20102011,ANA,66.53333333333333,0,0,0,0,0,0,2,3,1,8,10,12,1,8,8,53,61,53,61,1,5,0.6666666666666666,30153024.409999996
ADAM.BURISH,20102011,DAL,904.0333333333333,8,3,3,6,14,11,255,477,222,89,142,77,21,18,25,628,1006,583,716,23,23,0.5345911949685535,30153112.555
ADAM.CRACKNELL,20102011,STL,214.16666666666666,3,3,1,4,7,6,46,118,72,26,47,29,9,2,4,179,194,174,185,10,9,0.3898305084745763,30153041.585
ADAM.FOOTE,20102011,COL,842.4833333333333,0,3,5,8,8,3,0,0,0,23,41,55,12,9,14,575,969,535,696,24,36,0,30153094.115000002
ADAM.HALL,20102011,T.B,1467.65,8,8,5,13,21,16,451,814,363,184,277,167,33,29,17,957,1587,873,998,30,45,0.5540540540540541,30153149.155
ADAM.HENRIQUE,20102011,N.J,13.35,0,0,0,0,0,0,0,1,1,3,3,0,0,0,0,11,8,8,8,1,0,0,15076509.1
ADAM.MAIR,20102011,N.J,591.1166666666667,1,2,1,3,4,3,57,111,54,58,90,63,13,15,16,406,485,388,441,6,22,0.5135135135135135,30153069.855
ADAM.MCQUAID,20102011,BOS,1295.3666666666668,3,7,9,16,19,10,0,0,0,59,166,132,83,23,29,1136,1298,1090,1083,63,32,0,30153116.705
ADAM.PARDY,20102011,CGY,440.6166666666667,1,4,2,6,7,5,0,0,0,36,81,42,33,6,12,443,366,422,333,21,17,0,30153043.96
ADRIAN.AUCOIN,20102011,ARI,1701.8,3,11,8,19,22,14,1,1,0,102,246,140,85,10,27,1428,1815,1240,1264,55,51,1,30153141.09
ALEC.MARTINEZ,20102011,L.A,997.6833333333334,5,4,8,12,17,9,0,0,0,79,206,73,88,2,10,1043,725,829,681,35,24,0,30153070.520000003
ALES.HEMSKY,20102011,EDM,859.2666666666667,14,21,7,28,42,35,1,7,6,100,183,29,46,12,8,816,771,544,624,29,31,0.14285714285714285,30153100.134999998
ALES.KOTALIK,20102011,CGY,321.7,4,1,1,2,6,5,6,11,5,62,103,38,17,4,4,340,266,284,249,7,13,0.5454545454545454,30153043.405
ALEX.BOLDUC,20102011,VAN,189.35000000000002,2,2,0,2,4,4,46,101,55,23,31,34,3,7,5,121,203,116,188,6,5,0.45544554455445546,30153044.31
ALEX.BURMISTROV,20102011,ATL,978.0666666666666,6,5,7,12,18,11,289,696,407,92,167,62,41,27,12,750,947,680,785,26,35,0.41522988505747127,30153121.805
ALEX.BURROWS,20102011,VAN,1743.1,35,10,20,30,65,45,16,34,18,214,369,127,73,44,39,1697,1593,1392,1128,68,50,0.47058823529411764,30153144.18
ALEX.EDLER,20102011,VAN,1858.25,10,17,14,31,41,27,0,2,2,178,418,161,139,6,16,2063,1613,1406,1206,60,46,0,30153126.11
ALEX.FROLOV,20102011,NYR,620.3333333333333,7,5,4,9,16,12,1,7,6,78,125,39,23,4,4,613,522,473,473,18,12,0.14285714285714285,30153070.43
ALEX.GIROUX,20102011,EDM,118.06666666666666,1,0,1,1,2,1,0,2,2,13,25,16,8,4,1,114,82,78,73,3,4,0,30153023.615
ALEX.GOLIGOSKI,20102011,DAL,599.6166666666668,5,3,7,10,15,8,0,0,0,61,138,24,51,5,6,643,500,392,354,14,16,0,30153049.925
ALEX.GOLIGOSKI,20102011,PIT,1245.9333333333334,9,10,12,22,31,19,0,0,0,101,254,51,97,9,15,1385,983,875,789,50,29,0,30153089.14
ALEX.KOVALEV,20102011,OTT,878.5166666666667,14,9,3,12,26,23,2,6,4,123,229,10,63,7,9,865,775,625,693,21,28,0.3333333333333333,30153099.325
ALEX.KOVALEV,20102011,PIT,455.78333333333336,3,3,3,6,9,6,1,4,3,44,107,7,39,5,13,571,273,370,243,13,13,0.25,30153034.965000004
ALEX.OVECHKIN,20102011,WSH,1887.1166666666668,37,32,26,58,95,69,9,21,12,397,869,279,291,41,29,2455,1452,1529,1261,60,46,0.42857142857142855,30153147.12
ALEX.PICARD,20102011,MTL,706.35,3,4,1,5,8,7,0,0,0,49,116,55,44,9,7,766,558,691,490,23,22,0,30153053.365000002
ALEX.PIETRANGELO,20102011,STL,1738.0833333333333,11,13,18,31,42,24,0,0,0,161,352,57,117,12,8,1767,1361,1239,1037,66,47,0,30153108.22
ALEX.PLANTE,20102011,EDM,45.15,0,0,0,0,0,0,0,0,0,5,6,4,1,2,4,47,42,46,37,1,3,0,15076512.07
ALEX.SEMIN,20102011,WSH,1335.0666666666666,32,19,9,28,60,51,4,12,8,224,507,33,147,18,32,1620,1037,1025,862,52,30,0.3333333333333333,30153114.765
ALEX.STEEN,20102011,STL,1407.7,20,16,12,28,48,36,41,106,65,218,457,39,119,28,14,1560,998,1053,805,41,44,0.3867924528301887,30153100.42
ALEX.SULZER,20102011,FLA,152.95,0,1,0,1,1,1,0,0,0,7,18,9,8,2,0,128,130,117,116,3,6,0,30153027.32
ALEX.SULZER,20102011,NSH,548.8666666666667,1,2,1,3,4,3,1,1,0,30,67,29,21,6,7,480,482,400,403,13,15,1,30153056.325
ALEX.TANGUAY,20102011,CGY,1561.1166666666668,22,33,14,47,69,55,42,107,65,120,204,31,36,18,12,1553,1321,994,993,60,48,0.3925233644859813,30153146.76
ALEX.URBOM,20102011,N.J,100.63333333333334,1,0,0,0,1,1,0,0,0,5,16,5,4,2,0,81,72,77,69,1,3,0,30153023.22
ALEX.VASYUNOV,20102011,N.J,206.56666666666666,1,4,0,4,5,5,0,0,0,18,32,6,9,3,0,163,127,159,121,6,6,0,30153028.28
ALEXEI.PONIKAROVSKY,20102011,L.A,809.2666666666667,6,6,4,10,16,12,5,11,6,99,171,149,36,12,17,740,678,618,578,21,17,0.45454545454545453,30153079.42
ANDRE.BENOIT,20102011,OTT,134.68333333333334,0,1,0,1,1,1,0,0,0,17,27,5,6,1,3,124,119,94,113,3,4,0,30153029.259999998
ANDREAS.ENGQVIST,20102011,MTL,26.283333333333335,0,0,0,0,0,0,7,19,12,1,4,2,2,0,0,14,25,13,16,0,0,0.3684210526315789,30153018.53
ANDREAS.LILJA,20102011,ANA,939.65,1,1,3,4,5,2,0,0,0,31,61,96,17,3,14,543,1101,504,748,15,33,0,30153103.855
ANDREAS.NODL,20102011,PHI,904.1666666666666,11,7,4,11,22,18,12,20,8,101,154,119,26,13,8,844,875,778,786,31,24,0.6,30153105.46
ANDREAS.THURESSON,20102011,NSH,30.433333333333337,0,0,0,0,0,0,0,2,2,2,6,8,2,0,1,30,27,30,27,0,1,0,30153019.1
ANDREI.KOSTITSYN,20102011,MTL,1396.9,22,17,7,24,46,39,0,2,2,211,382,160,92,8,22,1486,1269,1142,1170,44,42,0,30153153.805
ANDREI.LOKTIONOV,20102011,L.A,280.45000000000005,4,3,0,3,7,7,23,55,32,26,54,6,12,1,1,277,203,196,192,8,5,0.41818181818181815,30153039.78
ANDREI.MARKOV,20102011,MTL,160.40000000000003,1,1,1,2,3,2,0,0,0,20,37,2,8,2,2,166,134,123,101,5,3,0,30153026.195
ANDREJ.MESZAROS,20102011,PHI,1997.0333333333333,10,16,10,26,36,26,0,0,0,165,356,209,121,3,25,1979,1895,1473,1459,76,52,0,30153160.73
ANDREJ.SEKERA,20102011,BUF,1634.8333333333335,4,10,13,23,27,14,0,0,0,91,238,62,97,13,15,1573,1432,1197,1098,61,46,0,30153113.855
ANDREW.ALBERTS,20102011,VAN,750.9333333333334,1,4,1,5,6,5,0,0,0,27,66,142,31,11,22,601,751,561,618,22,31,0,30153080.935000002
ANDREW.BRUNETTE,20102011,MIN,1377.55,18,19,9,28,46,37,7,18,11,117,154,27,13,18,9,1309,1094,861,1006,32,33,0.3888888888888889,30153149.185000002
ANDREW.COGLIANO,20102011,EDM,1414.45,11,19,4,23,34,30,461,1108,647,129,233,89,61,17,21,1118,1443,897,1007,31,48,0.41606498194945846,30153164.86
ANDREW.DESJARDINS,20102011,S.J,141.8,2,1,1,2,4,3,34,65,31,16,32,38,12,1,4,145,133,143,124,6,6,0.5230769230769231,30153029.895
ANDREW.EBBETT,20102011,ARI,354.41666666666663,2,1,1,2,4,3,104,234,130,26,49,15,14,5,2,294,358,276,284,7,9,0.4444444444444444,30153051.285
ANDREW.FERENCE,20102011,BOS,1773.85,7,4,14,18,25,11,0,0,0,116,268,106,102,24,26,1572,1807,1414,1477,71,46,0,30153159.490000002
ANDREW.GORDON,20102011,WSH,78.03333333333333,1,1,0,1,2,2,0,0,0,5,17,5,5,1,0,68,44,58,41,3,5,0,30153020.060000002
ANDREW.HUTCHINSON,20102011,PIT,76.5,0,0,0,0,0,0,0,0,0,2,10,0,4,0,2,60,56,43,46,0,3,0,30153021.049999997
ANDREW.LADD,20102011,ATL,1625.8333333333335,29,15,14,29,58,44,15,44,29,195,336,68,77,14,15,1782,1553,1201,1133,46,51,0.3409090909090909,30153150.99
ANDREW.MACDONALD,20102011,NYI,1404.8500000000001,4,9,14,23,27,13,0,0,0,72,196,38,81,8,14,1301,1405,886,1050,43,41,0,30153125.68
ANDREW.MURRAY,20102011,CBJ,330.04999999999995,4,2,2,4,8,6,19,40,21,48,73,77,14,6,2,270,283,256,226,6,6,0.475,30153042.27
ANDREY.ZUBAREV,20102011,ATL,80.30000000000001,0,1,0,1,1,1,0,0,0,2,4,15,2,1,2,71,66,65,56,2,6,0,30153022.009999998
ANDY.GREENE,20102011,N.J,1833.5833333333335,4,8,11,19,23,12,0,0,0,91,210,49,78,6,10,1441,1451,1194,1126,38,61,0,30153122.435000002
ANDY.MCDONALD,20102011,STL,1162.0166666666667,20,15,14,29,49,35,207,349,142,180,280,40,37,7,13,1279,875,891,725,45,26,0.5931232091690545,30153107.75
ANDY.SUTTON,20102011,ANA,583.6833333333334,0,2,1,3,3,2,0,0,0,30,51,63,8,7,31,371,682,348,495,16,18,0,30153077.145
ANSSI.SALMELA,20102011,N.J,835.05,1,1,4,5,6,2,0,0,0,57,97,48,21,4,7,623,663,558,594,19,28,0,30153077.189999998
ANTHONY.STEWART,20102011,ATL,1197.8333333333335,14,15,9,24,38,29,7,18,11,141,235,98,44,12,14,1095,1113,883,1002,42,51,0.3888888888888889,30153138.225
ANTOINE.VERMETTE,20102011,CBJ,1542.7666666666667,19,13,15,28,47,32,855,1539,684,183,321,123,66,14,28,1596,1251,1064,938,41,40,0.5555555555555556,30153148.665
ANTON.BABCHUK,20102011,CAR,313.8666666666667,3,3,2,5,8,6,0,0,0,45,87,2,24,2,6,337,300,243,236,6,12,0,30153042.32
ANTON.BABCHUK,20102011,CGY,1015.5,8,5,14,19,27,13,0,0,0,87,221,17,78,5,11,1099,876,827,767,44,24,0,30153087.35
ANTON.STRALMAN,20102011,CBJ,1006.45,1,7,9,16,17,8,0,0,0,80,175,39,56,9,11,1055,756,731,658,24,34,0,30153077.615000002
ANTON.VOLCHENKOV,20102011,N.J,1032,0,5,2,7,7,5,0,0,0,65,130,125,39,6,18,778,865,723,677,31,31,0,30153080.31
ANTTI.MIETTINEN,20102011,MIN,1242.8666666666668,16,7,12,19,35,23,36,100,64,165,279,109,56,11,17,1120,1013,743,797,25,28,0.36,30153116.45
ANZE.KOPITAR,20102011,L.A,1619.0500000000002,25,30,18,48,73,55,579,1160,581,233,408,92,94,26,10,1708,1341,1135,970,62,32,0.4991379310344828,30153153.869999997
ARRON.ASHAM,20102011,PIT,490.3833333333333,8,5,2,7,15,13,3,10,7,68,96,128,20,11,14,413,433,409,433,18,17,0.3,30153069.73
ARTEM.ANISIMOV,20102011,NYR,1403.8833333333332,19,14,12,26,45,33,323,726,403,199,351,80,87,17,10,1309,1190,985,982,45,37,0.44490358126721763,30153145.19
ARTURS.KULDA,20102011,ATL,22.116666666666667,0,0,0,0,0,0,0,0,0,3,4,4,1,1,1,29,25,29,25,1,3,0,15076510.56
B.J..CROMBEEN,20102011,STL,1023.8,7,1,6,7,14,8,19,64,45,113,209,93,50,25,40,816,1039,765,797,24,45,0.296875,30153106.560000002
BARRET.JACKMAN,20102011,STL,1248.4333333333334,0,2,9,11,11,2,0,0,0,65,151,78,57,22,22,1019,1233,936,907,46,44,0,30153098.845
BEN.EAGER,20102011,ATL,416.6166666666667,3,4,3,7,10,7,0,2,2,41,72,48,15,11,18,315,430,302,413,15,11,0,30153068.335
BEN.EAGER,20102011,S.J,355.7,5,3,0,3,8,8,0,0,0,54,81,49,14,12,24,351,365,350,362,9,11,0,30153061.42
BEN.HOLMSTROM,20102011,PHI,18.15,0,0,0,0,0,0,5,16,11,0,1,8,1,2,1,10,21,8,12,0,1,0.3125,30153018.42
BEN.LOVEJOY,20102011,PIT,781.4166666666666,3,9,6,15,18,12,0,0,0,68,165,45,57,9,20,769,700,717,630,32,23,0,30153075.79
BEN.MAXWELL,20102011,ATL,143.93333333333334,1,0,1,1,2,1,16,36,20,13,20,1,1,4,3,134,115,119,102,2,8,0.4444444444444444,30153028.155
BEN.SMITH,20102011,CHI,186.56666666666666,4,0,0,0,4,4,9,16,7,12,18,18,4,0,0,140,163,126,152,7,6,0.5625,30153035.009999998
BENN.FERRIERO,20102011,S.J,487.1166666666667,6,3,1,4,10,9,2,13,11,59,117,54,33,6,5,529,402,451,391,19,11,0.15384615384615385,30153055.015
BENOIT.POULIOT,20102011,MTL,929.9166666666666,13,12,5,17,30,25,10,22,12,129,213,113,42,19,31,1021,796,908,753,35,32,0.45454545454545453,30153100.365000002
BILL.THOMAS,20102011,FLA,194.35,4,1,2,3,7,5,13,22,9,32,45,19,1,4,3,158,168,155,158,7,6,0.5909090909090909,30153037.16
BLAIR.BETTS,20102011,PHI,914.1833333333334,5,3,4,7,12,8,464,952,488,57,95,90,22,9,4,478,1129,393,567,10,23,0.48739495798319327,30153105.85
BLAIR.JONES,20102011,T.B,189.06666666666666,1,2,0,2,3,3,51,96,45,25,43,28,12,4,2,173,144,172,140,4,7,0.53125,30153031.63
BLAKE.COMEAU,20102011,NYI,1439.2333333333333,24,16,6,22,46,40,35,112,77,181,359,119,107,16,20,1237,1362,875,1006,36,48,0.3125,30153143.96
BLAKE.GEOFFRION,20102011,NSH,256.9,6,0,4,4,10,6,73,149,76,36,54,21,12,3,4,213,219,203,214,12,8,0.4899328859060403,30153044.85
BLAKE.WHEELER,20102011,ATL,434.1333333333333,7,7,3,10,17,14,0,12,12,78,122,18,20,3,7,525,344,421,284,16,12,0,30153047.205
BLAKE.WHEELER,20102011,BOS,881.9,11,9,7,16,27,20,52,136,84,101,170,56,33,11,16,827,872,669,716,30,23,0.38235294117647056,30153105.415
BOBBY.BUTLER,20102011,OTT,555.45,10,6,5,11,21,16,0,2,2,73,116,28,18,7,5,574,479,439,454,19,31,0,30153072.345
BOBBY.RYAN,20102011,ANA,1736.7166666666667,37,26,12,38,75,63,87,227,140,280,444,163,70,39,26,1686,1583,1210,1277,73,54,0.3832599118942731,30153191.62
BOYD.GORDON,20102011,WSH,898.9666666666667,3,4,2,6,9,7,492,829,337,90,149,39,32,6,11,589,873,539,586,17,26,0.5934861278648975,30153092.689999998
BRAD.BOYES,20102011,BUF,446.6333333333333,6,5,4,9,15,11,106,231,125,60,88,15,14,1,3,453,420,335,385,20,19,0.4588744588744589,30153068.3
BRAD.BOYES,20102011,STL,1064.5333333333333,12,15,14,29,41,27,56,135,79,132,257,56,64,10,11,1147,785,859,712,40,26,0.4148148148148148,30153094.19
BRAD.LUKOWICH,20102011,DAL,51.31666666666667,0,0,0,0,0,0,0,0,0,3,6,5,2,1,0,63,48,63,48,3,1,0,30153019.96
BRAD.MARCHAND,20102011,BOS,1495.9,32,19,9,28,60,51,10,31,21,210,327,119,63,32,39,1456,1527,1298,1228,64,38,0.3225806451612903,30153167.895
BRAD.RICHARDS,20102011,DAL,1563.7833333333333,28,32,17,49,77,60,501,989,488,271,547,20,154,9,7,1770,1264,954,1049,54,37,0.506572295247725,30153167.505000003
BRAD.RICHARDSON,20102011,L.A,893.35,9,9,6,15,24,18,119,244,125,120,219,95,54,23,19,811,826,774,707,30,45,0.48770491803278687,30153097.09
BRAD.STAUBITZ,20102011,MIN,462.6166666666667,4,3,2,5,9,7,0,4,4,29,51,133,10,31,46,258,450,253,441,13,17,0,30153080.009999998
BRAD.STUART,20102011,DET,1679.6166666666668,3,8,9,17,20,11,0,0,0,91,189,150,58,15,21,1398,1764,1217,1196,61,57,0,30153132.225
BRAD.WINCHESTER,20102011,ANA,215.08333333333331,1,0,1,1,2,1,1,2,1,25,36,54,4,10,12,163,191,122,185,2,10,0.5,30153041.215
BRAD.WINCHESTER,20102011,STL,597.8666666666667,9,2,2,4,13,11,2,7,5,67,112,119,24,27,22,514,465,417,449,17,25,0.2857142857142857,30153071.549999997
BRADLEY.MILLS,20102011,N.J,33.099999999999994,1,0,0,0,1,1,7,17,10,6,6,7,0,1,1,25,32,22,29,1,0,0.4117647058823529,30153021.189999998
BRANDON.DUBINSKY,20102011,NYR,1681.1666666666665,26,19,12,31,57,45,491,959,468,209,360,161,79,32,36,1607,1576,1066,1123,51,59,0.5119916579770595,30153176.36
BRANDON.MASHINTER,20102011,S.J,82.9,0,0,0,0,0,0,0,0,0,5,14,16,2,4,4,71,71,68,70,2,4,0,30153023.89
BRANDON.MCMILLAN,20102011,ANA,923.2166666666667,12,7,4,11,23,19,119,309,190,85,144,65,26,8,9,591,1074,496,786,21,31,0.3851132686084142,30153129.09
BRANDON.PIRRI,20102011,CHI,8.933333333333334,0,0,0,0,0,0,2,6,4,1,1,0,0,1,0,8,12,8,12,0,1,0.3333333333333333,15076509.89
BRANDON.PRUST,20102011,NYR,1214.55,13,7,10,17,30,20,4,11,7,95,156,185,32,47,41,976,1239,906,972,31,35,0.36363636363636365,30153132.93
BRANDON.SEGAL,20102011,DAL,381.26666666666665,5,2,3,5,10,7,2,4,2,40,78,91,16,10,13,292,324,275,319,14,13,0.5,30153055.055
BRANDON.SUTTER,20102011,CAR,1382.3666666666668,14,13,2,15,29,27,596,1342,746,145,243,69,44,22,11,1088,1508,914,1071,40,33,0.44411326378539495,30153176.41
BRANDON.YIP,20102011,COL,975.0333333333333,12,6,4,10,22,18,5,14,9,127,206,77,38,17,23,802,903,612,809,24,43,0.35714285714285715,30153120.32
BRAYDEN.SCHENN,20102011,L.A,89.98333333333333,0,2,0,2,2,2,17,51,34,11,13,12,0,2,0,57,87,42,80,3,3,0.3333333333333333,30153029.15
BRAYDON.COBURN,20102011,PHI,1992.2833333333333,3,10,5,15,18,13,0,0,0,135,289,209,87,6,29,1738,1985,1503,1501,72,70,0,30153161.785
BRENDAN.MIKKELSON,20102011,ANA,97,0,0,1,1,1,0,0,0,0,4,6,6,2,3,2,50,139,48,81,2,3,0,30153026.255000003
BRENDAN.MIKKELSON,20102011,CGY,244.48333333333335,0,1,0,1,1,1,0,0,0,10,30,15,10,2,1,216,241,202,223,6,11,0,30153038.67
BRENDAN.MORRISON,20102011,CGY,1101.8833333333332,9,16,17,33,42,25,378,762,384,89,149,22,33,17,9,1006,991,674,717,36,28,0.49606299212598426,30153117.765
BRENDEN.MORROW,20102011,DAL,1577.3166666666666,33,14,8,22,55,47,1,11,10,208,361,224,58,33,35,1677,1319,995,1047,56,53,0.09090909090909091,30153154.57
BRENDON.NASH,20102011,MTL,20.383333333333333,0,0,0,0,0,0,0,0,0,2,4,1,2,0,0,18,18,18,18,0,1,0,30153018.1
BRENT.BURNS,20102011,MIN,2003.7833333333333,17,13,12,25,42,30,1,2,1,170,378,132,130,13,37,1738,1839,1244,1335,59,61,0.5,30153160.369999997
BRENT.SEABROOK,20102011,CHI,2114.5666666666666,9,17,20,37,46,26,0,0,0,144,305,243,91,12,24,1965,1903,1493,1328,59,62,0,30153146.62
BRENT.SOPEL,20102011,ATL,969.5333333333333,2,4,1,5,7,6,0,0,0,40,89,30,33,11,9,687,1187,611,773,29,27,0,30153099.735
BRENT.SOPEL,20102011,MTL,294.8666666666667,1,0,0,0,1,1,0,0,0,8,19,13,7,0,1,202,366,184,284,9,14,0,30153048.75
BRETT.CARSON,20102011,CAR,140.71666666666667,0,0,0,0,0,0,0,0,0,8,15,14,6,2,2,113,119,106,98,11,5,0,30153024.07
BRETT.CARSON,20102011,CGY,76.63333333333333,0,0,0,0,0,0,0,0,0,4,7,5,2,1,0,73,60,70,50,4,1,0,30153019.810000002
BRETT.CLARK,20102011,T.B,1865.1,10,10,11,21,31,20,0,0,0,104,246,143,80,8,11,1865,1565,1318,1214,61,48,0,30153131.805
BRETT.FESTERLING,20102011,ANA,14.883333333333333,0,0,0,0,0,0,0,0,0,0,1,2,0,0,0,5,28,5,13,0,2,0,15076509.95
BRETT.LEBDA,20102011,TOR,546.8666666666667,1,0,3,3,4,1,0,2,2,34,107,33,46,2,7,579,510,449,461,14,27,0,30153057.995
BRETT.MACLEAN,20102011,ARI,113.89999999999999,2,0,1,1,3,2,1,2,1,16,30,8,8,1,1,106,84,78,79,5,4,0.5,30153024.975
BRETT.STERLING,20102011,PIT,105.83333333333334,3,1,1,2,5,4,2,3,1,14,25,7,7,2,3,155,86,91,76,4,3,0.6666666666666666,30153025.625
BRETT.SUTTER,20102011,CAR,4.15,0,0,0,0,0,0,1,3,2,0,1,1,1,0,0,2,8,2,3,0,0,0.3333333333333333,15076508.54
BRETT.SUTTER,20102011,CGY,40.46666666666667,0,1,0,1,1,1,12,23,11,3,5,2,0,1,1,29,38,25,25,0,1,0.5217391304347826,30153020.29
BRIAN.BOYLE,20102011,NYR,1397.9166666666665,21,7,7,14,35,28,575,1186,611,243,400,260,84,27,26,1167,1427,1000,1070,33,36,0.484822934232715,30153169.645
BRIAN.CAMPBELL,20102011,CHI,1678.9666666666667,6,10,13,23,29,16,0,0,0,95,218,31,72,7,6,1606,1369,1252,1096,61,32,0,30153114.745
BRIAN.FAHEY,20102011,WSH,82.73333333333333,0,1,0,1,1,1,0,0,0,4,7,9,3,0,1,78,64,69,63,3,4,0,30153022.5
BRIAN.GIONTA,20102011,MTL,1766.9,32,15,4,19,51,47,20,60,40,333,572,100,120,20,11,2005,1584,1382,1146,45,45,0.3333333333333333,30153145.8
BRIAN.LEE,20102011,OTT,864.5666666666666,0,1,2,3,3,1,0,0,0,35,90,88,25,4,9,664,854,612,654,22,33,0,30153080.79
BRIAN.RAFALSKI,20102011,DET,1518.3,6,17,27,44,50,23,0,0,0,129,269,59,90,7,13,1813,1069,1234,935,63,51,0,30153096.145000003
BRIAN.ROLSTON,20102011,N.J,1144.4,14,11,9,20,34,25,52,135,83,168,291,67,62,9,16,1003,723,673,533,27,29,0.3851851851851852,30153080.494999997
BRIAN.STRAIT,20102011,PIT,40.61666666666667,0,0,0,0,0,0,0,0,0,0,3,2,2,0,0,37,21,37,20,1,2,0,30153017.200000003
BRIAN.SUTHERBY,20102011,DAL,378.01666666666665,2,2,0,2,4,4,19,32,13,32,56,70,16,13,16,233,357,218,305,6,16,0.59375,30153055.14
BRIAN.WILLSIE,20102011,WSH,6.25,0,0,1,1,1,0,0,0,0,0,0,0,0,1,0,2,10,2,10,1,1,0,15076509.585
BRODIE.DUPONT,20102011,NYR,5.566666666666666,0,0,0,0,0,0,0,0,0,1,1,2,0,0,0,4,2,4,2,0,0,0,15076508.4
BROOKS.LAICH,20102011,WSH,1701.45,17,21,17,38,55,38,330,633,303,226,393,122,97,22,21,1805,1500,1095,990,42,31,0.5213270142180095,30153140.645
BROOKS.ORPIK,20102011,PIT,1484.8833333333332,1,4,11,15,16,5,1,1,0,61,147,216,50,15,32,1236,1513,1103,1008,42,36,1,30153110.465000004
BRUNO.GERVAIS,20102011,NYI,830.8,0,3,2,5,5,3,0,0,0,43,114,40,40,5,8,665,910,608,766,18,33,0,30153097.5
BRYAN.ALLEN,20102011,CAR,301.1166666666667,0,2,2,4,4,2,0,0,0,8,31,35,17,7,8,283,340,264,272,12,7,0,30153042.67
BRYAN.ALLEN,20102011,FLA,1018.0833333333335,4,2,5,7,11,6,0,0,0,50,112,83,42,9,24,853,1093,792,852,39,47,0,30153103.015
BRYAN.BICKELL,20102011,CHI,1144.7833333333333,19,11,11,22,41,30,3,13,10,136,228,199,46,18,19,989,1009,850,969,53,40,0.23076923076923078,30153134.975
BRYAN.LITTLE,20102011,ATL,1402.9833333333331,18,16,14,30,48,34,616,1331,715,158,282,41,72,22,11,1446,1314,1008,936,48,38,0.4628099173553719,30153150.310000002
BRYAN.MCCABE,20102011,FLA,1008.75,5,10,7,17,22,15,0,0,0,88,185,71,71,7,13,1040,911,726,719,34,27,0,30153088.244999997
BRYAN.MCCABE,20102011,NYR,398.3333333333333,2,3,3,6,8,5,0,0,0,40,87,23,41,2,6,400,271,220,244,7,10,0,30153041.095
BRYAN.RODNEY,20102011,CAR,26.200000000000003,0,0,0,0,0,0,0,0,0,3,3,0,0,0,1,24,22,21,22,0,0,0,15076510.8
CAL.CLUTTERBUCK,20102011,MIN,1204.4166666666667,19,11,4,15,34,30,3,11,8,191,333,336,64,21,24,1040,1113,734,859,33,34,0.2727272727272727,30153127.48
CAL.O'REILLY,20102011,NSH,642.2833333333333,6,7,5,12,18,13,231,497,266,44,77,5,17,7,1,626,498,451,459,23,19,0.4647887323943662,30153078.634999998
CAM.BARKER,20102011,MIN,852.9166666666666,1,1,2,3,4,2,0,0,0,43,108,68,35,9,14,650,781,515,674,18,27,0,30153089.64
CAM.FOWLER,20102011,ANA,1815.25,11,16,16,32,43,27,0,0,0,135,284,51,92,6,11,1653,1623,1028,1430,36,61,0,30153186.56
CAM.JANSSEN,20102011,STL,263.45,1,2,1,3,4,3,0,0,0,16,28,95,5,23,32,185,238,184,238,6,12,0,30153049.055
CAMERON.GAUNCE,20102011,COL,140.05,1,0,0,0,1,1,0,0,0,4,12,10,5,5,5,115,147,111,119,2,5,0,30153029.450000003
CARL.GUNNARSSON,20102011,TOR,1240.4833333333333,4,4,9,13,17,8,0,0,0,69,157,63,62,10,7,1080,1281,852,936,36,39,0,30153109.875
CARL.KLINGBERG,20102011,ATL,10.366666666666667,0,0,0,0,0,0,0,0,0,0,1,1,1,0,0,6,5,6,5,0,0,0,15076508.55
CARLO.COLAIACOVO,20102011,STL,1178.8000000000002,6,8,9,17,23,14,0,0,0,81,190,75,70,8,10,1225,887,879,806,31,35,0,30153093.205
CARSON.MCMILLAN,20102011,MIN,37.35,1,0,1,1,2,1,9,23,14,5,9,5,4,0,0,33,28,33,27,3,2,0.391304347826087,30153019.485
CASEY.WELLMAN,20102011,MIN,159.65,1,0,1,1,2,1,8,16,8,20,34,5,9,0,2,128,164,113,148,3,3,0.5,30153033.645
CHAD.KOLARIK,20102011,NYR,36.516666666666666,0,1,0,1,1,1,0,0,0,4,7,3,1,0,1,35,26,33,25,2,2,0,30153019.049999997
CHAD.LAROSE,20102011,CAR,1316.4833333333331,16,8,7,15,31,24,11,33,22,174,326,194,77,27,26,1259,1374,1118,1089,34,53,0.3333333333333333,30153137.285
CHRIS.BUTLER,20102011,BUF,1051.1833333333334,2,3,4,7,9,5,0,0,0,58,137,49,53,4,19,966,1012,795,787,38,34,0,30153090.29
CHRIS.CAMPOLI,20102011,CHI,514.9666666666667,1,3,4,7,8,4,0,0,0,29,59,41,21,2,2,457,448,381,360,21,14,0,30153049.57
CHRIS.CAMPOLI,20102011,OTT,1091.15,3,3,8,11,14,6,0,0,0,59,135,73,54,13,14,955,971,792,749,32,34,0,30153085.88
CHRIS.CLARK,20102011,CBJ,776.05,5,6,3,9,14,11,3,16,13,83,137,89,27,14,16,541,762,470,573,15,21,0.1875,30153086.985
CHRIS.CONNER,20102011,PIT,795.6833333333334,8,4,5,9,17,12,1,4,3,100,175,56,40,13,6,780,637,722,612,28,19,0.25,30153076.345
CHRIS.DRURY,20102011,NYR,341.45000000000005,1,3,2,5,6,4,171,295,124,29,61,26,14,1,5,249,381,221,280,8,8,0.5796610169491525,30153053.35
CHRIS.HIGGINS,20102011,FLA,798.9,11,7,4,11,22,18,30,65,35,125,198,62,35,8,4,769,753,619,539,26,21,0.46153846153846156,30153077.479999997
CHRIS.HIGGINS,20102011,VAN,640.3666666666667,6,6,1,7,13,12,29,55,26,83,149,88,36,4,4,674,554,563,456,12,10,0.5272727272727272,30153062.925
CHRIS.KELLY,20102011,BOS,743.9333333333334,7,7,4,11,18,14,226,449,223,52,92,59,21,10,6,577,753,517,575,24,16,0.5033407572383074,30153091.689999998
CHRIS.KELLY,20102011,OTT,891.9166666666667,12,6,5,11,23,18,364,726,362,89,171,51,46,14,11,658,906,586,585,18,37,0.5013774104683195,30153098.125
CHRIS.KUNITZ,20102011,PIT,1310.75,24,14,11,25,49,38,6,10,4,146,289,166,71,19,25,1581,940,979,798,47,29,0.6,30153106.255000003
CHRIS.MUELLER,20102011,NSH,129.55,0,2,1,3,3,2,43,89,46,7,12,19,2,3,1,92,130,92,128,4,4,0.48314606741573035,30153033.775
CHRIS.NEIL,20102011,OTT,1021,6,5,5,10,16,11,3,6,3,105,191,258,49,39,54,928,884,861,850,28,43,0.5,30153110.585
CHRIS.PHILLIPS,20102011,OTT,1764.8166666666666,1,3,4,7,8,4,0,0,0,81,170,116,45,9,16,1268,1953,1151,1300,38,70,0,30153150.69
CHRIS.PORTER,20102011,STL,467.31666666666666,3,3,1,4,7,6,12,22,10,55,87,91,15,6,5,382,396,375,361,13,17,0.5454545454545454,30153055.465
CHRIS.PRONGER,20102011,PHI,1166.6666666666665,4,10,12,22,26,14,0,0,0,116,249,42,91,6,24,1223,1120,787,768,35,29,0,30153092.11
CHRIS.STEWART,20102011,COL,609.3,13,11,6,17,30,24,2,6,4,94,139,30,24,9,12,596,506,404,456,24,24,0.3333333333333333,30153079.87
CHRIS.STEWART,20102011,STL,474.90000000000003,15,8,0,8,23,23,11,26,15,67,105,26,15,5,6,532,362,372,325,16,13,0.4230769230769231,30153061.84
CHRIS.SUMMERS,20102011,ARI,27.73333333333333,0,0,0,0,0,0,0,0,0,0,2,4,1,0,2,18,35,17,20,0,3,0,30153018.8
CHRIS.TANEV,20102011,VAN,473.26666666666665,0,0,1,1,1,0,0,0,0,17,45,11,23,0,0,425,391,411,364,13,13,0,30153046.075000003
CHRIS.THORBURN,20102011,ATL,1131.2666666666667,9,6,4,10,19,15,125,251,126,114,193,129,48,26,27,876,1201,757,891,28,32,0.49800796812749004,30153125.86
CHRIS.VANDEVELDE,20102011,EDM,207.31666666666666,0,0,2,2,2,0,84,159,75,16,34,19,8,3,5,169,196,126,153,3,8,0.5283018867924528,30153036.14
CHRISTIAN.EHRHOFF,20102011,VAN,2411.5166666666664,16,22,24,46,62,38,0,0,0,258,575,82,187,24,32,2772,1912,1866,1497,74,61,0,30153151.64
CHRISTIAN.HANSON,20102011,TOR,50.61666666666667,0,0,0,0,0,0,7,17,10,2,11,11,3,0,2,37,35,35,33,0,0,0.4117647058823529,30153020.08
CHUCK.KOBASEW,20102011,MIN,745.8333333333334,9,2,5,7,16,11,6,13,7,74,124,31,35,21,8,542,708,498,671,20,26,0.46153846153846156,30153097.175
CLARKE.MACARTHUR,20102011,TOR,1403.4,20,30,11,41,61,50,9,16,7,153,291,115,82,27,16,1627,1155,1208,1055,54,43,0.5625,30153135.855
CLAUDE.GIROUX,20102011,PHI,1832.2,26,39,22,61,87,65,669,1313,644,190,351,143,86,46,22,2054,1552,1377,1155,64,45,0.5095201827875095,30153178.47
CLAY.WILSON,20102011,FLA,222.64999999999998,3,1,1,2,5,4,0,0,0,22,45,16,12,5,3,229,141,156,124,11,5,0,30153028.175
CLAYTON.STONER,20102011,MIN,961.2,2,2,5,7,9,4,0,0,0,40,96,109,34,13,31,648,986,598,798,24,23,0,30153107.255
CODY.ALMOND,20102011,MIN,56.21666666666667,0,0,0,0,0,0,13,32,19,3,5,11,1,0,1,27,61,27,55,1,1,0.40625,30153024.22
CODY.BASS,20102011,OTT,7.15,0,0,0,0,0,0,0,0,0,0,0,3,0,0,0,5,6,5,6,0,0,0,15076508.9
CODY.FRANSON,20102011,NSH,1397.85,9,18,8,26,35,27,0,0,0,178,349,89,99,3,15,1379,1092,1072,1007,41,32,0,30153120.93
CODY.HODGSON,20102011,VAN,143.1,1,1,0,1,2,2,38,90,52,21,36,10,10,1,1,131,116,115,114,3,6,0.4222222222222222,30153030.58
CODY.MCCORMICK,20102011,BUF,944.5833333333333,9,8,4,12,21,17,134,324,190,111,200,120,56,32,40,795,872,762,826,30,29,0.41358024691358025,30153120.43
CODY.MCLEOD,20102011,COL,694.3833333333334,5,1,2,3,8,6,3,8,5,73,118,147,23,30,55,582,635,547,575,18,24,0.375,30153085.869999997
COLBY.ARMSTRONG,20102011,TOR,806.2333333333333,8,9,6,15,23,17,3,8,5,69,124,88,27,24,16,692,795,578,622,31,29,0.375,30153089.509999998
COLBY.COHEN,20102011,COL,53.199999999999996,0,0,0,0,0,0,0,0,0,2,5,4,2,4,2,53,60,35,54,1,2,0,30153022.84
COLIN.FRASER,20102011,EDM,688.4833333333333,3,2,0,2,5,5,245,551,306,57,91,79,22,13,15,413,820,355,482,11,16,0.44464609800362975,30153087.380000003
COLIN.GREENING,20102011,OTT,362.08333333333337,6,3,3,6,12,9,11,24,13,57,91,56,16,5,4,355,359,303,296,16,14,0.4583333333333333,30153051.064999998
COLIN.STUART,20102011,BUF,39.46666666666667,0,0,0,0,0,0,1,2,1,5,11,3,3,0,1,44,41,44,35,1,0,0.5,30153019.39
COLIN.WHITE,20102011,N.J,1301,0,1,3,4,4,1,0,0,0,50,96,108,30,14,21,898,1147,831,837,30,38,0,30153098.064999998
COLIN.WILSON,20102011,NSH,1124.9666666666667,16,15,3,18,34,31,110,231,121,103,191,41,52,11,7,1028,883,796,836,37,26,0.47619047619047616,30153119.685
COLTON.GILLIES,20102011,MIN,72.56666666666666,1,0,0,0,1,1,1,2,1,3,8,16,1,1,1,43,52,35,50,1,3,0.5,30153023
COLTON.ORR,20102011,TOR,233.31666666666666,2,0,0,0,2,2,0,1,1,14,26,46,7,17,30,152,230,148,228,5,6,0,30153048.32
COLTON.SCEVIOUR,20102011,DAL,5.15,0,0,0,0,0,0,0,0,0,0,1,0,1,0,0,7,3,7,3,0,1,0,15076508.2
COREY.LOCKE,20102011,OTT,45.86666666666667,0,1,0,1,1,1,7,32,25,6,11,1,2,0,0,29,46,26,42,1,2,0.21875,30153023.08
COREY.PERRY,20102011,ANA,1981.1833333333334,52,34,20,54,106,86,9,22,13,308,515,69,96,45,40,1940,1799,1203,1374,67,64,0.4090909090909091,30153217.009999998
COREY.POTTER,20102011,PIT,16.716666666666665,0,0,0,0,0,0,0,0,0,1,1,1,0,0,0,13,15,13,12,0,0,0,15076509.45
CORY.EMMERTON,20102011,DET,16.683333333333334,1,0,0,0,1,1,0,1,1,3,3,0,0,0,0,12,7,12,7,1,0,0,15076509.45
CORY.SARICH,20102011,CGY,1358.7833333333333,4,4,8,12,16,8,0,1,1,75,161,175,49,17,32,1191,1231,1082,990,49,39,0,30153110.57
CORY.STILLMAN,20102011,CAR,398.35,5,10,0,10,15,15,6,12,6,35,67,11,17,2,2,461,369,312,340,14,12,0.5,30153058.56
CORY.STILLMAN,20102011,FLA,700.8166666666666,7,8,8,16,23,15,11,25,14,81,151,52,34,8,11,746,578,486,528,25,20,0.44,30153078.82
CRAIG.ADAMS,20102011,PIT,1066.7333333333333,5,5,6,11,16,10,218,510,292,96,150,191,31,20,22,693,1110,625,690,19,29,0.42745098039215684,30153108.67
CRAIG.CONROY,20102011,CGY,167.43333333333334,2,0,0,0,2,2,100,188,88,11,20,21,4,4,3,129,178,117,97,3,3,0.5319148936170213,30153029.990000002
CRAIG.RIVET,20102011,BUF,299.91666666666663,1,1,1,2,3,2,0,0,0,20,41,19,14,1,6,266,275,244,245,9,11,0,30153040.835
CRAIG.RIVET,20102011,CBJ,243.10000000000002,1,0,0,0,1,1,0,0,0,13,33,12,13,3,6,233,244,166,169,8,13,0,30153032.68
CURTIS.GLENCROSS,20102011,CGY,1283.3666666666668,24,12,7,19,43,36,57,141,84,149,252,105,46,21,18,1133,1192,912,811,42,35,0.40425531914893614,30153117.265
DAINIUS.ZUBRUS,20102011,N.J,1354.9833333333333,13,10,7,17,30,23,253,448,195,115,190,106,31,17,23,1209,840,846,723,36,42,0.5647321428571429,30153104.314999998
DALE.WEISE,20102011,NYR,65.05,0,0,0,0,0,0,0,0,0,9,12,20,1,3,5,50,55,49,54,0,0,0,30153023.23
DAN.BOYLE,20102011,S.J,2465.2166666666667,13,24,27,51,64,37,0,2,2,266,545,69,173,20,32,2917,2172,1751,1622,72,67,0,30153178.225
DAN.CARCILLO,20102011,PHI,534.2333333333333,6,1,2,3,9,7,1,2,1,70,112,96,31,28,40,451,539,446,531,10,23,0.5,30153082.42
DAN.CLEARY,20102011,DET,110.35,1,1,0,1,2,2,2,9,7,15,34,17,9,6,1,111,104,86,83,3,7,0.2222222222222222,30153025.39
DAN.GIRARDI,20102011,NYR,2100.116666666667,4,12,14,26,30,16,0,0,0,116,256,211,90,9,17,1786,2242,1369,1572,54,64,0,30153181.14
DAN.HAMHUIS,20102011,VAN,1923.3166666666666,7,6,15,21,28,13,0,0,0,135,294,119,107,17,19,1732,1736,1446,1210,65,43,0,30153118.994999997
DAN.SEXTON,20102011,ANA,553.5666666666667,4,6,3,9,13,10,1,4,3,79,119,29,10,7,3,420,513,378,497,12,20,0.25,30153079.784999996
DANA.TYRELL,20102011,T.B,992.25,6,4,5,9,15,10,7,13,6,77,125,57,21,16,7,697,920,638,705,20,29,0.5384615384615384,30153096.265
DANIEL.ALFREDSSON,20102011,OTT,1040.9,14,9,8,17,31,23,2,12,10,96,187,41,51,15,9,954,899,601,657,24,39,0.16666666666666666,30153095.880000003
DANIEL.PAILLE,20102011,BOS,704.1500000000001,9,8,2,10,19,17,1,1,0,73,108,54,16,9,9,552,739,514,570,21,18,1,30153086.68
DANIEL.SEDIN,20102011,VAN,2026.4499999999998,50,38,36,74,124,88,6,25,19,365,615,26,131,24,23,2593,1384,1665,1227,85,56,0.24,30153166.33
DANIEL.WINNIK,20102011,COL,1323.85,11,10,5,15,26,21,25,69,44,167,273,54,54,21,15,1084,1304,945,883,25,34,0.36231884057971014,30153116.185000002
DANNY.BRIERE,20102011,PHI,1628.3666666666668,41,21,15,36,77,62,445,918,473,289,455,55,97,43,42,1819,1407,1227,1287,70,57,0.48474945533769065,30153204.905
DANNY.CLEARY,20102011,DET,1209.5666666666666,27,17,6,23,50,44,45,107,62,207,328,115,48,15,11,1231,1084,947,880,44,40,0.4205607476635514,30153130.85
DANNY.SYVRET,20102011,ANA,98.68333333333334,1,0,0,0,1,1,0,0,0,8,21,3,9,0,2,100,83,91,78,2,5,0,30153023.4
DANNY.SYVRET,20102011,PHI,119.58333333333334,0,0,0,0,0,0,0,0,0,8,19,3,9,0,1,140,106,128,103,2,5,0,30153024.450000003
DANY.HEATLEY,20102011,S.J,1913.0666666666666,29,29,15,44,73,58,17,38,21,264,489,134,110,23,33,2250,1620,1425,1352,66,52,0.4473684210526316,30153178.285
DARCY.HORDICHUK,20102011,FLA,324.4,1,1,3,4,5,2,0,0,0,31,59,116,16,15,22,277,281,277,278,9,10,0,30153047.075
DARREN.HELM,20102011,DET,1239.4499999999998,15,15,8,23,38,30,519,1001,482,202,329,156,64,38,12,1088,1284,979,806,41,41,0.5184815184815185,30153123.240000002
DARROLL.POWE,20102011,PHI,1128.6166666666668,7,9,2,11,18,16,83,165,82,96,177,218,41,16,21,732,1316,642,777,22,34,0.503030303030303,30153112.880000003
DARRYL.BOYCE,20102011,TOR,523.5833333333334,5,3,5,8,13,8,212,457,245,27,65,68,20,11,13,393,520,363,483,29,20,0.4638949671772429,30153082.515
DAVE.BOLLAND,20102011,CHI,1156.1,17,19,7,26,43,36,491,1088,597,111,193,45,38,14,18,973,1106,696,768,42,26,0.45128676470588236,30153141.105
DAVE.SCATCHARD,20102011,STL,38.05,0,1,0,1,1,1,12,26,14,6,9,7,0,0,3,27,30,27,28,1,0,0.46153846153846156,30153021.08
DAVID.BACKES,20102011,STL,1615.8833333333332,31,19,11,30,61,50,506,1138,632,211,361,213,56,29,36,1679,1309,1183,1013,68,36,0.4446397188049209,30153166.455
DAVID.BOOTH,20102011,FLA,1549.75,23,11,6,17,40,34,24,48,24,280,487,129,109,34,13,1725,1352,1255,1169,46,71,0.5,30153145.700000003
DAVID.CLARKSON,20102011,N.J,1116.9666666666667,12,3,3,6,18,15,19,45,26,192,297,169,44,28,32,1002,770,788,726,19,35,0.4222222222222222,30153102.615000002
DAVID.DESHARNAIS,20102011,MTL,608.75,8,6,8,14,22,14,231,466,235,65,96,18,19,10,8,587,522,443,419,17,18,0.4957081545064378,30153075.29
DAVID.HALE,20102011,OTT,407.81666666666666,1,1,3,4,5,2,0,0,0,20,35,29,11,0,3,332,384,310,316,15,11,0,30153047.425
DAVID.JONES,20102011,COL,1361.0666666666666,27,10,8,18,45,37,10,21,11,153,266,93,51,9,14,1202,1296,870,1023,44,41,0.47619047619047616,30153147.490000002
DAVID.KOCI,20102011,COL,143.05,1,0,0,0,1,1,0,0,0,9,15,28,5,12,16,104,154,104,151,3,8,0,30153036.42
DAVID.KREJCI,20102011,BOS,1917.2166666666667,25,38,21,59,84,63,760,1536,776,214,368,75,80,26,15,2170,1679,1524,1385,76,40,0.4947916666666667,30153209.035
DAVID.LEGWAND,20102011,NSH,1468,23,13,14,27,50,36,518,1080,562,160,257,46,55,16,16,1318,1318,1001,982,48,39,0.47962962962962963,30153156.08
DAVID.LIFFITON,20102011,COL,29.833333333333336,1,0,0,0,1,1,0,0,0,2,5,3,1,2,3,37,29,37,29,3,0,0,30153019.67
DAVID.MOSS,20102011,CGY,793.8,17,3,9,12,29,20,157,364,207,128,202,92,32,9,8,766,700,602,506,31,19,0.43131868131868134,30153083.545
DAVID.PERRON,20102011,STL,184.18333333333334,5,2,0,2,7,7,0,0,0,29,37,6,3,6,5,206,123,117,108,7,2,0,30153032.21
DAVID.SCHLEMKO,20102011,ARI,753.2333333333333,5,2,7,9,14,7,0,0,0,51,101,60,28,3,14,754,642,617,565,25,19,0,30153072.255000003
DAVID.STECKEL,20102011,N.J,231.10000000000002,1,0,0,0,1,1,84,150,66,18,31,16,7,2,1,157,182,141,145,1,3,0.56,30153034.23
DAVID.STECKEL,20102011,WSH,663.35,5,6,0,6,11,11,424,666,242,60,98,88,22,9,9,485,661,452,470,15,21,0.6366366366366366,30153077.950000003
DAVID.VAN DER GULIK,20102011,COL,40.516666666666666,1,2,0,2,3,3,0,1,1,12,16,10,0,0,1,64,23,57,18,4,0,0,30153018.35
DAVIS.DREWISKE,20102011,L.A,545.3833333333333,0,3,2,5,5,3,0,0,0,27,70,23,33,3,8,397,473,367,385,15,17,0,30153053.08
DAYMOND.LANGKOW,20102011,CGY,59.03333333333333,0,0,1,1,1,0,23,43,20,6,13,4,4,2,0,54,49,49,37,3,0,0.5348837209302325,30153019.715
DENNIS.SEIDENBERG,20102011,BOS,2598.133333333333,8,17,17,34,42,25,0,0,0,229,438,218,128,15,28,2493,2669,1921,2026,82,74,0,30153224.875
DENNIS.WIDEMAN,20102011,FLA,1461.5666666666666,9,7,17,24,33,16,1,1,0,135,298,75,93,15,15,1497,1363,978,970,39,56,1,30153113.865000002
DENNIS.WIDEMAN,20102011,WSH,337.08333333333337,1,2,3,5,6,3,0,0,0,25,66,20,23,2,4,349,310,224,206,10,9,0,30153035.145
DEREK.BOOGAARD,20102011,NYR,100.08333333333334,1,1,0,1,2,2,0,0,0,4,9,27,1,8,12,71,96,69,95,3,3,0,30153030.03
DEREK.DORSETT,20102011,CBJ,1003.8333333333333,4,8,5,13,17,12,19,51,32,112,193,195,42,56,53,706,890,663,717,20,37,0.37254901960784315,30153104.695
DEREK.JOSLIN,20102011,CAR,307,1,1,3,4,5,2,0,0,0,23,52,21,25,2,1,309,307,230,231,13,8,0,30153036.744999997
DEREK.JOSLIN,20102011,S.J,211.98333333333335,1,1,1,2,3,2,0,0,0,11,25,19,8,2,4,179,194,170,176,4,6,0,30153035.095
DEREK.MACKENZIE,20102011,CBJ,683.35,9,7,7,14,23,16,246,473,227,76,144,159,34,17,8,575,607,500,440,25,18,0.5200845665961945,30153073.384999998
DEREK.MORRIS,20102011,ARI,1621.4833333333333,5,7,1,8,13,12,2,3,1,83,186,117,54,10,19,1395,1808,1205,1314,44,42,0.6666666666666666,30153153.205
DEREK.ROY,20102011,BUF,703.3833333333332,10,21,5,26,36,31,254,545,291,90,154,16,41,9,8,775,605,443,473,23,20,0.46605504587155966,30153092.424999997
DEREK.SMITH,20102011,OTT,137.85000000000002,0,1,0,1,1,1,0,0,0,13,22,5,7,2,0,135,97,124,91,4,1,0,30153023.520000003
DEREK.STEPAN,20102011,NYR,1450.8833333333332,21,16,8,24,45,37,289,749,460,170,320,86,83,17,12,1452,1146,1053,1000,47,45,0.38584779706275035,30153149.03
DERICK.BRASSARD,20102011,CBJ,1260.1166666666668,17,18,12,30,47,35,414,888,474,182,303,121,77,14,24,1414,998,936,893,45,46,0.46621621621621623,30153140.450000003
DERYK.ENGELLAND,20102011,PIT,840.4333333333334,3,3,2,5,8,6,0,0,0,49,109,122,36,25,34,721,778,705,734,23,28,0,30153094.2
DEVIN.SETOGUCHI,20102011,S.J,1408.7333333333331,29,7,13,20,49,36,5,11,6,263,453,181,99,30,24,1670,1136,1180,1047,49,53,0.45454545454545453,30153134.775
DION.PHANEUF,20102011,TOR,1670.0166666666667,8,9,13,22,30,17,0,0,0,190,443,186,159,19,32,1655,1627,1130,1268,48,47,0,30153145.165
DJ.KING,20102011,WSH,90.95,0,0,2,2,2,0,0,0,0,6,7,20,1,6,6,66,81,64,81,3,6,0,30153026.259999998
DMITRY.KULIKOV,20102011,FLA,1436.4333333333334,6,8,10,18,24,14,0,0,0,83,213,107,86,10,21,1411,1277,1085,1043,44,47,0,30153115.95
DOMINIC.MOORE,20102011,T.B,1520.8666666666668,21,17,3,20,41,38,585,1118,533,200,317,97,58,34,31,1315,1415,1104,983,42,56,0.5232558139534884,30153153.815
DOUG.JANIK,20102011,DET,92.51666666666668,0,0,0,0,0,0,0,0,0,8,16,2,7,2,2,84,72,83,66,4,6,0,30153021.32
DOUG.WEIGHT,20102011,NYI,315.45,2,4,3,7,9,6,57,110,53,26,54,9,13,2,6,336,254,187,228,7,7,0.5181818181818182,30153046.475
DOUGLAS.MURRAY,20102011,S.J,1782.95,1,3,8,11,12,4,0,0,0,128,296,272,114,17,20,1624,1815,1471,1394,51,56,0,30153139.82
DRAYSON.BOWMAN,20102011,CAR,221.98333333333335,0,1,0,1,1,1,0,0,0,27,61,23,19,3,5,216,206,198,197,6,6,0,30153035.08
DREW.BAGNALL,20102011,MIN,26.016666666666666,0,0,0,0,0,0,0,0,0,1,2,0,1,1,2,11,27,11,21,0,2,0,30153019.310000002
DREW.DOUGHTY,20102011,L.A,2111.75,13,16,15,31,44,29,0,1,1,151,383,145,148,23,34,2223,1675,1470,1260,75,56,0,30153130.505
DREW.MILLER,20102011,DET,879.6666666666667,11,5,4,9,20,16,6,21,15,97,176,99,37,17,6,716,882,669,615,27,29,0.2857142857142857,30153083.060000002
DREW.STAFFORD,20102011,BUF,1165.4666666666667,32,12,11,23,55,44,32,87,55,212,323,63,67,10,18,1237,972,794,796,45,23,0.367816091954023,30153125.055
DUNCAN.KEITH,20102011,CHI,2393,11,17,20,37,48,28,0,0,0,200,497,51,190,6,15,2433,2071,1800,1520,74,77,0,30153145.759999998
DUSTIN.BOYD,20102011,MTL,98.38333333333333,1,0,0,0,1,1,23,55,32,8,19,12,6,1,1,71,112,68,91,1,7,0.41818181818181815,30153028.33
DUSTIN.BROWN,20102011,L.A,1708.15,29,18,12,30,59,47,18,37,19,238,450,334,108,55,30,1778,1399,1187,1115,56,42,0.4864864864864865,30153148.619999997
DUSTIN.BYFUGLIEN,20102011,ATL,1887.6666666666667,20,21,12,33,53,41,0,0,0,347,657,140,166,17,32,2199,1479,1545,1296,70,57,0,30153147.02
DUSTIN.JEFFREY,20102011,PIT,324.3666666666667,7,5,0,5,12,12,109,247,138,39,70,14,19,4,2,327,229,249,198,12,8,0.44129554655870445,30153044.85
DUSTIN.PENNER,20102011,EDM,1144.4,21,8,10,18,39,29,127,293,166,137,234,63,37,9,17,1037,1064,708,801,32,43,0.4334470989761092,30153127.27
DUSTIN.PENNER,20102011,L.A,410.5,3,5,0,5,8,8,4,21,17,46,91,38,20,5,3,436,316,296,290,11,11,0.19047619047619047,30153049.009999998
DWIGHT.KING,20102011,L.A,70.33333333333333,0,0,0,0,0,0,0,0,0,3,4,7,0,2,1,50,60,48,60,2,4,0,30153023.119999997
DYLAN.REESE,20102011,NYI,400.0333333333333,0,3,3,6,6,3,0,0,0,23,47,17,12,3,6,333,398,299,319,11,19,0,30153049.905
ED.JOVANOVSKI,20102011,ARI,1085.5166666666667,5,4,6,10,15,9,0,0,0,76,161,94,62,17,18,928,1213,775,820,25,28,0,30153100.520000003
ERIC.BELANGER,20102011,ARI,1485.8666666666668,13,14,13,27,40,27,748,1354,606,132,257,79,53,22,19,1404,1425,1103,1031,49,41,0.552437223042836,30153150.965
ERIC.BOULTON,20102011,ATL,618.1166666666667,6,4,0,4,10,10,0,3,3,51,87,93,19,20,22,481,554,469,548,20,19,0,30153082
ERIC.BREWER,20102011,STL,1200.85,8,3,3,6,14,11,0,0,0,86,170,78,45,9,20,988,1173,886,816,38,40,0,30153097.015
ERIC.BREWER,20102011,T.B,935.5833333333333,2,3,4,7,9,5,0,0,0,50,97,109,36,9,16,730,1055,546,740,24,22,0,30153099.54
ERIC.FEHR,20102011,WSH,722.35,11,7,3,10,21,18,0,1,1,130,225,45,44,9,8,805,560,579,507,21,20,0,30153073.465
ERIC.GODARD,20102011,PIT,98.30000000000001,0,3,0,3,3,3,0,0,0,1,3,19,1,11,20,72,81,71,79,5,1,0,30153028.71
ERIC.NYSTROM,20102011,MIN,1091.3,4,4,4,8,12,8,45,131,86,83,163,169,43,18,11,639,1106,588,877,19,36,0.3435114503816794,30153124.48
ERIC.STAAL,20102011,CAR,1783.2666666666667,33,26,17,43,76,59,837,1747,910,294,535,80,111,28,31,2097,1691,1300,1220,51,57,0.47910704064109905,30153205.634999998
ERIC.TANGRADI,20102011,PIT,183.2,1,2,0,2,3,3,1,3,2,20,30,30,3,5,5,143,142,110,130,4,7,0.3333333333333333,30153033.14
ERIC.WELLWOOD,20102011,PHI,40.25,0,1,0,1,1,1,0,0,0,8,13,4,3,2,1,36,38,32,36,2,1,0,30153020.67
ERIK.CHRISTENSEN,20102011,NYR,869.2,12,14,2,16,28,26,341,681,340,96,184,40,45,10,10,796,748,545,673,29,23,0.5007342143906021,30153115.34
ERIK.COLE,20102011,CAR,1504.9333333333334,26,14,11,25,51,40,7,34,27,199,363,224,90,38,19,1549,1486,1070,1140,48,50,0.20588235294117646,30153154.485
ERIK.CONDRA,20102011,OTT,412.58333333333337,6,5,0,5,11,11,2,4,2,48,82,4,19,6,6,368,403,313,302,9,10,0.5,30153052.34
ERIK.GUSTAFSSON,20102011,PHI,32.86666666666667,0,0,0,0,0,0,0,0,0,2,5,0,3,1,1,24,21,24,20,0,0,0,15076509.86
ERIK.JOHNSON,20102011,COL,540.1666666666666,3,3,4,7,10,6,0,0,0,53,106,32,37,9,8,496,523,334,369,12,15,0,30153055.79
ERIK.JOHNSON,20102011,STL,1217.1333333333332,5,6,7,13,18,11,0,0,0,107,208,67,65,6,13,1113,1074,818,784,30,42,0,30153093.634999998
ERIK.KARLSSON,20102011,OTT,1763.7,13,17,14,31,44,30,0,0,0,182,386,32,138,16,24,1807,1521,1256,1194,41,62,0,30153138.310000002
ETHAN.MOREAU,20102011,CBJ,461.85,1,2,3,5,6,3,5,17,12,56,99,73,25,1,12,287,516,268,384,6,16,0.29411764705882354,30153063.235
EVAN.BROPHEY,20102011,CHI,7.15,0,0,0,0,0,0,4,5,1,1,1,3,0,0,0,3,8,3,8,0,0,0.8,15076509.36
EVAN.OBERG,20102011,VAN,19.65,0,0,0,0,0,0,0,0,0,1,4,2,2,1,0,27,17,27,17,1,1,0,30153017.310000002
EVANDER.KANE,20102011,ATL,1303.95,19,18,5,23,42,37,26,64,38,234,378,154,76,40,25,1267,1143,937,959,40,52,0.40625,30153137.165
EVGENI.MALKIN,20102011,PIT,852.4666666666667,15,11,11,22,37,26,77,200,123,182,322,32,76,25,10,1111,583,626,479,27,28,0.385,30153075.205
EVGENY.DADONOV,20102011,FLA,513.0833333333334,8,3,6,9,17,11,1,5,4,60,101,45,19,11,7,494,434,434,414,19,17,0.2,30153063.25
EVGENY.GRACHEV,20102011,NYR,61.61666666666666,0,0,0,0,0,0,0,1,1,3,6,8,2,1,0,43,56,43,56,0,3,0,30153022.66
FEDOR.TYUTIN,20102011,CBJ,1815.5666666666666,7,10,7,17,24,17,1,2,1,128,260,120,91,11,16,1744,1476,1166,1038,39,56,0.5,30153114.275
FERNANDO.PISANI,20102011,CHI,778.1166666666666,7,6,2,8,15,13,34,67,33,75,128,73,34,10,5,583,831,538,649,20,18,0.5074626865671642,30153093.11
FILIP.KUBA,20102011,OTT,1326.6999999999998,2,5,9,14,16,7,0,0,0,76,176,23,60,1,8,1205,1284,918,922,32,54,0,30153104.935000002
FRANCIS.BOUILLON,20102011,NSH,890.1833333333333,1,6,3,9,10,7,0,0,0,47,108,133,44,10,9,708,812,572,674,33,34,0,30153085.475
FRANCIS.LESSARD,20102011,OTT,92.55000000000001,0,0,0,0,0,0,1,1,0,6,12,36,2,6,13,70,64,70,64,1,1,1,30153024.45
FRANCIS.WATHIER,20102011,DAL,11.766666666666666,0,0,0,0,0,0,0,0,0,0,0,3,0,0,0,3,10,3,10,0,2,0,30153017.85
FRANCOIS.BEAUCHEMIN,20102011,ANA,727.3333333333333,3,0,4,4,7,3,0,1,1,32,68,51,22,8,8,525,753,399,507,18,22,0,30153071.93
FRANCOIS.BEAUCHEMIN,20102011,TOR,1282.8166666666666,2,3,6,9,11,5,0,0,0,76,189,82,69,4,8,1138,1230,928,929,39,45,0,30153101.79
FRANS.NIELSEN,20102011,NYI,1261.2,13,20,11,31,44,33,444,963,519,156,255,23,53,21,10,1194,1224,788,768,37,32,0.46105919003115264,30153130.745
FRAZER.MCLAREN,20102011,S.J,38.266666666666666,0,0,0,0,0,0,0,0,0,1,2,6,1,5,5,20,32,20,30,1,2,0,30153020.55
FREDDY.MEYER,20102011,ATL,228.95,1,1,0,1,2,2,0,0,0,11,29,29,10,1,4,161,255,154,227,4,11,0,30153043.16
FREDRIK.MODIN,20102011,ATL,430.26666666666665,7,2,1,3,10,9,7,16,9,51,83,16,15,5,6,374,498,333,402,14,21,0.4375,30153065.755000003
FREDRIK.MODIN,20102011,CGY,33.86666666666667,0,0,0,0,0,0,1,4,3,3,4,3,1,0,0,27,24,27,19,0,2,0.25,30153018.14
FREDRIK.SJOSTROM,20102011,TOR,739.8666666666668,2,2,1,3,5,4,5,15,10,62,106,108,25,9,7,539,834,504,630,12,19,0.3333333333333333,30153087.515
GARRETT.STAFFORD,20102011,ARI,24.8,0,0,0,0,0,0,0,0,0,2,3,4,0,0,0,16,27,16,27,1,1,0,15076511.45
GEORGE.PARROS,20102011,ANA,524.9166666666666,3,1,0,1,4,4,1,4,3,36,68,103,14,39,41,373,467,369,466,5,10,0.25,30153076.23
GILBERT.BRULE,20102011,EDM,565.4833333333333,7,2,0,2,9,9,106,199,93,72,112,95,25,14,18,469,555,375,508,14,21,0.5326633165829145,30153084.13
GRANT.CLITSOME,20102011,CBJ,659.3333333333333,4,7,7,14,18,11,0,0,0,50,134,67,57,3,7,733,531,431,420,21,19,0,30153057.005000003
GREG.MAULDIN,20102011,COL,305.8333333333333,5,5,0,5,10,10,2,7,5,46,74,56,7,2,3,248,259,233,204,12,8,0.2857142857142857,30153041.85
GREG.NEMISZ,20102011,CGY,30.56666666666667,0,1,0,1,1,1,1,3,2,5,9,1,3,1,0,31,32,31,32,1,2,0.3333333333333333,30153020.049999997
GREG.ZANON,20102011,MIN,1766.5500000000002,0,2,4,6,6,2,0,0,0,55,142,169,55,12,24,1179,1965,1068,1472,42,51,0,30153177.22
GREGORY.CAMPBELL,20102011,BOS,1350.1,14,7,11,18,32,21,505,1017,512,121,203,151,51,22,30,1069,1553,963,1145,31,31,0.49655850540806296,30153173.595
GUILLAUME.DESBIENS,20102011,VAN,88.26666666666667,0,0,0,0,0,0,1,1,0,4,12,22,3,2,3,58,92,48,85,0,3,1,30153027.06
GUILLAUME.LATENDRESSE,20102011,MIN,139.8,3,3,0,3,6,6,0,6,6,18,28,18,2,1,4,131,118,96,114,5,2,0,30153033.310000002
HAL.GILL,20102011,MTL,1650.0333333333333,2,1,6,7,9,3,0,0,0,66,142,85,47,9,18,1250,1750,1138,1196,38,50,0,30153134.740000002
HENRIK.SEDIN,20102011,VAN,2103.0166666666664,22,59,35,94,116,81,947,1882,935,201,338,28,82,19,27,2630,1484,1686,1291,81,63,0.5031880977683315,30153203.445
HENRIK.TALLINDER,20102011,N.J,1848.3166666666666,5,5,6,11,16,10,0,0,0,102,202,67,58,5,18,1480,1412,1308,1083,45,63,0,30153112.65
HENRIK.ZETTERBERG,20102011,DET,1720.6333333333332,27,40,21,61,88,67,580,1113,533,326,586,44,127,25,20,2011,1352,1324,1122,59,57,0.5211141060197664,30153173.575
HUGH.JESSIMAN,20102011,FLA,14.700000000000001,0,0,0,0,0,0,0,0,0,2,4,4,1,1,1,18,8,17,8,0,1,0,30153016.96
IAN.COLE,20102011,STL,457.8,1,0,2,2,3,1,0,0,0,22,58,36,20,8,16,415,414,371,351,18,13,0,30153049.33
IAN.WHITE,20102011,CAR,753.1666666666667,0,3,6,9,9,3,0,0,0,53,138,27,52,4,6,743,771,634,641,26,23,0,30153074.939999998
IAN.WHITE,20102011,CGY,347.7833333333333,2,1,3,4,6,3,0,0,0,34,81,12,31,1,3,379,276,229,227,4,13,0,30153038.185000002
IAN.WHITE,20102011,S.J,799.7666666666667,3,4,11,15,18,7,0,0,0,91,198,30,69,5,8,904,753,689,608,34,25,0,30153068.725
ILYA.KOVALCHUK,20102011,N.J,1827.5833333333335,31,19,10,29,60,50,9,31,22,245,461,28,112,23,11,1798,1248,1146,1115,45,65,0.2903225806451613,30153150.939999998
J-F.JACQUES,20102011,EDM,360.68333333333334,4,1,0,1,5,5,5,16,11,28,49,111,8,15,19,261,350,256,344,6,12,0.3125,30153061.450000003
J-P.DUMONT,20102011,NSH,803.2166666666667,10,4,6,10,20,14,1,2,1,91,153,47,36,11,11,808,603,611,571,24,22,0.5,30153078.6
JACK.HILLEN,20102011,NYI,1204.35,4,11,6,17,21,15,0,0,0,81,178,54,60,9,17,1073,1333,919,1063,43,45,0,30153130.54
JACK.JOHNSON,20102011,L.A,2039.1166666666668,6,20,20,40,46,26,0,0,0,169,414,91,137,7,18,2076,1746,1355,1467,51,64,0,30153168.52
JACK.SKILLE,20102011,CHI,525.9666666666667,7,7,3,10,17,14,2,4,2,121,185,95,39,12,12,528,405,496,392,20,15,0.5,30153058.675
JACK.SKILLE,20102011,FLA,213.33333333333331,1,0,1,1,2,1,1,6,5,33,58,39,10,4,2,201,178,152,157,4,13,0.16666666666666666,30153033.354999997
JACOB.JOSEFSON,20102011,N.J,370.6333333333333,3,5,2,7,10,8,95,201,106,30,55,8,12,1,3,304,245,233,227,11,5,0.472636815920398,30153046.759999998
JAKE.DOWELL,20102011,CHI,949.9333333333333,6,10,5,15,21,16,327,668,341,73,109,110,19,17,17,790,931,747,706,25,26,0.48952095808383234,30153108.675
JAKE.MUZZIN,20102011,L.A,150.85,0,1,0,1,1,1,0,0,0,8,20,22,10,1,0,123,112,102,110,2,4,0,30153027.060000002
JAKUB.KINDL,20102011,DET,653.2666666666667,2,1,1,2,4,3,0,0,0,62,123,44,40,3,17,647,573,585,553,21,28,0,30153068.755
JAKUB.VORACEK,20102011,CBJ,1357.6666666666665,14,20,12,32,46,34,24,65,41,183,298,55,48,16,14,1577,1054,1081,950,49,50,0.36923076923076925,30153125.32
JAMAL.MAYERS,20102011,S.J,760.35,3,6,5,11,14,9,56,108,52,67,114,133,19,17,34,570,774,540,621,21,23,0.5185185185185185,30153093.085
JAMES.NEAL,20102011,DAL,1044.2833333333333,21,12,6,18,39,33,7,17,10,160,270,120,49,21,22,1093,867,787,803,41,28,0.4117647058823529,30153117.79
JAMES.NEAL,20102011,PIT,459.8833333333333,2,5,1,6,8,7,4,12,8,72,154,47,47,11,6,588,278,405,251,11,13,0.3333333333333333,30153034.395000003
JAMES.VAN RIEMSDYK,20102011,PHI,1303.2333333333333,28,11,8,19,47,39,0,3,3,243,405,134,83,26,17,1450,1210,1151,1107,54,43,0,30153145.810000002
JAMES.WISNIEWSKI,20102011,MTL,1111,7,12,13,25,32,19,0,0,0,94,204,65,72,18,12,1241,1019,850,841,30,30,0,30153104.005000003
JAMES.WISNIEWSKI,20102011,NYI,743.9666666666667,3,11,7,18,21,14,0,0,0,71,161,52,55,9,8,817,659,477,510,14,26,0,30153072.314999998
JAMES.WRIGHT,20102011,T.B,4.6,0,0,0,0,0,0,0,2,2,0,0,1,0,0,0,2,10,2,10,0,2,0,15076509.75
JAMIE.ARNIEL,20102011,BOS,12.433333333333334,0,0,0,0,0,0,0,0,0,3,3,0,0,0,0,16,11,16,11,0,1,0,15076509.25
JAMIE.BENN,20102011,DAL,1241.7833333333333,22,18,16,34,56,40,84,195,111,177,326,124,79,32,20,1183,1124,820,812,42,38,0.4307692307692308,30153122.53
JAMIE.DOORNBOSCH,20102011,NYI,5.35,0,0,0,0,0,0,0,0,0,1,2,1,1,0,0,4,7,4,7,0,1,0,15076509
JAMIE.LANGENBRUNNER,20102011,DAL,645.6333333333333,5,8,5,13,18,13,10,18,8,77,143,63,30,10,13,595,543,444,415,18,17,0.5555555555555556,30153063.825
JAMIE.LANGENBRUNNER,20102011,N.J,575.25,4,5,4,9,13,9,1,10,9,75,128,33,27,6,8,561,462,399,331,14,29,0.1,30153051.35
JAMIE.MCBAIN,20102011,CAR,1447.9333333333334,7,8,12,20,27,15,0,0,0,95,223,41,93,9,16,1453,1378,1075,1151,46,54,0,30153131.990000002
JAMIE.MCGINN,20102011,S.J,613.5,1,4,2,6,7,5,8,12,4,66,129,116,28,16,18,538,563,517,529,11,18,0.6666666666666666,30153073.479999997
JAN.HEJDA,20102011,CBJ,1626.4,5,4,9,13,18,9,1,1,0,79,167,151,49,6,14,1303,1541,1167,1126,50,61,1,30153124.675
JAN.MURSAK,20102011,DET,155.66666666666669,1,0,0,0,1,1,3,6,3,20,34,14,7,3,2,171,104,168,103,1,4,0.5,30153024.5
JANNIK.HANSEN,20102011,VAN,1602.2333333333336,12,20,6,26,38,32,16,39,23,163,263,188,52,14,19,1336,1556,1231,1156,48,29,0.41025641025641024,30153145.33
JARED.BOLL,20102011,CBJ,560.2166666666667,7,4,1,5,12,11,0,6,6,66,108,143,19,43,42,512,461,503,454,22,23,0,30153070.805
JARED.SPURGEON,20102011,MIN,798.8166666666666,4,5,3,8,12,9,0,0,0,38,80,37,25,6,1,698,678,542,605,16,20,0,30153081.884999998
JARKKO.RUUTU,20102011,ANA,223.15,1,0,1,1,2,1,2,6,4,20,32,49,6,8,13,122,215,110,137,2,3,0.3333333333333333,30153034.335
JARKKO.RUUTU,20102011,OTT,623.5333333333333,2,6,2,8,10,8,5,14,9,46,90,83,20,15,24,465,582,447,419,17,20,0.35714285714285715,30153062.75
JAROME.IGINLA,20102011,CGY,1716.6666666666667,43,26,17,43,86,69,227,419,192,289,518,102,127,25,16,1831,1335,1200,1146,66,52,0.5417661097852029,30153169.555
JAROSLAV.SPACEK,20102011,MTL,1259.3166666666666,1,5,10,15,16,6,0,0,0,70,189,67,78,10,19,1219,1235,967,934,37,35,0,30153101.65
JARRET.STOLL,20102011,L.A,1501.1333333333332,20,18,8,26,46,38,804,1403,599,192,358,177,88,14,21,1480,1266,1035,933,40,41,0.5730577334283677,30153144.8
JASON.ARNOTT,20102011,N.J,958.4,13,7,4,11,24,20,385,750,365,138,238,28,50,4,15,935,662,672,598,23,30,0.5133333333333333,30153098.490000002
JASON.ARNOTT,20102011,WSH,319.1666666666667,5,7,1,8,13,12,127,277,150,43,74,26,19,3,5,377,251,265,230,10,6,0.4584837545126354,30153049.985
JASON.BLAKE,20102011,ANA,1204.3166666666666,19,7,10,17,36,26,1,5,4,204,312,81,54,32,15,1113,1125,923,1065,41,47,0.2,30153146.71
JASON.CHIMERA,20102011,WSH,1188.8000000000002,12,11,7,18,30,23,21,45,24,177,284,122,46,18,24,1079,1120,939,974,36,47,0.4666666666666667,30153131.945
JASON.DEMERS,20102011,S.J,1721.5500000000002,4,10,13,23,27,14,0,0,0,125,289,108,97,13,19,1885,1446,1393,1110,56,41,0,30153108.905
JASON.GARRISON,20102011,FLA,1627.4666666666667,5,8,5,13,18,13,0,0,0,116,264,136,85,3,11,1376,1614,1116,1130,36,38,0,30153127.805
JASON.POMINVILLE,20102011,BUF,1403.5166666666667,23,19,14,33,56,42,71,166,95,223,372,38,90,19,7,1588,1267,1010,904,44,37,0.42771084337349397,30153125.53
JASON.SPEZZA,20102011,OTT,1252.3333333333335,21,25,11,36,57,46,681,1210,529,188,345,14,77,18,13,1296,1142,852,811,46,44,0.5628099173553719,30153137.545
JASON.STRUDWICK,20102011,EDM,647.0333333333333,0,0,0,0,0,0,0,0,0,9,36,42,14,7,7,419,732,394,571,10,28,0,30153080.42
JASON.WILLIAMS,20102011,DAL,218.95,2,3,0,3,5,5,18,44,26,18,45,14,14,0,3,197,190,179,189,5,7,0.4090909090909091,30153038.57
JASSEN.CULLIMORE,20102011,CHI,454.6666666666667,0,3,4,7,7,3,0,0,0,22,55,38,21,0,4,379,418,367,371,18,15,0,30153051.6
JAY.BEAGLE,20102011,WSH,325.6333333333333,2,0,1,1,3,2,58,104,46,27,53,45,18,8,4,219,298,209,242,7,9,0.5576923076923077,30153043.825000003
JAY.BOUWMEESTER,20102011,CGY,2130.866666666667,4,8,10,18,22,12,0,0,0,121,270,72,95,5,22,1895,2030,1376,1341,59,59,0,30153143.1
JAY.HARRISON,20102011,CAR,1092.0166666666667,3,6,1,7,10,9,0,0,0,49,137,110,48,16,27,938,1198,858,876,38,36,0,30153104.235
JAY.LEACH,20102011,N.J,99.7,0,0,0,0,0,0,0,0,0,2,6,5,2,1,2,50,67,48,64,2,3,0,30153023.51
JAY.MCCLEMENT,20102011,COL,375.6166666666667,1,3,0,3,4,4,168,321,153,38,71,23,11,2,6,251,439,222,292,4,13,0.5233644859813084,30153058.09
JAY.MCCLEMENT,20102011,STL,959.7166666666667,6,7,3,10,16,13,427,831,404,89,145,52,23,5,9,712,1027,653,694,28,41,0.5138387484957883,30153110.355
JAY.ROSEHILL,20102011,TOR,135.38333333333335,1,2,0,2,3,3,0,0,0,12,16,36,3,16,16,95,150,95,150,3,9,0,30153038.310000002
JED.ORTMEYER,20102011,MIN,37.56666666666667,0,0,0,0,0,0,0,0,0,5,9,4,1,0,1,36,25,36,23,0,1,0,15076510.15
JEFF.CARTER,20102011,PHI,1549.8833333333332,37,14,17,31,68,51,338,627,289,353,605,71,127,10,18,1790,1316,1189,1113,64,37,0.5390749601275917,30153161.744999997
JEFF.HALPERN,20102011,MTL,987.7833333333333,12,10,5,15,27,22,368,635,267,71,124,43,30,17,12,732,1033,668,731,33,29,0.5795275590551181,30153112.765
JEFF.PETRY,20102011,EDM,713.0833333333333,1,0,3,3,4,1,0,0,0,41,118,48,46,3,5,622,592,490,486,18,28,0,30153059.055
JEFF.SCHULTZ,20102011,WSH,1599.2166666666667,1,2,5,7,8,3,0,0,0,42,108,65,44,3,9,1334,1648,1216,1253,48,47,0,30153135.505
JEFF.SKINNER,20102011,CAR,1362.2333333333333,31,15,17,32,63,46,58,155,97,211,399,70,100,52,21,1522,1187,1053,1027,53,46,0.3741935483870968,30153144.665
JEFF.TAFFE,20102011,CHI,4.083333333333333,0,0,0,0,0,0,2,5,3,0,0,0,0,0,0,0,1,0,1,0,0,0.4,15076508.53
JEFF.TAMBELLINI,20102011,VAN,773.7666666666667,9,5,3,8,17,14,19,35,16,116,204,123,40,5,10,814,611,677,566,24,16,0.5428571428571428,30153075.185
JEFF.WOYWITKA,20102011,DAL,1130.5333333333333,2,1,6,7,9,3,0,0,0,72,164,43,58,6,12,982,1091,884,1002,35,30,0,30153116.509999998
JEREMY.COLLITON,20102011,NYI,178.31666666666666,2,1,0,1,3,3,52,84,32,7,20,23,7,1,5,139,192,123,155,3,8,0.6190476190476191,30153036.240000002
JEREMY.MORIN,20102011,CHI,108.86666666666666,2,1,0,1,3,3,0,0,0,13,23,12,4,2,3,96,89,72,81,5,4,0,30153026.77
JEREMY.WILLIAMS,20102011,NYR,3.716666666666667,0,0,0,0,0,0,0,0,0,0,1,0,1,1,0,3,12,3,12,0,0,0,15076509.76
JEROME.SAMSON,20102011,CAR,157.56666666666666,0,0,2,2,2,0,2,3,1,28,61,13,19,3,0,164,146,160,145,3,3,0.6666666666666666,30153028.560000002
JERRED.SMITHSON,20102011,NSH,1373.4,6,5,4,9,15,11,630,1101,471,89,161,184,34,24,21,862,1423,800,953,28,34,0.5722070844686649,30153142.49
JESSE.JOENSUU,20102011,NYI,486.18333333333334,6,1,2,3,9,7,5,9,4,41,74,59,20,6,11,394,520,387,510,15,20,0.5555555555555556,30153077.21
JESSE.WINCHESTER,20102011,OTT,780.1166666666666,4,7,2,9,13,11,303,544,241,118,192,101,34,22,17,700,653,643,537,17,27,0.5569852941176471,30153081.740000002
JIM.O'BRIEN,20102011,OTT,58.03333333333333,0,0,0,0,0,0,8,16,8,11,15,5,2,0,1,58,53,56,52,0,3,0.5,30153022.22
JIM.SLATER,20102011,ATL,380.98333333333335,5,4,3,7,12,9,185,301,116,53,79,59,10,6,8,312,426,298,353,18,14,0.6146179401993356,30153064.134999998
JIM.VANDERMEER,20102011,EDM,1128.4499999999998,2,5,6,11,13,7,0,0,0,57,141,122,56,8,31,933,1146,810,886,30,44,0,30153108.18
JIRI.HUDLER,20102011,DET,1116.8833333333332,11,19,9,28,39,30,33,75,42,117,208,48,49,8,17,1269,868,914,814,35,43,0.44,30153109.375
JIRI.TLUSTY,20102011,CAR,562.1166666666667,6,4,2,6,12,10,2,15,13,53,102,36,32,8,7,512,530,484,520,21,21,0.13333333333333333,30153073.310000002
JOCHEN.HECHT,20102011,BUF,1159.6666666666665,12,13,5,18,30,25,324,744,420,174,280,33,39,12,19,1187,1029,939,763,44,33,0.43548387096774194,30153116.905
JODY.SHELLEY,20102011,PHI,366.45000000000005,2,0,2,2,4,2,2,4,2,32,54,98,8,20,29,266,362,263,358,12,12,0.5,30153061.83
JOE.CALLAHAN,20102011,FLA,428.73333333333335,0,1,0,1,1,1,0,0,0,21,46,46,13,2,6,355,396,335,357,14,16,0,30153051.77
JOE.COLBORNE,20102011,TOR,18.683333333333334,0,1,0,1,1,1,3,9,6,1,2,0,0,0,0,18,16,15,14,1,0,0.3333333333333333,15076510.32
JOE.CORVO,20102011,CAR,2033.05,11,18,10,28,39,29,0,1,1,190,384,55,125,14,9,2057,2032,1349,1400,46,54,0,30153162.79
JOE.PAVELSKI,20102011,S.J,1834.8666666666668,25,31,19,50,75,56,716,1315,599,340,565,79,118,34,16,2246,1598,1338,1104,51,39,0.5444866920152092,30153168.355
JOE.THORNTON,20102011,S.J,1990.2,24,41,21,62,86,65,874,1576,702,197,342,73,80,25,25,2398,1574,1434,1237,64,58,0.5545685279187818,30153189.884999998
JOE.VITALE,20102011,PIT,95.15,1,0,1,1,2,1,36,64,28,13,24,18,9,2,5,90,74,77,66,2,3,0.5625,30153024.134999998
JOEL.PERRAULT,20102011,VAN,50.35,0,0,0,0,0,0,13,31,18,3,7,11,2,0,0,30,45,29,45,3,4,0.41935483870967744,30153021.97
JOEL.WARD,20102011,NSH,1610.0333333333333,17,11,12,23,40,28,97,206,109,185,288,89,58,22,23,1412,1350,1053,1023,43,44,0.470873786407767,30153138.4
JOEY.CRABB,20102011,TOR,623.0166666666667,3,8,3,11,14,11,5,22,17,51,90,99,18,3,11,520,668,445,583,23,23,0.22727272727272727,30153087.305
JOFFREY.LUPUL,20102011,ANA,343.8,5,5,3,8,13,10,7,14,7,54,93,22,17,3,3,326,365,217,341,8,11,0.5,30153062.985
JOFFREY.LUPUL,20102011,TOR,499.8333333333333,9,4,5,9,18,13,5,18,13,75,128,41,28,13,9,509,515,346,471,19,21,0.2777777777777778,30153077.505
JOHAN.FRANZEN,20102011,DET,1451.2666666666669,30,18,10,28,58,48,83,168,85,268,450,157,77,18,28,1612,1110,1142,998,51,44,0.49404761904761907,30153142.75
JOHAN.HARJU,20102011,T.B,84.73333333333333,1,2,0,2,3,3,2,5,3,14,22,9,4,1,1,84,61,61,58,4,6,0.4,30153023.74
JOHN-MICHAEL.LILES,20102011,COL,1672.6666666666667,6,19,21,40,46,25,0,0,0,163,360,59,130,25,13,1676,1456,1143,1219,52,57,0,30153141.475
JOHN.CARLSON,20102011,WSH,2066.6000000000004,9,14,15,29,38,23,0,0,0,165,358,85,122,17,20,2075,1791,1518,1356,61,50,0,30153143.095
JOHN.ERSKINE,20102011,WSH,1215.85,5,2,6,8,13,7,0,0,0,64,142,190,53,21,37,1101,1199,1033,1010,42,41,0,30153116.11
JOHN.MADDEN,20102011,MIN,1165.7833333333333,12,7,6,13,25,19,504,988,484,107,185,43,45,13,5,719,1245,615,857,27,37,0.5101214574898786,30153141.59
JOHN.MCCARTHY,20102011,S.J,323.48333333333335,2,1,1,2,4,3,13,36,23,41,71,28,15,3,3,271,290,264,265,5,13,0.3611111111111111,30153045.625
JOHN.MITCHELL,20102011,TOR,287.8,2,0,1,1,3,2,83,149,66,28,53,31,17,4,6,251,305,227,265,4,11,0.5570469798657718,30153048.035
JOHN.MOORE,20102011,CBJ,22.950000000000003,0,0,0,0,0,0,0,0,0,0,1,1,1,0,0,17,21,17,18,1,1,0,30153018.05
JOHN.SCOTT,20102011,CHI,276.6333333333333,0,0,1,1,1,0,0,3,3,17,39,66,12,16,17,225,230,222,220,8,6,0,30153039.185000002
JOHN.TAVARES,20102011,NYI,1520.75,29,20,18,38,67,49,691,1317,626,242,404,22,82,26,26,1695,1363,1138,1217,48,57,0.524677296886864,30153195.950000003
JOHN.ZEILER,20102011,L.A,22.4,0,0,0,0,0,0,5,10,5,1,5,4,2,0,0,21,19,21,19,0,1,0.5,30153018.25
JOHNNY.BOYCHUK,20102011,BOS,1930.4833333333333,6,8,11,19,25,14,0,0,0,203,405,179,127,17,19,1908,1929,1642,1519,63,42,0,30153156.345
JOHNNY.ODUYA,20102011,ATL,1699.2833333333333,2,4,11,15,17,6,0,0,0,90,211,64,76,21,12,1346,1837,1116,1289,33,56,0,30153148.634999998
JON.MATSUMOTO,20102011,CAR,91.9,2,0,0,0,2,2,30,83,53,11,21,13,7,1,2,87,92,83,90,2,6,0.3614457831325301,30153029.11
JON.SIM,20102011,NYI,387.73333333333335,1,2,1,3,4,3,5,11,6,38,61,53,13,9,11,275,450,243,375,7,18,0.45454545454545453,30153063.365000002
JONAS.ANDERSSON,20102011,VAN,24.216666666666665,0,0,0,0,0,0,0,0,0,1,2,3,1,0,0,14,17,14,17,1,0,0,30153018.1
JONAS.HOLOS,20102011,COL,703.9833333333333,0,1,5,6,6,1,0,0,0,36,85,19,23,3,5,574,635,469,500,20,22,0,30153065.105
JONATHAN.ERICSSON,20102011,DET,1601,4,8,6,14,18,12,0,0,0,113,209,130,51,9,36,1508,1394,1403,1174,59,63,0,30153124.74
JONATHAN.TOEWS,20102011,CHI,1818.8333333333335,33,30,17,47,80,63,1023,1805,782,252,372,84,58,34,14,1925,1466,1328,1066,70,44,0.5667590027700831,30153175.585
JONATHON.BLUM,20102011,NSH,634.6333333333334,3,5,2,7,10,8,0,0,0,29,64,34,18,2,4,543,574,427,507,31,21,0,30153070.92
JONI.PITKANEN,20102011,CAR,1793.6166666666668,5,14,15,29,34,19,0,0,0,144,311,66,100,5,30,1940,1672,1342,1334,53,59,0,30153150.625
JORDAN.CARON,20102011,BOS,291.45,3,1,3,4,7,4,1,7,6,27,49,19,11,0,3,215,322,188,236,10,7,0.14285714285714285,30153044.314999998
JORDAN.EBERLE,20102011,EDM,1220.1333333333332,18,17,8,25,43,35,11,26,15,158,286,32,77,19,10,1144,1077,853,911,33,44,0.4230769230769231,30153126.78
JORDAN.HENDRY,20102011,CHI,395.6,1,0,0,0,1,1,0,1,1,35,64,47,14,7,1,333,353,325,343,12,13,0,30153050.52
JORDAN.LEOPOLD,20102011,BUF,1761.1,13,11,11,22,35,24,0,0,0,139,283,58,101,7,20,1647,1761,1190,1272,45,49,0,30153151.895
JORDAN.STAAL,20102011,PIT,1047.1166666666668,12,14,7,21,33,26,459,968,509,108,196,88,55,8,9,1106,856,720,592,29,26,0.47417355371900827,30153101.015
JORDIN.TOOTOO,20102011,NSH,802.6833333333334,9,12,3,15,24,21,2,4,2,115,198,126,48,30,25,680,696,659,682,28,17,0.5,30153097.455
JOSH.BAILEY,20102011,NYI,1248.4,11,11,6,17,28,22,273,615,342,101,161,47,36,15,13,1075,1258,745,886,27,40,0.44390243902439025,30153138.42
JOSH.GORGES,20102011,MTL,762.2333333333333,1,1,5,6,7,2,0,0,0,20,62,55,23,5,9,579,793,508,521,20,22,0,30153066.825000003
JOSH.GREEN,20102011,ANA,120.1,0,0,0,0,0,0,3,7,4,10,20,11,3,0,2,97,113,96,99,1,4,0.42857142857142855,30153026.92
JUSSI.JOKINEN,20102011,CAR,1208.2666666666667,19,20,13,33,52,39,167,317,150,136,222,43,46,23,10,1326,1074,857,851,43,37,0.526813880126183,30153127.585
JUSTIN.ABDELKADER,20102011,DET,1058.2333333333333,7,8,4,12,19,15,270,506,236,146,252,216,42,29,33,938,1008,875,755,35,26,0.5335968379446641,30153105.689999998
JUSTIN.BRAUN,20102011,S.J,477.53333333333336,2,3,5,8,10,5,0,0,0,45,115,27,36,1,1,492,381,406,313,13,15,0,30153041.634999998
JUSTIN.DIBENEDETTO,20102011,NYI,72.51666666666667,0,0,1,1,1,0,0,0,0,6,10,13,3,5,1,52,68,48,67,2,4,0,30153023.975
JUSTIN.FALK,20102011,MIN,311.45000000000005,0,2,1,3,3,2,0,0,0,7,21,22,11,2,3,218,318,205,274,9,13,0,30153046.345
JUSTIN.WILLIAMS,20102011,L.A,1359.8000000000002,25,18,18,36,61,43,7,14,7,229,414,52,91,21,23,1551,1010,1146,906,56,39,0.5,30153117.19
KARL.ALZNER,20102011,WSH,1834.9666666666667,2,2,7,9,11,4,0,0,0,76,160,107,55,7,11,1597,1668,1431,1307,52,49,0,30153133.494999997
KARLIS.SKRASTINS,20102011,DAL,1328.3166666666666,3,2,2,4,7,5,0,1,1,30,87,55,33,11,19,887,1470,821,989,36,42,0,30153121.310000002
KEATON.ELLERBY,20102011,FLA,869.05,2,3,6,9,11,5,0,0,0,56,137,74,57,6,12,795,786,741,687,19,33,0,30153079.259999998
KEITH.AUCOIN,20102011,WSH,11.783333333333333,0,0,0,0,0,0,1,3,2,0,0,1,0,0,0,19,13,11,9,0,0,0.3333333333333333,15076509.14
KEITH.AULIE,20102011,TOR,765.0333333333333,2,0,0,0,2,2,0,0,0,32,76,98,27,4,13,579,918,522,736,24,22,0,30153098.14
KEITH.BALLARD,20102011,VAN,1176.3166666666666,2,0,4,4,6,2,0,0,0,65,155,113,63,24,25,974,1201,873,961,31,26,0,30153111.84
KEITH.YANDLE,20102011,ARI,2102.4333333333334,11,24,29,53,64,35,0,0,0,208,455,31,135,22,21,2262,1798,1578,1531,67,58,0,30153173.795
KENNDAL.MCARDLE,20102011,FLA,109.4,0,0,0,0,0,0,1,3,2,6,12,36,3,2,6,93,99,92,96,0,3,0.3333333333333333,30153027.16
KENT.HUSKINS,20102011,S.J,924.8499999999999,2,3,4,7,9,5,0,0,0,40,104,19,49,0,7,807,780,762,638,28,19,0,30153068.950000003
KEVIN.BIEKSA,20102011,VAN,2123.95,11,7,14,21,32,18,0,0,0,152,333,192,102,32,50,1950,1886,1566,1393,70,44,0,30153149.369999997
KEVIN.KLEIN,20102011,NSH,1926.9833333333333,3,7,10,17,20,10,0,0,0,114,230,155,68,13,12,1354,2012,1223,1449,65,55,0,30153167.08
KEVIN.PORTER,20102011,COL,1022.5166666666667,14,5,6,11,25,19,19,58,39,102,202,126,52,7,14,923,889,712,811,38,48,0.3275862068965517,30153111.08
KEVIN.SHATTENKIRK,20102011,COL,912.6333333333333,7,11,8,19,26,18,0,0,0,67,154,51,58,5,10,858,721,595,626,29,30,0,30153084.049999997
KEVIN.SHATTENKIRK,20102011,STL,515.9,2,9,5,14,16,11,0,0,0,39,88,15,33,2,8,545,384,420,340,23,16,0,30153047.994999997
KEVIN.WESTGARTH,20102011,L.A,341.9666666666667,0,2,3,5,5,2,2,4,2,23,38,69,3,15,29,253,279,253,275,11,15,0.5,30153050.055
KIMMO.TIMONEN,20102011,PHI,2115.7833333333333,7,18,18,36,43,25,0,1,1,170,335,112,84,17,24,2088,1969,1305,1254,59,59,0,30153146.369999997
KORBINIAN.HOLZER,20102011,TOR,26.033333333333335,0,0,0,0,0,0,0,0,0,1,3,1,2,0,1,27,24,24,21,0,1,0,30153018.35
KRIS.DRAPER,20102011,DET,565.7833333333333,6,1,5,6,12,7,118,219,101,60,100,59,17,3,8,539,541,520,447,25,25,0.5388127853881278,30153064.475
KRIS.LETANG,20102011,PIT,2156.5666666666666,8,21,24,45,53,29,1,1,0,264,547,186,173,30,39,2415,1629,1512,1183,61,53,1,30153121.54
KRIS.NEWBURY,20102011,NYR,83.96666666666667,0,0,0,0,0,0,34,56,22,6,14,19,4,5,8,67,76,67,71,1,1,0.6071428571428571,30153025.36
KRIS.RUSSELL,20102011,CBJ,1278.7333333333333,5,10,7,17,22,15,0,0,0,88,197,63,63,14,17,1361,1003,960,870,38,42,0,30153100.465
KRIS.VERSTEEG,20102011,PHI,580.1333333333333,8,5,4,9,17,13,27,65,38,72,131,35,34,12,13,581,574,459,487,19,17,0.4153846153846154,30153074.6
KRIS.VERSTEEG,20102011,TOR,1003.4333333333334,14,11,9,20,34,25,40,76,36,128,271,20,78,19,14,1122,875,726,730,24,36,0.5263157894736842,30153101.015
KRISTIAN.HUSELIUS,20102011,CBJ,638.1833333333334,14,5,4,9,23,19,0,0,0,94,176,4,37,4,5,727,455,516,415,17,27,0,30153063.189999998
KRYS.BARCH,20102011,DAL,229.86666666666667,2,0,1,1,3,2,2,4,2,16,23,53,2,16,18,156,211,151,207,3,10,0.5,30153044.465
KURTIS.FOSTER,20102011,EDM,1306.7833333333333,8,4,8,12,20,12,0,0,0,182,364,89,108,9,21,1321,1070,804,936,28,38,0,30153117.04
KYLE.BRODZIAK,20102011,MIN,1262.0833333333335,16,15,6,21,37,31,532,1088,556,126,230,52,43,15,22,1083,1278,869,962,38,42,0.4889705882352941,30153157.33
KYLE.CHIPCHURA,20102011,ANA,319.75,0,2,0,2,2,2,132,283,151,23,34,30,4,9,7,230,339,225,272,6,5,0.4664310954063604,30153054.17
KYLE.CLIFFORD,20102011,L.A,802.1333333333334,10,7,2,9,19,17,9,17,8,78,145,153,38,25,35,662,729,651,722,26,38,0.5294117647058824,30153103.36
KYLE.CUMISKEY,20102011,COL,353.96666666666664,1,0,6,6,7,1,0,0,0,21,39,9,8,2,5,300,370,229,234,15,14,0,30153039.67
KYLE.OKPOSO,20102011,NYI,630.15,5,7,8,15,20,12,36,86,50,72,163,31,55,14,16,696,515,512,438,26,17,0.4186046511627907,30153060.68
KYLE.PALMIERI,20102011,ANA,96.98333333333333,1,0,0,0,1,1,0,0,0,11,16,5,2,0,0,65,103,65,103,2,3,0,30153029.35
KYLE.QUINCEY,20102011,COL,411.2166666666667,0,1,0,1,1,1,0,0,0,39,73,28,24,5,9,362,358,270,266,13,14,0,30153041.25
KYLE.TURRIS,20102011,ARI,788.0666666666666,12,9,6,15,27,21,288,576,288,124,201,36,39,11,9,842,661,703,612,35,30,0.5,30153095.03
KYLE.WELLWOOD,20102011,S.J,727.6166666666666,6,8,5,13,19,14,85,163,78,68,122,16,31,13,0,834,576,775,562,26,8,0.5214723926380368,30153069.055
KYLE.WILSON,20102011,CBJ,340.3333333333333,4,4,3,7,11,8,63,133,70,38,63,21,15,4,6,306,283,261,250,14,15,0.47368421052631576,30153047.535
LADISLAV.SMID,20102011,EDM,1581.5333333333333,0,3,5,8,8,3,0,0,0,48,121,145,50,17,30,1234,1614,1044,1168,40,56,0,30153135.095
LANCE.BOUMA,20102011,CGY,93.96666666666667,0,1,0,1,1,1,0,3,3,9,17,15,4,3,1,95,77,95,77,2,3,0,30153023.729999997
LARS.ELLER,20102011,MTL,949.0999999999999,7,9,3,12,19,16,205,482,277,90,190,103,50,10,27,898,879,857,833,27,31,0.42531120331950206,30153117.575
LAURI.KORPIKOSKI,20102011,ARI,1292.9499999999998,19,13,9,22,41,32,108,247,139,105,200,97,48,16,11,956,1507,791,960,41,36,0.43724696356275305,30153141.655
LEE.STEMPNIAK,20102011,ARI,1299.6833333333334,19,4,15,19,38,23,19,49,30,207,369,128,99,22,6,1299,1184,1071,1109,41,39,0.3877551020408163,30153137.705
LEE.SWEATT,20102011,VAN,40.16666666666667,1,1,0,1,2,2,0,0,0,4,8,4,2,0,1,34,39,34,39,4,0,0,30153021.35
LIAM.REDDOX,20102011,EDM,659.8333333333333,1,5,4,9,10,6,41,124,83,85,142,76,34,11,7,472,693,397,461,11,20,0.33064516129032256,30153071.95
LINUS.KLASEN,20102011,NSH,51.55,0,0,0,0,0,0,0,0,0,4,6,1,0,0,0,52,30,43,28,0,3,0,30153018.75
LINUS.OMARK,20102011,EDM,783.1333333333333,5,14,8,22,27,19,3,8,5,75,140,13,38,16,15,801,606,558,569,19,31,0.375,30153083.58
LOGAN.COUTURE,20102011,S.J,1757,39,21,10,31,70,60,579,1118,539,315,528,71,99,27,19,2060,1498,1454,1188,56,38,0.5178890876565295,30153178.380000003
LOUI.ERIKSSON,20102011,DAL,1624.95,27,27,17,44,71,54,1,4,3,179,285,26,41,23,4,1643,1427,1038,1141,51,38,0.25,30153166.895000003
LUBOMIR.VISNOVSKY,20102011,ANA,2095.8999999999996,18,18,32,50,68,36,0,0,0,163,364,55,116,9,12,2215,1724,1398,1460,81,63,0,30153170.990000002
LUCA.CAPUTI,20102011,TOR,77.48333333333333,0,0,0,0,0,0,2,6,4,8,15,7,2,1,2,89,73,70,66,0,3,0.3333333333333333,30153023.490000002
LUCA.SBISA,20102011,ANA,1241.0333333333333,2,5,5,10,12,7,0,0,0,78,158,182,49,18,19,961,1293,749,1041,24,43,0,30153135.705
LUKE.ADAM,20102011,BUF,213,3,0,1,1,4,3,41,119,78,31,48,17,7,5,5,201,210,151,193,4,8,0.3445378151260504,30153044.265
LUKE.SCHENN,20102011,TOR,1834.2833333333333,5,10,4,14,19,15,0,0,0,128,314,251,130,12,13,1634,1975,1398,1489,59,61,0,30153159.37
MAGNUS.PAAJARVI,20102011,EDM,1230.7833333333333,15,10,9,19,34,25,1,5,4,180,317,22,79,19,9,1120,1037,869,958,33,48,0.2,30153127.355
MAKSIM.MAYOROV,20102011,CBJ,43.5,1,0,0,0,1,1,0,0,0,3,8,4,3,0,0,44,31,44,31,1,1,0,30153019.2
MANNY.MALHOTRA,20102011,VAN,1234.8333333333335,11,10,9,19,30,21,813,1329,516,116,204,61,41,16,11,930,1301,747,906,29,27,0.6117381489841986,30153143.705
MARC-ANDRE.BERGERON,20102011,T.B,511.16666666666663,4,3,3,6,10,7,0,0,0,61,144,25,52,7,7,659,357,455,304,12,18,0,30153038.595
MARC-ANDRE.GRAGNANI,20102011,BUF,290.85,2,2,6,8,10,4,0,0,0,20,37,14,12,4,3,319,228,211,194,6,6,0,30153036.79
MARC-ANTOINE.POULIOT,20102011,T.B,32.300000000000004,0,0,0,0,0,0,5,13,8,2,4,2,1,1,0,30,25,24,23,1,3,0.38461538461538464,15076510.66
MARC-EDOUARD.VLASIC,20102011,S.J,2060.616666666667,4,10,5,15,19,14,0,0,0,134,331,72,118,11,11,1985,2004,1679,1475,67,56,0,30153143.185
MARC.METHOT,20102011,CBJ,1471.8,0,7,8,15,15,7,0,0,0,57,131,176,43,17,26,1091,1484,975,1023,45,43,0,30153119.369999997
MARC.SAVARD,20102011,BOS,395.08333333333337,2,4,4,8,10,6,167,328,161,50,83,5,17,9,9,467,359,322,320,11,14,0.5091463414634146,30153058.42
MARC.STAAL,20102011,NYR,2120.883333333333,7,12,11,23,30,19,0,0,0,121,249,150,74,17,24,1795,2101,1361,1488,52,59,0,30153174.895
MARCEL.GOC,20102011,NSH,817.9833333333333,9,4,11,15,24,13,346,693,347,111,178,51,36,6,3,745,701,622,598,33,26,0.49927849927849927,30153094.025
MARCEL.MUELLER,20102011,TOR,30.366666666666667,0,0,0,0,0,0,0,1,1,5,7,7,0,0,1,26,23,26,23,0,0,0,30153019.1
MARCO.SCANDELLA,20102011,MIN,299.3833333333333,0,2,0,2,2,2,0,0,0,13,27,20,9,4,1,236,266,208,241,7,20,0,30153041.79
MARCO.STURM,20102011,L.A,245.98333333333335,4,3,2,5,9,7,1,1,0,27,44,12,3,2,3,230,219,191,181,11,5,1,30153038.41
MARCO.STURM,20102011,WSH,384.0333333333333,2,4,4,8,10,6,5,15,10,48,84,23,19,4,5,367,340,304,281,10,7,0.3333333333333333,30153046.64
MARCUS.JOHANSSON,20102011,WSH,1181.2666666666667,15,14,4,18,33,29,310,764,454,116,206,55,58,20,5,1091,1128,862,943,41,36,0.40575916230366493,30153144.85
MARCUS.KRUGER,20102011,CHI,142.96666666666667,0,0,1,1,1,0,23,63,40,9,16,6,4,5,2,118,121,110,101,3,4,0.36507936507936506,30153027.745
MAREK.SVATOS,20102011,NSH,101.15,1,1,1,2,3,2,0,0,0,17,25,4,5,2,1,103,106,87,102,5,4,0,30153028.295
MAREK.SVATOS,20102011,OTT,227.09999999999997,3,2,0,2,5,5,0,0,0,33,55,8,11,2,4,210,200,184,192,7,7,0,30153038.869999997
MAREK.ZIDLICKY,20102011,MIN,1001.5333333333333,7,7,10,17,24,14,0,0,0,53,141,66,51,9,15,828,982,540,697,22,28,0,30153097.59
MARIAN.GABORIK,20102011,NYR,1240.8666666666668,23,16,11,27,50,39,0,0,0,212,359,59,77,14,10,1219,993,808,887,41,30,0,30153129.415
MARIAN.HOSSA,20102011,CHI,1411.1,27,18,18,36,63,45,6,7,1,221,341,62,64,11,17,1393,1199,982,914,42,35,0.8571428571428571,30153132.450000003
MARIO.BLIZNAK,20102011,VAN,26.45,1,0,0,0,1,1,7,21,14,1,3,2,1,0,0,10,37,8,27,1,1,0.3333333333333333,15076512.98
MARK.EATON,20102011,NYI,692.25,0,1,1,2,2,1,0,0,0,29,63,30,18,7,4,484,790,413,559,17,22,0,30153077.195
MARK.FAYNE,20102011,N.J,1016.6500000000001,4,5,5,10,14,9,0,0,0,77,147,51,43,5,12,851,716,736,621,34,26,0,30153072.925
MARK.FISTRIC,20102011,DAL,819.8499999999999,2,2,1,3,5,4,0,0,0,26,80,173,30,11,19,586,821,559,688,27,38,0,30153090.035
MARK.FRASER,20102011,N.J,363.4,0,2,0,2,2,2,0,0,0,16,37,58,10,11,10,289,293,279,252,10,10,0,30153040.86
MARK.GIORDANO,20102011,CGY,1897.55,8,16,17,33,41,24,0,0,0,164,389,140,129,19,30,1950,1567,1336,1162,51,48,0,30153125.564999998
MARK.KATIC,20102011,NYI,180.7,0,0,0,0,0,0,0,0,0,8,14,8,4,0,1,142,169,117,140,3,8,0,30153031.15
MARK.LETESTU,20102011,PIT,1020.6333333333333,14,7,7,14,28,21,452,827,375,143,258,58,63,12,5,1168,708,833,613,30,24,0.5465538089480049,30153089.275
MARK.MANCARI,20102011,BUF,256.1,1,3,4,7,8,4,3,6,3,44,66,17,7,2,6,258,205,205,198,9,10,0.5,30153039.439999998
MARK.OLVER,20102011,COL,213.95,2,4,3,7,9,6,12,25,13,25,41,27,10,7,6,178,183,136,174,9,10,0.48,30153039.525
MARK.PARRISH,20102011,BUF,23.55,0,0,0,0,0,0,0,0,0,0,2,2,1,0,0,29,23,28,22,1,3,0,15076509.85
MARK.RECCHI,20102011,BOS,1708.3166666666666,19,21,21,42,61,40,70,135,65,171,281,124,65,20,20,1819,1485,1290,1253,65,44,0.5185185185185185,30153161.174999997
MARK.STUART,20102011,ATL,341.5,1,0,0,0,1,1,0,0,0,21,51,51,16,7,6,269,329,254,268,6,14,0,30153043.42
MARK.STUART,20102011,BOS,503.9333333333333,1,3,1,4,5,4,1,1,0,20,58,56,21,10,7,418,541,383,427,19,14,1,30153059.965
MARTIN.ERAT,20102011,NSH,1349.75,18,22,16,38,56,40,21,50,29,150,271,68,78,23,14,1321,1139,948,932,43,28,0.42,30153127.72
MARTIN.HANZAL,20102011,ARI,1269,17,7,5,12,29,24,561,1110,549,156,275,161,48,24,30,1316,1152,869,786,28,32,0.5054054054054054,30153130.055
MARTIN.HAVLAT,20102011,MIN,1430.8166666666666,22,28,12,40,62,50,3,10,7,228,368,34,66,22,23,1480,1241,1038,1097,50,55,0.3,30153158.84
MARTIN.ST. LOUIS,20102011,T.B,2101.4333333333334,41,50,27,77,118,91,52,143,91,304,527,45,110,36,8,2321,1783,1420,1469,74,58,0.36363636363636365,30153217.265
MARTY.REASONER,20102011,FLA,1407.25,14,11,7,18,32,25,700,1284,584,124,232,71,53,16,11,1112,1481,994,1009,38,34,0.5451713395638629,30153151.085
MASON.RAYMOND,20102011,VAN,1525.7666666666669,16,16,14,30,46,32,46,106,60,253,420,57,89,26,7,1620,1238,1330,1017,44,41,0.4339622641509434,30153120.15
MATHIEU.DARCHE,20102011,MTL,774.7166666666667,13,11,4,15,28,24,7,21,14,102,176,86,36,8,5,860,638,696,596,29,21,0.3333333333333333,30153083.36
MATHIEU.PERREAULT,20102011,WSH,414.70000000000005,7,4,3,7,14,11,137,297,160,41,78,13,21,7,10,453,311,335,280,13,15,0.4612794612794613,30153054.225
MATHIEU.ROY,20102011,T.B,18.86666666666667,0,0,0,0,0,0,0,0,0,1,2,4,0,1,1,20,19,20,18,0,2,0,30153018.41
MATS.ZUCCARELLO,20102011,NYR,602.8,6,8,9,17,23,14,8,15,7,75,122,56,18,7,3,665,407,477,358,19,15,0.5333333333333333,30153054.615000002
MATT.BARTKOWSKI,20102011,BOS,55.233333333333334,0,0,0,0,0,0,0,0,0,2,8,4,4,1,2,48,59,47,57,1,2,0,30153022.36
MATT.BELESKEY,20102011,ANA,521.8833333333333,4,4,3,7,11,8,4,10,6,66,109,73,23,10,17,405,603,378,551,17,28,0.4,30153085.685000002
MATT.BRADLEY,20102011,WSH,724.2166666666667,4,1,6,7,11,5,5,12,7,63,113,184,28,16,21,578,612,560,594,20,25,0.4166666666666667,30153080.96
MATT.CALVERT,20102011,CBJ,465.93333333333334,11,5,4,9,20,16,3,9,6,50,84,51,17,17,4,486,341,397,322,21,17,0.3333333333333333,30153053.54
MATT.CAMPANALE,20102011,NYI,8.35,0,0,0,0,0,0,0,0,0,0,0,0,0,0,1,5,13,5,13,0,0,0,15076510.1
MATT.CARKNER,20102011,OTT,744.2,1,2,1,3,4,3,0,0,0,40,71,71,21,19,38,593,682,569,514,23,22,0,30153068.314999998
MATT.CARLE,20102011,PHI,2060.7166666666667,1,22,21,43,44,23,0,0,0,136,306,55,107,10,11,2156,1943,1679,1651,86,63,0,30153174.175
MATT.COOKE,20102011,PIT,1047.5833333333333,12,8,10,18,30,20,8,29,21,95,166,192,31,27,45,877,1002,743,682,33,25,0.27586206896551724,30153098.34
MATT.CULLEN,20102011,MIN,1406.1333333333332,12,17,10,27,39,29,473,843,370,150,287,39,79,20,15,1221,1340,757,973,31,38,0.561091340450771,30153150.32
MATT.D'AGOSTINI,20102011,STL,1210.25,21,16,9,25,46,37,21,55,34,163,286,70,63,19,18,1230,954,974,913,51,44,0.38181818181818183,30153124.354999997
MATT.DUCHENE,20102011,COL,1515.5833333333335,27,23,17,40,67,50,627,1245,618,202,356,57,69,23,15,1529,1314,1054,1182,60,56,0.5036144578313253,30153191.785
MATT.ELLIS,20102011,BUF,152.15,0,0,0,0,0,0,35,68,33,20,41,9,8,0,0,118,131,116,124,0,4,0.5147058823529411,30153030.4
MATT.FRATTIN,20102011,TOR,15.566666666666666,0,0,0,0,0,0,0,0,0,5,8,1,1,0,0,26,14,22,11,0,0,0,15076508.9
MATT.GILROY,20102011,NYR,900.5999999999999,4,3,4,7,11,7,0,0,0,82,152,47,46,6,7,845,766,714,688,29,24,0,30153082.71
MATT.GREENE,20102011,L.A,1305.75,2,6,3,9,11,8,0,0,0,56,124,265,35,8,34,1029,1275,973,904,35,34,0,30153105.854999997
MATT.HALISCHUK,20102011,NSH,414.45000000000005,6,3,5,8,14,9,1,10,9,36,70,9,15,6,1,313,379,297,360,18,15,0.1,30153059.375
MATT.HENDRICKS,20102011,WSH,946.0333333333333,9,8,7,15,24,17,53,100,47,114,199,182,40,27,35,820,881,720,711,25,33,0.53,30153101.665
MATT.HUNWICK,20102011,BOS,356.73333333333335,1,0,2,2,3,1,0,0,0,26,49,16,12,2,3,331,341,251,307,12,8,0,30153049.02
MATT.HUNWICK,20102011,COL,994.6666666666666,0,4,4,8,8,4,0,0,0,73,139,49,44,5,8,812,1031,641,732,20,33,0,30153092.05
MATT.KASSIAN,20102011,MIN,21.93333333333333,0,0,0,0,0,0,0,0,0,1,2,6,1,2,3,12,25,12,24,0,1,0,30153019.869999997
MATT.LASHOFF,20102011,TOR,152.15,0,0,1,1,1,0,0,0,0,8,22,10,7,2,3,140,154,103,139,5,1,0,30153031.345
MATT.MARTIN,20102011,NYI,745.1166666666666,5,4,5,9,14,9,10,27,17,60,132,299,43,24,33,543,859,506,752,18,34,0.37037037037037035,30153109.865000002
MATT.MOULSON,20102011,NYI,1547.3,31,8,14,22,53,39,5,9,4,237,402,84,87,19,13,1745,1411,1144,1211,46,54,0.5555555555555556,30153162.29
MATT.NISKANEN,20102011,DAL,708.1,0,2,3,5,5,2,0,0,0,51,137,97,48,5,12,705,552,492,484,19,15,0,30153060.175
MATT.NISKANEN,20102011,PIT,424.0333333333333,1,3,1,4,5,4,0,0,0,31,63,32,15,2,9,389,343,319,290,8,11,0,30153045.945
MATT.SMABY,20102011,T.B,223.68333333333334,0,0,0,0,0,0,0,0,0,9,23,45,10,4,7,214,196,206,179,6,5,0,30153032.189999998
MATT.STAJAN,20102011,CGY,1081.2833333333333,6,17,7,24,30,23,436,845,409,81,148,66,26,11,17,1057,964,914,819,42,39,0.5159763313609468,30153120.325
MATT.TAORMINA,20102011,N.J,351.3833333333333,3,2,0,2,5,5,0,0,0,38,72,12,18,4,1,325,230,235,214,8,11,0,30153038.240000002
MATT.WALKER,20102011,PHI,46.53333333333333,0,0,0,0,0,0,0,0,0,3,4,5,1,1,2,29,55,29,54,1,1,0,30153023.310000002
MATTHEW.CORRENTE,20102011,N.J,299.18333333333334,0,3,3,6,6,3,0,0,0,21,40,30,16,7,12,249,259,242,243,12,16,0,30153041.445
MATTHEW.LOMBARDI,20102011,NSH,29.65,0,0,0,0,0,0,15,28,13,6,8,0,0,0,0,25,32,12,28,0,1,0.5357142857142857,30153020.9
MATTIAS.OHLUND,20102011,T.B,1711.8833333333332,1,2,5,7,8,3,0,0,0,48,120,174,47,8,35,1183,1948,1094,1370,54,56,0,30153162.055
MATTIAS.RITOLA,20102011,T.B,314.31666666666666,4,3,1,4,8,7,18,43,25,42,69,24,13,6,4,293,238,249,219,9,12,0.4186046511627907,30153041.955
MATTIAS.TEDENBY,20102011,N.J,727.5333333333333,8,10,4,14,22,18,0,0,0,87,136,24,30,20,7,689,496,513,454,22,17,0,30153068.15
MAX.PACIORETTY,20102011,MTL,588.1333333333333,14,6,4,10,24,20,0,1,1,111,187,66,30,15,15,770,432,581,396,18,19,0,30153061.05
MAX.TALBOT,20102011,PIT,1353.7666666666667,9,13,3,16,25,22,476,983,507,126,206,166,46,33,24,1092,1331,998,911,28,33,0.4842319430315361,30153136.645
MAXIM.LAPIERRE,20102011,ANA,243.14999999999998,0,2,1,3,3,2,71,133,62,28,46,59,9,3,3,147,265,144,227,5,9,0.5338345864661654,30153046.695
MAXIM.LAPIERRE,20102011,MTL,444.55,5,3,0,3,8,8,29,50,21,78,112,104,16,14,19,387,414,383,393,13,20,0.58,30153064.75
MAXIM.LAPIERRE,20102011,VAN,558.4833333333333,4,1,1,2,6,5,203,411,208,65,107,114,24,10,15,420,564,404,464,11,9,0.49391727493917276,30153078.045
MAXIM.NOREAU,20102011,MIN,71.43333333333334,0,0,0,0,0,0,0,0,0,8,15,2,2,1,0,72,58,44,47,2,3,0,30153021.16
MICHAEL.DEL ZOTTO,20102011,NYR,915.8166666666667,2,5,3,8,10,7,0,0,0,58,152,92,52,3,10,982,773,653,651,29,32,0,30153078.155
MICHAEL.FROLIK,20102011,CHI,535.9666666666667,5,7,2,9,14,12,63,152,89,111,162,33,33,5,7,485,437,425,399,16,13,0.4144736842105263,30153065.72
MICHAEL.FROLIK,20102011,FLA,833.7166666666667,8,10,11,21,29,18,5,12,7,158,272,31,61,6,10,875,717,695,663,30,29,0.4166666666666667,30153089.235
MICHAEL.GRABNER,20102011,NYI,1146.3166666666666,34,12,5,17,51,46,2,6,4,228,334,22,51,20,5,1079,1087,878,875,42,36,0.3333333333333333,30153133.205
MICHAEL.GRIER,20102011,BUF,1117.0666666666666,5,5,6,11,16,10,11,32,21,112,172,129,25,9,6,774,1221,712,818,27,33,0.34375,30153110.03
MICHAEL.RUPP,20102011,PIT,878.4,10,7,2,9,19,17,100,195,95,96,162,200,36,26,42,792,707,685,670,27,25,0.5128205128205128,30153099.41
MICHAEL.RYDER,20102011,BOS,1508.9,26,23,9,32,58,49,5,11,6,209,378,94,98,22,17,1517,1354,1179,1251,57,46,0.45454545454545453,30153166.945
MICHAEL.SAUER,20102011,NYR,1445.4333333333334,3,6,6,12,15,9,0,0,0,56,131,87,37,19,26,1217,1349,1127,1096,47,31,0,30153124.689999998
MICHAEL.VERNACE,20102011,T.B,87,0,0,1,1,1,0,0,0,0,6,11,8,2,0,1,95,80,92,73,4,6,0,30153022.475
MICHAEL.ZIGOMANIS,20102011,TOR,55.8,0,0,1,1,1,0,21,40,19,7,10,6,2,0,2,35,50,29,32,1,1,0.525,30153020.865000002
MICHAL.HANDZUS,20102011,L.A,1544.4333333333334,13,10,9,19,32,23,736,1452,716,101,189,104,35,18,10,1325,1453,850,988,31,37,0.5068870523415978,30153162.744999997
MICHAL.REPIK,20102011,FLA,396.18333333333334,2,4,2,6,8,6,3,7,4,54,94,47,12,4,13,403,332,363,307,8,13,0.42857142857142855,30153050.009999998
MICHAL.ROZSIVAL,20102011,ARI,739.2833333333333,3,2,1,3,6,5,0,0,0,34,64,65,18,5,11,665,713,566,506,26,26,0,30153064.175
MICHAL.ROZSIVAL,20102011,NYR,705.4666666666667,3,5,6,11,14,8,0,0,0,24,79,45,33,5,11,654,592,486,465,26,17,0,30153061.299999997
MICHEAL.HALEY,20102011,NYI,216.73333333333335,2,1,0,1,3,3,7,20,13,13,24,55,6,12,20,143,228,135,222,6,10,0.35,30153047.549999997
MIKAEL.BACKLUND,20102011,CGY,881.7833333333333,10,9,6,15,25,19,319,664,345,144,240,35,41,12,9,876,711,778,592,32,28,0.48042168674698793,30153090.58
MIKAEL.SAMUELSSON,20102011,VAN,1428.25,19,25,9,34,53,44,10,31,21,234,423,95,111,15,21,1656,1067,1195,997,47,43,0.3225806451612903,30153126.275
MIKE.BLUNDEN,20102011,CBJ,10.516666666666667,0,0,0,0,0,0,5,10,5,2,4,6,1,0,0,10,15,10,15,0,1,0.5,15076510.15
MIKE.BROWN,20102011,TOR,504.70000000000005,3,3,2,5,8,6,4,15,11,58,96,105,14,17,17,333,558,291,425,14,13,0.26666666666666666,30153071.53
MIKE.CAMMALLERI,20102011,MTL,1403.2833333333333,22,18,17,35,57,40,48,103,55,217,381,18,87,21,15,1459,1260,974,1045,38,37,0.46601941747572817,30153147.955
MIKE.COMMODORE,20102011,CBJ,371.2,2,2,2,4,6,4,0,1,1,32,71,38,25,6,17,324,364,264,258,5,13,0,30153044.41
MIKE.COMRIE,20102011,PIT,248.26666666666665,1,3,2,5,6,4,15,40,25,25,39,10,10,7,5,263,182,180,162,4,10,0.375,30153035.369999997
MIKE.DUCO,20102011,FLA,17.1,0,0,0,0,0,0,0,0,0,0,0,6,0,2,2,13,19,13,19,0,1,0,15076510.77
MIKE.FISHER,20102011,NSH,741.5666666666667,8,7,4,11,19,15,320,667,347,85,162,69,40,8,9,688,646,489,543,20,18,0.47976011994003,30153094.08
MIKE.FISHER,20102011,OTT,1013.3,14,8,2,10,24,22,399,825,426,132,204,91,35,10,14,857,999,569,735,21,34,0.48363636363636364,30153130.36
MIKE.GREEN,20102011,WSH,1395.5500000000002,9,12,9,21,30,21,0,0,0,138,295,112,104,16,27,1563,1171,971,866,35,36,0,30153101.685
MIKE.KNUBLE,20102011,WSH,1533.7166666666667,26,10,6,16,42,36,10,35,25,213,326,86,41,9,22,1670,1390,1182,1126,38,33,0.2857142857142857,30153153.79
MIKE.KOMISAREK,20102011,TOR,1022.3333333333334,1,4,4,8,9,5,0,0,0,48,149,145,72,15,27,826,1112,779,921,33,44,0,30153109.75
MIKE.LUNDIN,20102011,T.B,1672.0166666666667,1,4,9,13,14,5,0,0,0,65,190,29,83,7,7,1308,1737,1149,1264,59,55,0,30153135.295
MIKE.MODANO,20102011,DET,518.3666666666667,4,5,7,12,16,9,139,283,144,84,148,10,34,7,4,621,396,417,362,15,15,0.4911660777385159,30153059.355
MIKE.MOORE,20102011,S.J,60.66666666666667,1,0,0,0,1,1,0,0,0,5,8,4,3,1,2,54,59,54,56,4,5,0,30153022.41
MIKE.MOTTAU,20102011,NYI,406.66666666666663,0,0,3,3,3,0,0,0,0,21,48,17,20,2,4,364,402,279,329,4,17,0,30153050.195
MIKE.RIBEIRO,20102011,DAL,1636.6,19,34,17,51,70,53,565,1213,648,161,286,95,59,24,12,1732,1373,1032,1075,56,52,0.46578730420445175,30153179.015
MIKE.RICHARDS,20102011,PHI,1738.9333333333334,24,32,16,48,72,56,667,1360,693,227,448,119,113,34,33,1790,1595,1159,1176,51,48,0.4904411764705882,30153190.57
MIKE.SANTORELLI,20102011,FLA,1368.2,20,12,9,21,41,32,518,1031,513,193,320,60,61,12,10,1431,1278,957,977,39,51,0.5024248302618817,30153153.215
MIKE.WEAVER,20102011,FLA,1706.1666666666665,2,7,4,11,13,9,0,0,0,53,145,98,62,18,17,1363,1756,1257,1243,41,45,0,30153135.58
MIKE.WEBER,20102011,BUF,1090.8166666666666,4,3,8,11,15,7,0,0,0,59,132,175,45,15,33,879,1132,824,889,39,33,0,30153109.15
MIKHAIL.GRABOVSKI,20102011,TOR,1568.2666666666669,29,19,10,29,58,48,642,1324,682,239,428,44,84,28,29,1796,1330,1278,1104,62,41,0.48489425981873113,30153172.060000002
MIKKEL.BOEDKER,20102011,ARI,406.53333333333336,4,7,4,11,15,11,3,5,2,42,79,46,21,9,4,392,328,322,317,16,6,0.6,30153052.21
MIKKO.KOIVU,20102011,MIN,1383.8833333333334,17,21,24,45,62,38,683,1293,610,191,341,62,83,25,24,1254,1172,781,844,35,30,0.5282289249806651,30153148.67
MILAN.HEJDUK,20102011,COL,1272.5,22,18,16,34,56,40,2,5,3,170,254,9,42,7,9,1271,1077,849,963,38,47,0.4,30153143.05
MILAN.JURCINA,20102011,NYI,831.1166666666667,4,8,5,13,17,12,0,0,0,76,139,125,39,1,15,691,969,545,728,29,36,0,30153101.884999998
MILAN.LUCIC,20102011,BOS,1757.35,35,22,16,38,73,57,24,68,44,228,434,238,115,27,52,2075,1450,1566,1326,80,41,0.35294117647058826,30153167.08
MILAN.MICHALEK,20102011,OTT,1192,18,8,7,15,33,26,4,13,9,167,270,49,47,21,20,1050,1127,714,822,31,42,0.3076923076923077,30153121.895
NATE.GUENIN,20102011,CBJ,44.38333333333333,0,0,0,0,0,0,0,0,0,2,3,11,1,0,1,34,38,27,35,1,3,0,30153020.35
NATE.PROSSER,20102011,MIN,29.6,0,0,0,0,0,0,0,0,0,1,3,0,1,0,0,25,18,24,17,0,0,0,15076509.5
NATE.THOMPSON,20102011,T.B,1473.3166666666668,11,11,6,17,28,22,430,816,386,149,242,146,44,18,15,1011,1586,911,1008,34,42,0.5269607843137255,30153149.53
NATHAN.GERBE,20102011,BUF,946.7333333333333,18,8,7,15,33,26,5,20,15,190,295,73,55,27,21,982,772,815,719,32,27,0.25,30153101.695
NATHAN.HORTON,20102011,BOS,1657.8833333333332,34,21,15,36,70,55,9,22,13,238,429,107,99,28,40,1992,1337,1518,1235,83,44,0.4090909090909091,30153153.765
NATHAN.OYSTRICK,20102011,STL,109.55000000000001,1,0,2,2,3,1,0,0,0,11,21,6,8,1,3,134,58,108,57,5,4,0,30153019.560000002
NAZEM.KADRI,20102011,TOR,457.48333333333335,3,5,4,9,12,8,49,121,72,51,94,16,22,14,4,472,408,353,372,11,10,0.4049586776859504,30153061.25
NICHOLAS.DRAZENOVIC,20102011,STL,26.93333333333333,0,0,0,0,0,0,6,11,5,2,5,7,0,0,0,24,23,16,23,0,3,0.5454545454545454,30153019.439999998
NICK.BONINO,20102011,ANA,301.43333333333334,0,0,0,0,0,0,86,187,101,30,54,22,8,5,3,234,301,207,278,4,9,0.45989304812834225,30153052.240000002
NICK.BOYNTON,20102011,CHI,644.5,1,3,4,7,8,4,0,0,0,42,85,50,31,5,15,563,609,530,515,30,28,0,30153065.15
NICK.BOYNTON,20102011,PHI,102.48333333333333,0,0,0,0,0,0,0,0,0,1,10,11,5,0,2,76,132,75,129,1,4,0,30153031.55
NICK.FOLIGNO,20102011,OTT,1277.3166666666666,14,11,8,19,33,25,65,138,73,149,219,119,38,29,19,1202,1085,974,1001,32,50,0.47101449275362317,30153137.490000002
NICK.HOLDEN,20102011,CBJ,85.95,0,0,0,0,0,0,0,0,0,6,15,4,4,1,0,94,58,57,51,1,1,0,30153020.86
NICK.JOHNSON,20102011,PIT,66.95,1,1,1,2,3,2,0,0,0,10,14,4,1,1,1,73,50,54,42,4,2,0,30153021.335
NICK.LEDDY,20102011,CHI,760.5833333333334,4,1,1,2,6,5,0,0,0,39,74,32,19,4,2,676,668,638,614,32,33,0,30153074.765
NICK.PALMIERI,20102011,N.J,616,9,5,3,8,17,14,2,2,0,66,126,36,29,5,2,501,436,450,418,23,16,1,30153061.805
NICK.SCHULTZ,20102011,MIN,1496.3166666666666,3,9,5,14,17,12,1,1,0,45,115,78,35,5,18,1134,1557,1009,1139,48,49,1,30153136.865000002
NICK.SPALING,20102011,NSH,1214.7833333333333,10,4,6,10,20,14,312,608,296,86,165,53,46,12,10,803,1253,738,838,23,35,0.5131578947368421,30153122.2
NICKLAS.BACKSTROM,20102011,WSH,1788.35,18,30,19,49,67,48,759,1465,706,225,391,76,80,14,20,2193,1514,1428,1158,55,36,0.5180887372013652,30153171.175
NICKLAS.GROSSMANN,20102011,DAL,1073.6666666666667,1,4,5,9,10,5,0,0,0,38,114,161,44,8,15,782,1096,720,798,36,30,0,30153095.705
NICKLAS.LIDSTROM,20102011,DET,2164.3999999999996,20,19,28,47,67,39,0,0,0,201,404,56,102,2,12,2338,1913,1438,1355,68,59,0,30153160.770000003
NICLAS.BERGFORS,20102011,ATL,735.9333333333334,11,8,9,17,28,19,2,3,1,99,165,4,37,4,3,838,647,665,621,25,34,0.6666666666666666,30153085.345
NICLAS.BERGFORS,20102011,FLA,326.2833333333333,1,4,2,6,7,5,2,6,4,53,81,8,10,1,2,322,258,269,232,10,8,0.3333333333333333,30153041.04
NICLAS.WALLIN,20102011,S.J,1470.4666666666667,4,4,4,8,12,8,0,0,0,110,216,135,65,9,25,1301,1458,1206,1168,45,46,0,30153129.54
NIGEL.DAWES,20102011,ATL,100.66666666666666,0,0,1,1,1,0,0,0,0,9,15,11,4,0,1,84,104,80,98,2,8,0,30153026.975
NIGEL.DAWES,20102011,MTL,26.949999999999996,0,0,0,0,0,0,0,0,0,3,5,8,1,0,0,25,33,20,32,0,0,0,30153020.3
NIK.ANTROPOV,20102011,ATL,1189.4166666666665,16,16,9,25,41,32,260,534,274,104,182,62,32,8,18,1154,1000,814,925,33,43,0.4868913857677903,30153144.555
NIKITA.FILATOV,20102011,CBJ,283.3,0,4,3,7,7,4,0,0,0,31,61,10,21,5,4,283,190,202,178,4,1,0,30153033.975
NIKITA.NIKITIN,20102011,STL,672.0833333333333,1,5,3,8,9,6,0,0,0,46,109,40,37,5,5,579,566,475,456,21,20,0,30153059.225
NIKLAS.HAGMAN,20102011,CGY,968.4000000000001,11,12,4,16,27,23,3,25,22,140,255,35,61,20,12,999,771,758,710,29,27,0.12,30153096.270000003
NIKLAS.HJALMARSSON,20102011,CHI,1610.6166666666666,3,3,6,9,12,6,0,0,0,69,157,55,51,13,15,1257,1538,1158,1159,53,38,0,30153126.88
NIKLAS.KRONWALL,20102011,DET,2014.65,13,14,13,27,40,27,0,0,0,146,297,139,92,11,20,2010,1803,1467,1254,58,54,0,30153136.935000002
NIKOLAY.KULEMIN,20102011,TOR,1420.5833333333333,30,8,17,25,55,38,60,111,51,173,314,101,74,21,13,1541,1254,1124,1042,54,39,0.5405405405405406,30153136.835
NIKOLAY.ZHERDEV,20102011,PHI,815.5,17,4,4,8,25,21,2,8,6,156,244,46,53,16,12,954,677,829,643,32,27,0.25,30153083.189999998
NINO.NIEDERREITER,20102011,NYI,122.33333333333334,1,1,0,1,2,2,0,0,0,12,19,16,4,2,3,91,120,77,117,2,3,0,30153031.62
NOAH.WELCH,20102011,ATL,35.099999999999994,0,0,0,0,0,0,0,0,0,1,2,10,1,0,0,28,32,28,32,2,3,0,30153019.5
NOLAN.YONKMAN,20102011,ARI,194.01666666666668,0,1,0,1,1,1,0,0,0,8,14,41,5,5,14,146,194,136,133,9,3,0,30153030.65
OLIVER.EKMAN-LARSSON,20102011,ARI,721.7,1,4,5,9,10,5,0,0,0,50,117,41,42,8,12,701,604,588,516,29,24,0,30153061.505000003
OLIVIER.MAGNAN,20102011,N.J,153.6,0,0,0,0,0,0,0,1,1,3,8,15,2,0,0,127,126,116,95,2,4,0,30153024.55
OLIVIER.MAGNAN-GRENIER,20102011,N.J,129.21666666666667,0,0,0,0,0,0,0,0,0,5,12,14,4,0,2,106,134,101,101,2,4,0,30153026.25
OLLI.JOKINEN,20102011,CGY,1404.3833333333334,17,17,20,37,54,34,552,1164,612,206,367,56,82,25,17,1480,1136,949,970,37,45,0.4742268041237113,30153157.630000003
OSCAR.MOLLER,20102011,L.A,200.33333333333334,1,2,1,3,4,3,7,14,7,27,55,10,18,3,1,198,151,139,143,6,6,0.5,30153031.085
OSKARS.BARTULIS,20102011,PHI,169.31666666666666,0,0,0,0,0,0,0,0,0,7,18,8,8,3,2,137,189,134,185,3,7,0,30153036.58
P.A..PARENTEAU,20102011,NYI,1476,20,18,15,33,53,38,11,30,19,162,264,118,59,26,23,1656,1276,1111,1161,50,53,0.36666666666666664,30153156.425
P.K..SUBBAN,20102011,MTL,1914.5833333333335,16,10,14,24,40,26,0,0,0,213,421,121,125,39,49,2011,1677,1410,1233,46,50,0,30153141.439999998
PASCAL.DUPUIS,20102011,PIT,1481.9,18,13,7,20,38,31,9,34,25,187,312,137,58,15,24,1284,1494,1125,1115,49,39,0.2647058823529412,30153145.985
PATRIC.HORNQVIST,20102011,NSH,1425.5166666666667,23,18,9,27,50,41,22,47,25,308,458,101,68,30,22,1527,1023,1061,969,47,36,0.46808510638297873,30153138.255
PATRICE.BERGERON,20102011,BOS,1861.2833333333333,28,31,18,49,77,59,1114,1936,822,278,475,93,111,16,27,1992,1695,1400,1214,71,43,0.5754132231404959,30153187.37
PATRICE.CORMIER,20102011,ATL,202.53333333333333,1,1,0,1,2,2,39,67,28,27,38,31,1,7,2,165,210,157,203,3,6,0.582089552238806,30153042.48
PATRICK.DWYER,20102011,CAR,1011.9833333333333,8,5,5,10,18,13,80,237,157,103,181,165,41,13,6,801,1182,738,851,24,31,0.33755274261603374,30153119.455
PATRICK.EAVES,20102011,DET,925.4666666666667,16,7,1,8,24,23,7,22,15,126,242,122,59,14,10,828,974,753,655,28,30,0.3181818181818182,30153087.795
PATRICK.KALETA,20102011,BUF,585.3833333333333,5,5,2,7,12,10,6,14,8,73,104,147,19,34,26,485,558,463,489,17,21,0.42857142857142855,30153075.93
PATRICK.KANE,20102011,CHI,1560.6666666666665,28,27,24,51,79,55,2,14,12,238,410,20,95,24,15,1766,1111,1224,990,63,48,0.14285714285714285,30153131.32
PATRICK.MARLEAU,20102011,S.J,2107.116666666667,44,21,21,42,86,65,329,637,308,338,575,114,126,17,11,2436,1863,1466,1316,65,67,0.5164835164835165,30153186.705
PATRICK.O'SULLIVAN,20102011,CAR,88.6,1,0,0,0,1,1,3,11,8,13,25,4,5,0,2,80,90,65,82,2,3,0.2727272727272727,30153026.52
PATRICK.O'SULLIVAN,20102011,MIN,289.2,1,5,1,6,7,6,17,40,23,37,63,11,9,2,1,271,254,202,238,8,8,0.425,30153046.075000003
PATRICK.RISSMILLER,20102011,ATL,13.116666666666667,0,0,0,0,0,0,1,3,2,2,2,2,0,1,0,12,12,12,11,0,1,0.3333333333333333,15076509.5
PATRICK.RISSMILLER,20102011,FLA,90.53333333333333,0,1,0,1,1,1,1,1,0,12,22,15,3,0,0,83,62,83,62,2,2,1,30153022.04
PATRICK.SHARP,20102011,CHI,1568.9666666666667,37,19,20,39,76,56,278,564,286,299,521,93,111,16,19,1685,1237,1118,965,50,45,0.4929078014184397,30153148.53
PATRICK.WIERCIOCH,20102011,OTT,111.21666666666667,0,0,2,2,2,0,0,0,0,3,15,4,5,1,2,99,85,86,83,8,8,0,30153023.310000002
PATRIK.BERGLUND,20102011,STL,1392.4333333333334,22,18,11,29,51,40,450,974,524,175,314,116,67,15,12,1521,1012,1069,877,45,47,0.4620123203285421,30153136.325
PATRIK.ELIAS,20102011,N.J,1509.7166666666667,21,21,20,41,62,42,224,498,274,204,349,62,87,13,7,1436,975,927,685,43,44,0.4497991967871486,30153103.99
PAUL.BISSONNETTE,20102011,ARI,256.31666666666666,1,0,0,0,1,1,2,4,2,19,40,127,15,20,16,205,209,199,205,8,2,0.5,30153038.18
PAUL.BYRON,20102011,BUF,87.63333333333333,1,0,1,1,2,1,29,71,42,5,7,18,0,4,1,85,82,82,77,3,4,0.4084507042253521,30153026.525
PAUL.GAUSTAD,20102011,BUF,1361.0833333333335,12,12,9,21,33,24,764,1290,526,131,213,137,41,31,42,1123,1328,951,947,36,33,0.5922480620155038,30153146.945
PAUL.MARA,20102011,ANA,665.7166666666667,1,0,1,1,2,1,0,0,0,33,67,60,16,5,17,449,778,372,585,16,18,0,30153085.875
PAUL.MARA,20102011,MTL,316.26666666666665,0,1,3,4,4,1,0,0,0,15,28,31,4,7,12,233,364,206,259,9,9,0,30153046.494999997
PAUL.MARTIN,20102011,PIT,1972.1333333333332,3,8,14,22,25,11,0,0,0,114,235,50,77,7,9,1932,1570,1380,1128,53,46,0,30153111.87
PAUL.POSTMA,20102011,ATL,9.916666666666666,0,0,0,0,0,0,0,0,0,1,1,1,0,0,0,9,14,8,14,0,0,0,15076510
PAUL.STASTNY,20102011,COL,1460.4833333333331,22,22,13,35,57,44,810,1523,713,181,279,74,47,18,27,1385,1331,911,1042,46,46,0.5318450426789232,30153182.605
PAVEL.DATSYUK,20102011,DET,1314.75,27,30,17,47,74,57,508,928,420,174,321,81,79,23,10,1525,949,1021,792,57,38,0.5474137931034483,30153126.875
PAVEL.KUBINA,20102011,T.B,1641.1666666666667,6,8,10,18,24,14,0,0,0,85,212,114,80,12,35,1632,1394,1275,1172,53,46,0,30153127.57
PETER.FORSBERG,20102011,COL,35.166666666666664,0,0,0,0,0,0,0,0,0,3,7,3,2,0,2,27,38,23,32,0,2,0,15076512.05
PETER.HARROLD,20102011,L.A,232.88333333333333,1,2,1,3,4,3,0,0,0,12,30,5,9,0,2,237,168,209,154,9,5,0,30153029.225
PETER.REGIN,20102011,OTT,736.1666666666667,3,7,7,14,17,10,132,316,184,87,157,30,35,11,5,742,586,628,546,25,29,0.4177215189873418,30153077.565
PETER.SCHAEFER,20102011,VAN,154.81666666666666,1,1,0,1,2,2,13,33,20,10,22,18,8,2,1,104,184,92,127,4,7,0.3939393939393939,30153031.939999998
PETR.PRUCHA,20102011,ARI,126.05000000000001,0,1,0,1,1,1,3,5,2,10,19,13,4,0,2,96,115,93,101,2,3,0.6,30153027.52
PHIL.KESSEL,20102011,TOR,1610.95,32,23,9,32,64,55,24,59,35,325,571,11,137,23,14,1775,1508,1182,1352,47,61,0.4067796610169492,30153188.415
PHILIP.LARSEN,20102011,DAL,80.6,0,0,2,2,2,0,0,0,0,11,18,1,1,3,0,96,56,51,47,6,3,0,30153020.68
PHILIP.MCRAE,20102011,STL,135.55,1,1,0,1,2,2,34,64,30,13,25,8,8,2,1,106,148,99,148,2,12,0.53125,30153035.48
PHILIPPE.DUPUIS,20102011,COL,674.3666666666667,6,7,4,11,17,13,153,331,178,101,155,128,22,15,12,483,710,437,517,20,26,0.4622356495468278,30153088.619999997
PIERRE-LUC.LETOURNEAU-LEBLOND,20102011,N.J,6.916666666666667,0,0,0,0,0,0,0,0,0,0,0,3,0,1,5,2,5,2,4,0,2,0,30153017.759999998
PIERRE-MARC.BOUCHARD,20102011,MIN,927.0999999999999,12,10,15,25,37,22,17,43,26,98,172,15,39,10,7,970,759,662,690,32,34,0.3953488372093023,30153098.455
RADEK.DVORAK,20102011,ATL,183.71666666666664,0,1,0,1,1,1,5,9,4,20,32,5,5,3,2,159,158,143,123,3,4,0.5555555555555556,30153028.630000003
RADEK.DVORAK,20102011,FLA,877.3666666666667,7,8,6,14,21,15,2,10,8,89,135,46,23,13,10,673,924,629,689,24,23,0.2,30153097.560000002
RADEK.MARTINEK,20102011,NYI,1334.1166666666668,3,7,5,12,15,10,0,0,0,96,208,69,64,10,16,1093,1466,942,1116,38,46,0,30153135.125
RADIM.VRBATA,20102011,ARI,1372.7166666666667,21,19,13,32,53,40,2,8,6,253,404,44,71,8,10,1500,1092,973,960,40,37,0.25,30153135.835
RAFFI.TORRES,20102011,VAN,1271.65,17,8,11,19,36,25,16,46,30,135,218,188,32,14,35,1144,1143,1031,1107,42,36,0.34782608695652173,30153150.505000003
RAITIS.IVANANS,20102011,CGY,8.333333333333334,0,0,0,0,0,0,0,0,0,0,1,1,0,1,1,10,7,10,7,0,1,0,15076508.96
RANDY.JONES,20102011,T.B,1075.4,1,6,7,13,14,7,0,0,0,53,131,45,46,9,7,968,1108,883,747,35,42,0,30153080.565
RAY.MACIAS,20102011,COL,30.2,0,0,0,0,0,0,0,0,0,0,4,1,1,0,1,24,27,20,24,1,2,0,30153018.950000003
RAY.WHITNEY,20102011,ARI,1349.25,18,28,14,42,60,46,47,102,55,167,301,32,65,15,13,1550,1013,999,906,43,40,0.46078431372549017,30153128.03
RAYMOND.SAWADA,20102011,DAL,5.833333333333333,0,0,0,0,0,0,0,0,0,1,1,2,0,0,0,4,3,4,3,0,1,0,15076508.55
RENE.BOURQUE,20102011,CGY,1420.2833333333333,27,14,9,23,50,41,7,24,17,218,382,90,74,10,21,1375,1244,902,965,36,40,0.2916666666666667,30153141.855
RHETT.RAKHSHANI,20102011,NYI,23.416666666666664,0,0,0,0,0,0,0,0,0,2,3,0,0,0,0,19,24,19,24,0,1,0,30153019.25
RICH.PEVERLEY,20102011,ATL,1134.15,14,13,7,20,34,27,565,1019,454,161,256,27,47,16,17,1202,1162,789,884,24,38,0.5544651619234544,30153144.285
RICH.PEVERLEY,20102011,BOS,767.55,8,4,7,11,19,12,182,326,144,82,148,20,32,9,8,698,743,558,559,20,16,0.558282208588957,30153083.744999997
RICHARD.PETIOT,20102011,EDM,26.166666666666668,0,0,0,0,0,0,0,0,0,1,2,3,1,1,2,19,33,18,31,1,0,0,15076512.06
RICK.NASH,20102011,CBJ,1419.5,32,19,15,34,66,51,7,24,17,305,547,91,124,30,17,1651,1115,1020,955,51,45,0.2916666666666667,30153135.355
RICK.RYPIEN,20102011,VAN,46.083333333333336,0,0,1,1,1,0,9,14,5,6,8,13,1,5,7,19,57,19,55,1,5,0.6428571428571429,30153025.134999998
RJ.UMBERGER,20102011,CBJ,1575.5,25,19,12,31,56,44,111,220,109,220,362,114,64,24,14,1570,1357,975,922,44,40,0.5045454545454545,30153136.380000003
ROB.KLINKHAMMER,20102011,CHI,11.6,0,0,0,0,0,0,0,0,0,1,3,3,1,0,0,7,11,7,11,1,0,0,15076509.3
ROB.NIEDERMAYER,20102011,BUF,1004.6166666666667,6,11,5,16,22,17,158,335,177,88,135,41,25,7,12,790,1031,739,877,32,41,0.4716417910447761,30153126.715
ROB.SCHREMP,20102011,ATL,207.55,3,0,1,1,4,3,43,107,64,19,31,6,6,3,2,193,133,160,128,4,4,0.40186915887850466,30153032.424999997
ROB.SCHREMP,20102011,NYI,677.0333333333333,10,7,5,12,22,17,181,379,198,63,119,28,27,11,6,604,631,454,589,17,35,0.47757255936675463,30153099.025
ROB.SCUDERI,20102011,L.A,1788.6833333333334,2,8,4,12,14,10,0,0,0,49,129,69,48,6,8,1381,1874,1295,1382,53,52,0,30153153.71
ROBBIE.EARL,20102011,MIN,52.583333333333336,0,0,0,0,0,0,0,2,2,6,10,8,2,0,0,27,53,27,53,0,3,0,30153023.2
ROBYN.REGEHR,20102011,CGY,1697.1833333333334,2,5,7,12,14,7,0,0,0,72,174,180,59,14,26,1269,1748,1118,1176,55,56,0,30153132.215
ROD.PELLEY,20102011,N.J,873.8,3,3,4,7,10,6,169,319,150,88,149,113,28,9,9,582,809,543,635,13,23,0.5297805642633229,30153094.15
ROMAN.HAMRLIK,20102011,MTL,1923.4333333333334,5,14,18,32,37,19,0,0,0,133,295,75,93,7,39,1978,1905,1479,1495,54,51,0,30153169.87
ROMAN.POLAK,20102011,STL,1097.6166666666668,3,0,7,7,10,3,0,1,1,53,110,110,33,4,15,896,1094,842,857,38,41,0,30153099.915
ROMAN.WICK,20102011,OTT,60.38333333333333,0,0,0,0,0,0,1,3,2,4,15,2,5,1,0,47,64,47,64,0,4,0.3333333333333333,30153023.299999997
RON.HAINSEY,20102011,ATL,1482.9666666666667,3,6,9,15,18,9,0,0,0,83,184,51,57,5,13,1244,1506,1090,1193,47,46,0,30153137.575000003
ROSTISLAV.KLESLA,20102011,ARI,365.20000000000005,1,0,0,0,1,1,0,0,0,29,64,32,17,4,8,283,403,260,295,6,13,0,30153047.69
ROSTISLAV.KLESLA,20102011,CBJ,869.1666666666667,3,4,3,7,10,7,1,1,0,45,92,41,26,5,14,612,999,555,676,32,27,1,30153090.365000002
ROSTISLAV.OLESZ,20102011,FLA,610.6666666666667,6,6,5,11,17,12,2,10,8,71,121,68,30,5,4,587,561,501,453,22,22,0.2,30153064.055
RUSLAN.FEDOTENKO,20102011,NYR,1093.8833333333332,10,13,4,17,27,23,13,33,20,125,230,173,57,14,13,914,1079,780,883,32,31,0.3939393939393939,30153120.259999998
RUSLAN.SALEI,20102011,DET,1530.8,3,2,6,8,11,5,0,0,0,92,198,128,60,7,25,1405,1476,1308,1165,50,47,0,30153121.42
RYAN.CALLAHAN,20102011,NYR,1193.0166666666667,23,15,10,25,48,38,2,17,15,178,298,224,50,35,20,1138,1110,713,738,35,39,0.11764705882352941,30153116.880000003
RYAN.CARTER,20102011,ANA,193.33333333333331,1,0,2,2,3,1,86,171,85,23,37,29,6,8,8,169,167,161,137,3,7,0.5029239766081871,30153034.32
RYAN.CARTER,20102011,CAR,265.85,0,2,1,3,3,2,105,208,103,26,46,66,11,7,8,223,342,213,246,5,6,0.5048076923076923,30153048.195
RYAN.CARTER,20102011,FLA,162.01666666666665,2,1,0,1,3,3,51,99,48,14,30,38,6,4,7,105,147,98,101,4,2,0.5151515151515151,30153030.880000003
RYAN.CRAIG,20102011,PIT,58.93333333333333,0,0,0,0,0,0,3,5,2,7,9,6,1,4,4,50,57,40,44,0,2,0.6,30153022.009999998
RYAN.GETZLAF,20102011,ANA,1608.3000000000002,21,29,32,61,82,50,611,1329,718,134,259,207,58,18,18,1649,1347,1023,1119,59,48,0.4597441685477803,30153188.07
RYAN.HOLLWEG,20102011,ARI,19.5,0,0,0,0,0,0,0,0,0,0,0,8,0,0,0,12,23,12,23,0,1,0,15076511.1
RYAN.JOHNSON,20102011,CHI,411.48333333333335,1,1,5,6,7,2,213,341,128,27,40,35,7,4,5,296,434,284,316,11,15,0.624633431085044,30153055.035
RYAN.JONES,20102011,EDM,1120.8,18,3,3,6,24,21,10,29,19,126,229,152,62,17,14,787,1190,607,849,24,31,0.3448275862068966,30153124.494999997
RYAN.KESLER,20102011,VAN,2243.916666666667,48,28,16,44,92,76,1186,2101,915,336,643,201,160,51,41,2653,1876,1624,1238,61,45,0.5644930985245121,30153195.4
RYAN.MALONE,20102011,T.B,1145.9833333333333,17,11,16,27,44,28,65,166,101,183,265,168,38,25,31,1269,928,820,767,37,36,0.39156626506024095,30153116.9
RYAN.MCDONAGH,20102011,NYR,861.5,1,5,3,8,9,6,0,0,0,31,81,69,34,5,9,743,811,684,679,37,24,0,30153080.125
RYAN.O'BYRNE,20102011,COL,1305.7833333333333,0,2,7,9,9,2,0,0,0,42,120,167,51,5,33,998,1400,933,1054,36,43,0,30153123.625
RYAN.O'BYRNE,20102011,MTL,44.733333333333334,0,0,0,0,0,0,0,0,0,3,5,11,0,0,2,36,53,32,42,1,1,0,30153021.5
RYAN.O'MARRA,20102011,EDM,231.38333333333333,1,4,0,4,5,5,75,178,103,13,19,41,3,3,5,145,237,132,217,5,7,0.42134831460674155,30153049.98
RYAN.O'REILLY,20102011,COL,1188.2333333333333,13,9,4,13,26,22,531,1023,492,119,181,53,33,11,8,999,1145,820,801,27,35,0.5190615835777126,30153127.549999997
RYAN.PARENT,20102011,VAN,55.56666666666666,0,0,0,0,0,0,0,0,0,3,8,4,3,1,0,52,51,50,46,0,3,0,30153020.61
RYAN.POTULNY,20102011,CHI,30.366666666666667,0,0,0,0,0,0,10,26,16,2,4,3,1,0,0,21,23,16,21,0,1,0.38461538461538464,15076511.25
RYAN.POTULNY,20102011,OTT,48.61666666666667,0,0,0,0,0,0,0,0,0,5,8,2,2,0,0,31,36,31,35,2,2,0,30153019.85
RYAN.REAVES,20102011,STL,190.55,2,2,0,2,4,4,0,2,2,16,23,86,5,12,18,136,182,133,179,6,7,0,30153041.270000003
RYAN.SHANNON,20102011,OTT,1021.3833333333332,11,8,8,16,27,19,87,207,120,118,187,34,33,11,12,944,833,750,629,25,22,0.42028985507246375,30153090.29
RYAN.SMYTH,20102011,L.A,1589.1999999999998,25,12,15,27,52,37,62,139,77,209,330,29,41,20,18,1760,1176,1223,1038,50,44,0.4460431654676259,30153139.205
RYAN.STOA,20102011,COL,333.54999999999995,2,1,1,2,4,3,2,5,3,45,68,30,10,4,6,336,302,257,285,8,13,0.4,30153049.045
RYAN.SUTER,20102011,NSH,2107.85,5,21,19,40,45,26,0,1,1,137,317,85,124,9,30,1979,1727,1389,1313,60,44,0,30153144.365000002
RYAN.WHITE,20102011,MTL,286.98333333333335,2,2,1,3,5,4,25,55,30,33,50,94,13,10,11,258,263,249,257,13,8,0.45454545454545453,30153045.925
RYAN.WHITNEY,20102011,EDM,886.8333333333333,2,11,13,24,26,13,0,0,0,43,90,29,30,5,12,762,882,469,593,29,18,0,30153085.575
RYAN.WILSON,20102011,COL,1327,3,7,5,12,15,10,0,0,0,62,136,135,45,18,25,1000,1352,850,1014,41,51,0,30153126.555
RYANE.CLOWE,20102011,S.J,1677.7833333333333,30,31,16,47,77,61,18,44,26,224,357,195,76,42,43,2087,1365,1516,1228,64,47,0.4090909090909091,30153162.34
SAKU.KOIVU,20102011,ANA,1545.1166666666668,16,23,13,36,52,39,757,1435,678,111,203,57,58,12,21,1322,1642,891,1169,46,47,0.5275261324041812,30153191.674999997
SAM.GAGNER,20102011,EDM,1206.9833333333333,15,17,10,27,42,32,410,935,525,138,242,24,51,15,10,1200,1032,832,898,41,56,0.4385026737967914,30153147.1
SAMI.LEPISTO,20102011,ARI,848.5,4,3,3,6,10,7,1,1,0,31,78,49,30,11,18,684,893,648,639,33,25,1,30153079.525
SAMI.LEPISTO,20102011,CBJ,380.3833333333333,0,1,4,5,5,1,0,0,0,24,55,23,21,9,9,386,295,305,264,11,8,0,30153039.54
SAMI.SALO,20102011,VAN,952.8499999999999,6,3,2,5,11,9,0,0,0,72,160,27,49,2,8,888,932,668,648,18,25,0,30153081.07
SAMUEL.PAHLSSON,20102011,CBJ,1257.7166666666667,7,8,5,13,20,15,674,1297,623,108,181,162,40,10,15,807,1286,731,826,20,39,0.5196607555898227,30153136.685
SCOTT.GOMEZ,20102011,MTL,1623.0333333333333,7,23,12,35,42,30,622,1314,692,178,310,38,71,20,20,1851,1473,1348,1200,33,49,0.4733637747336377,30153172.43
SCOTT.HANNAN,20102011,COL,428.51666666666665,0,4,1,5,5,4,0,0,0,21,38,26,10,0,3,310,450,278,317,15,17,0,30153050.175
SCOTT.HANNAN,20102011,WSH,1327.3833333333332,1,2,3,5,6,3,0,0,0,41,88,73,32,6,15,1155,1292,1061,957,39,31,0,30153102.735
SCOTT.HARTNELL,20102011,PHI,1540.1,25,17,11,28,53,42,6,11,5,194,320,199,53,36,54,1631,1325,1183,1240,68,54,0.5454545454545454,30153171.225
SCOTT.NICHOL,20102011,S.J,641.2666666666667,4,2,1,3,7,6,340,585,245,69,99,145,14,19,24,389,692,365,488,13,23,0.5811965811965812,30153087.465
SCOTT.PARSE,20102011,L.A,86.51666666666668,1,1,2,3,4,2,0,0,0,6,14,5,3,0,0,91,92,77,90,7,2,0,30153026.35
SCOTT.TIMMINS,20102011,FLA,205.53333333333333,1,0,0,0,1,1,61,130,69,13,31,18,9,0,4,155,207,153,140,1,9,0.46923076923076923,30153033.14
SCOTTIE.UPSHALL,20102011,ARI,820.25,16,5,6,11,27,21,4,19,15,144,261,84,51,15,16,897,653,774,614,30,23,0.21052631578947367,30153082.61
SCOTTIE.UPSHALL,20102011,CBJ,330.98333333333335,6,1,0,1,7,7,4,6,2,47,86,24,23,6,4,327,269,247,224,9,16,0.6666666666666666,30153040.77
SEAN.AVERY,20102011,NYR,903.05,3,12,10,22,25,15,16,25,9,144,239,120,42,38,46,841,818,801,793,27,31,0.64,30153109.270000003
SEAN.BERGENHEIM,20102011,T.B,1344.9,23,9,8,17,40,32,34,70,36,228,371,141,69,29,31,1304,1182,1128,910,45,43,0.4857142857142857,30153118.95
SEAN.COLLINS,20102011,WSH,65.13333333333333,1,0,0,0,1,1,0,0,0,4,7,2,1,1,0,72,58,70,53,4,1,0,30153021.11
SEAN.O'DONNELL,20102011,PHI,1398.3333333333335,1,5,12,17,18,6,0,0,0,38,104,63,43,13,25,1123,1475,1055,1240,47,48,0,30153146.38
SERGEI.GONCHAR,20102011,OTT,1553.8666666666666,7,9,10,19,26,16,0,0,0,107,260,54,97,9,10,1497,1308,970,986,33,46,0,30153113.939999998
SERGEI.KOSTITSYN,20102011,NSH,1389.5,23,12,20,32,55,35,1,7,6,102,211,49,66,15,13,1317,1136,966,1015,51,38,0.14285714285714285,30153134.59
SERGEI.SAMSONOV,20102011,CAR,823.4333333333334,10,10,6,16,26,20,3,6,3,86,150,47,31,4,7,945,717,669,659,26,26,0.5,30153091.81
SERGEI.SAMSONOV,20102011,FLA,384.54999999999995,3,10,1,11,14,13,0,5,5,36,58,9,11,5,1,379,320,262,271,10,9,0,30153050.825
SERGEI.SHIROKOV,20102011,VAN,20.583333333333336,1,0,0,0,1,1,0,0,0,6,9,1,2,1,0,26,13,25,13,1,0,0,30153017.759999998
SHANE.DOAN,20102011,ARI,1475.7833333333333,23,27,14,41,64,50,76,173,97,233,426,196,97,20,31,1658,1184,1089,997,47,43,0.4393063583815029,30153142.59
SHANE.HNIDY,20102011,BOS,53.8,0,0,0,0,0,0,0,0,0,3,9,3,4,1,3,47,56,47,54,0,2,0,30153022.259999998
SHANE.O'BRIEN,20102011,NSH,1570.8166666666666,2,4,3,7,9,6,0,0,0,56,125,206,45,17,42,1163,1588,1074,1137,34,37,0,30153134.595
SHANE.SIMS,20102011,NYI,6.566666666666666,0,0,0,0,0,0,0,0,0,0,1,1,1,0,0,7,6,7,6,0,0,0,15076508.65
SHAONE.MORRISONN,20102011,BUF,1016.1333333333333,1,3,0,3,4,4,0,0,0,44,86,109,20,8,17,755,1072,712,816,28,34,0,30153103.28
SHAWN.BELLE,20102011,COL,72.13333333333333,0,0,0,0,0,0,0,0,0,1,3,5,1,0,1,48,68,46,53,5,4,0,30153021.450000003
SHAWN.BELLE,20102011,EDM,82.18333333333334,0,0,0,0,0,0,0,0,0,7,12,4,4,0,0,62,87,54,80,0,2,0,30153025.55
SHAWN.HORCOFF,20102011,EDM,878.2166666666667,9,14,3,17,26,23,393,813,420,78,141,32,34,12,16,809,826,584,622,22,23,0.4833948339483395,30153109.915
SHAWN.MATTHIAS,20102011,FLA,603.8666666666668,6,7,3,10,16,13,188,370,182,90,135,60,31,8,5,586,558,519,519,23,22,0.5081081081081081,30153081.125
SHAWN.THORNTON,20102011,BOS,921.7,10,7,4,11,21,17,22,38,16,171,271,184,52,31,36,833,900,814,882,27,21,0.5789473684210527,30153122.240000002
SHEA.WEBER,20102011,NSH,2409.4166666666665,19,17,16,33,52,36,0,0,0,291,586,241,148,15,32,2229,1953,1536,1495,67,59,0,30153175.05
SHELDON.BROOKBANK,20102011,ANA,591.3833333333333,0,0,0,0,0,0,0,0,0,31,65,62,22,15,20,416,669,397,458,7,19,0,30153065.7
SIDNEY.CROSBY,20102011,PIT,898.6166666666667,32,20,14,34,66,52,546,981,435,161,278,31,59,23,14,1122,690,644,566,40,24,0.5565749235474006,30153115.47
SIMON.GAGNE,20102011,T.B,1302.0333333333333,22,18,12,30,52,40,9,20,11,175,331,67,84,15,12,1477,1118,978,959,40,42,0.45,30153130.21
SPENCER.MACHACEK,20102011,ATL,76.80000000000001,0,0,0,0,0,0,0,0,0,7,11,22,3,0,0,72,71,72,71,0,2,0,30153023.450000003
STEFAN.DELLA ROVERE,20102011,STL,42.61666666666667,0,0,0,0,0,0,3,4,1,4,8,10,1,1,4,34,40,34,39,0,0,0.75,30153021.33
STEFAN.MEYER,20102011,CGY,124.01666666666668,0,1,1,2,2,1,7,17,10,12,27,23,11,10,4,104,104,102,89,5,4,0.4117647058823529,30153024.705
STEPHANE.DA COSTA,20102011,OTT,45.650000000000006,0,0,0,0,0,0,6,21,15,9,11,3,1,1,0,47,30,43,28,0,1,0.2857142857142857,30153019.55
STEPHANE.ROBIDAS,20102011,DAL,1987.15,5,10,15,25,30,15,0,0,0,106,255,216,89,19,27,1740,1862,1197,1195,57,58,0,30153133.665
STEPHEN.GIONTA,20102011,N.J,108.06666666666666,0,0,0,0,0,0,0,0,0,13,25,16,5,4,3,82,97,77,74,0,3,0,30153024.14
STEPHEN.WEISS,20102011,FLA,1527.5166666666667,21,15,13,28,49,36,688,1278,590,171,281,52,64,11,19,1536,1346,972,973,40,47,0.5383411580594679,30153156.305
STEVE.BEGIN,20102011,NSH,19.616666666666667,0,0,0,0,0,0,0,0,0,2,3,5,0,0,2,10,16,10,15,0,2,0,30153018.65
STEVE.BERNIER,20102011,FLA,886.1166666666667,5,5,5,10,15,10,4,17,13,97,162,112,26,6,9,786,826,617,677,19,31,0.23529411764705882,30153093.945
STEVE.DOWNIE,20102011,T.B,1041.65,12,20,14,34,46,32,54,119,65,110,180,127,34,42,63,1097,823,878,770,52,35,0.453781512605042,30153113.73
STEVE.EMINGER,20102011,NYR,1030.35,2,0,3,3,5,2,0,0,0,23,60,143,20,10,11,792,978,735,812,30,35,0,30153098.575000003
STEVE.MACINTYRE,20102011,EDM,120.20000000000002,0,1,0,1,1,1,0,0,0,6,10,23,2,10,24,65,127,65,125,2,3,0,30153035.95
STEVE.MONTADOR,20102011,BUF,1534.3166666666666,5,13,8,21,26,18,0,1,1,121,230,93,70,19,37,1382,1634,1235,1272,58,47,0,30153149.439999998
STEVE.OTT,20102011,DAL,1405.3166666666666,12,16,4,20,32,28,643,1134,491,119,213,252,40,42,51,1222,1404,828,971,31,33,0.5670194003527337,30153159.740000002
STEVE.REINPRECHT,20102011,FLA,182.93333333333334,1,4,0,4,5,5,52,92,40,16,26,11,5,2,0,144,171,136,141,6,7,0.5652173913043478,30153034.4
STEVE.STAIOS,20102011,CGY,574,3,4,3,7,10,7,1,1,0,23,55,42,21,10,10,524,516,492,462,27,19,1,30153061.265
STEVE.SULLIVAN,20102011,NSH,789.8833333333333,12,4,9,13,25,16,5,14,9,86,145,21,30,7,15,795,615,530,539,24,22,0.35714285714285715,30153081.045
STEVEN.KAMPFER,20102011,BOS,673.8333333333334,5,2,3,5,10,7,0,0,0,57,130,41,50,6,7,752,569,631,509,31,21,0,30153057.935000002
STEVEN.REINPRECHT,20102011,FLA,158.31666666666666,3,2,0,2,5,5,37,79,42,15,23,9,5,2,3,169,148,154,140,7,7,0.46835443037974683,30153034.15
STEVEN.STAMKOS,20102011,T.B,2010.4666666666667,51,25,27,52,103,76,526,1114,588,317,625,104,146,52,36,2280,1661,1396,1375,74,55,0.47217235188509876,30153217.335
T.J..OSHIE,20102011,STL,940.25,12,17,5,22,34,29,100,227,127,103,195,71,46,23,6,959,766,658,552,31,22,0.44052863436123346,30153084.605
TANNER.GLASS,20102011,VAN,800.7333333333333,3,7,0,7,10,10,36,86,50,52,99,162,22,22,24,501,847,471,724,14,25,0.4186046511627907,30153110.659999996
TAYLOR.CHORNEY,20102011,EDM,191.8,1,0,3,3,4,1,0,0,0,13,33,13,15,1,2,175,199,134,172,4,8,0,30153034.634999998
TAYLOR.HALL,20102011,EDM,1183.6333333333332,22,9,10,19,41,31,42,105,63,186,363,48,101,40,13,1212,1041,897,937,37,44,0.4,30153126.98
TAYLOR.PYATT,20102011,ARI,1238.15,19,8,5,13,32,27,7,21,14,136,228,154,36,10,11,1093,1282,939,1059,41,35,0.3333333333333333,30153144.105
TEDDY.PURCELL,20102011,T.B,1388.9333333333334,23,24,21,45,68,47,14,48,34,242,390,26,86,9,9,1615,1137,1149,1024,54,38,0.2916666666666667,30153137.625
TEEMU.HARTIKAINEN,20102011,EDM,208.9,3,1,1,2,5,4,6,18,12,21,37,19,7,8,2,207,154,142,142,3,6,0.3333333333333333,30153033.895
TEEMU.LAAKSO,20102011,NSH,2.716666666666667,0,0,0,0,0,0,0,0,0,0,1,1,1,0,0,3,2,3,2,0,0,0,15076508.25
TEEMU.SELANNE,20102011,ANA,1423.3666666666668,37,31,19,50,87,68,107,240,133,238,358,15,49,13,17,1449,1173,846,1040,47,44,0.44583333333333336,30153180.335
THEO.PECKHAM,20102011,EDM,1320.25,3,4,6,10,13,7,0,0,0,41,111,196,47,25,51,957,1449,869,1098,35,48,0,30153140.15
THOMAS.VANEK,20102011,BUF,1507.85,37,23,18,41,78,60,8,27,19,257,418,35,64,28,13,1811,1245,1136,1096,56,49,0.2962962962962963,30153161.95
TIM.BRENT,20102011,TOR,920.45,8,7,5,12,20,15,409,787,378,60,111,104,23,14,15,683,1057,530,726,17,24,0.5196950444726811,30153122.924999997
TIM.CONNOLLY,20102011,BUF,1263.8000000000002,13,13,17,30,43,26,508,1090,582,163,292,28,77,13,10,1326,1137,859,751,34,37,0.46605504587155966,30153120.875
TIM.GLEASON,20102011,CAR,1725.7,2,6,7,13,15,8,0,0,0,84,227,215,90,15,20,1529,2031,1272,1461,47,52,0,30153164.075
TIM.JACKMAN,20102011,CGY,805.5666666666667,10,10,3,13,23,20,6,16,10,130,224,133,50,26,25,861,583,744,547,26,21,0.375,30153073.625
TIM.KENNEDY,20102011,FLA,62.28333333333333,0,0,1,1,1,0,12,30,18,2,3,16,0,0,0,42,60,40,58,1,1,0.4,30153024.005
TIM.SESTITO,20102011,N.J,389.5333333333333,0,2,0,2,2,2,116,253,137,22,44,79,12,8,3,257,334,250,293,4,9,0.45849802371541504,30153053.97
TIM.STAPLETON,20102011,ATL,499.8666666666667,5,0,1,1,6,5,109,225,116,44,77,18,13,5,7,461,432,427,402,8,16,0.48444444444444446,30153063.884999998
TIM.WALLACE,20102011,PIT,56.35,0,0,0,0,0,0,3,3,0,1,4,21,2,1,1,43,55,43,55,0,3,1,30153022.48
TJ.BRODIE,20102011,CGY,48.016666666666666,0,0,0,0,0,0,0,0,0,1,4,2,3,0,1,56,37,38,34,0,2,0,30153019.45
TJ.GALIARDI,20102011,COL,566.8166666666666,7,4,4,8,15,11,62,134,72,62,110,41,24,15,4,445,561,399,402,17,20,0.4626865671641791,30153064.93
TJ.HENSICK,20102011,STL,118.08333333333334,1,2,0,2,3,3,11,29,18,12,22,1,4,0,1,119,102,111,100,6,11,0.3793103448275862,30153027.79
TOBIAS.ENSTROM,20102011,ATL,1705.3666666666668,10,21,19,40,50,31,0,0,0,113,247,30,89,13,25,1882,1456,1219,1194,51,53,0,30153143.155
TOBY.PETERSEN,20102011,DAL,602.3666666666667,2,3,1,4,6,5,45,119,74,58,89,56,14,5,4,379,614,354,423,8,17,0.37815126050420167,30153068.875
TODD.BERTUZZI,20102011,DET,1443.35,18,14,18,32,50,32,18,40,22,161,281,130,53,19,32,1487,1252,1171,1166,55,57,0.45,30153152.26
TODD.MARCHANT,20102011,ANA,1136.2333333333333,1,6,1,7,8,7,288,599,311,67,120,122,24,10,15,574,1426,510,794,9,32,0.48080133555926546,30153127.595
TODD.WHITE,20102011,NYR,138.21666666666667,1,1,0,1,2,2,30,56,26,11,19,1,4,1,1,91,154,81,138,2,5,0.5357142857142857,30153035.21
TOM.GILBERT,20102011,EDM,1935.35,6,6,13,19,25,12,0,0,0,107,220,69,64,5,15,1623,1869,1166,1252,48,67,0,30153145.325
TOM.KOSTOPOULOS,20102011,CAR,183.48333333333335,1,1,2,3,4,2,4,14,10,13,24,34,6,6,8,164,223,145,164,6,6,0.2857142857142857,30153035.82
TOM.KOSTOPOULOS,20102011,CGY,745.85,7,5,2,7,14,12,14,53,39,66,124,85,31,14,16,660,725,596,522,22,25,0.2641509433962264,30153072.5
TOM.POTI,20102011,WSH,385.58333333333337,2,4,1,5,7,6,0,0,0,20,40,7,15,1,4,354,368,272,278,12,13,0,30153045.835
TOM.PYATT,20102011,MTL,718.4000000000001,2,1,4,5,7,3,57,114,57,72,135,41,35,7,3,533,746,494,528,11,14,0.5,30153072.75
TOM.SESTITO,20102011,CBJ,85.75,2,2,0,2,4,4,1,1,0,7,18,31,3,8,9,76,73,59,68,2,6,1,30153027.270000003
TOM.WANDELL,20102011,DAL,881.6666666666667,7,1,1,2,9,8,190,435,245,94,197,65,53,20,7,691,758,648,636,14,20,0.4367816091954023,30153091.275
TOMAS.FLEISCHMANN,20102011,COL,406.4333333333333,8,13,0,13,21,21,2,11,9,54,99,6,31,5,4,390,383,282,349,15,17,0.18181818181818182,30153064.380000003
TOMAS.FLEISCHMANN,20102011,WSH,328.6666666666667,4,3,3,6,10,7,94,222,128,43,67,9,14,4,4,347,291,243,236,10,8,0.42342342342342343,30153049.075
TOMAS.HOLMSTROM,20102011,DET,1239.6666666666665,21,11,12,23,44,32,1,1,0,149,234,93,30,29,29,1523,842,1009,791,41,37,1,30153107.78
TOMAS.KABERLE,20102011,BOS,910.7,1,5,14,19,20,6,0,0,0,64,150,13,48,5,3,987,754,639,651,32,18,0,30153078.4
TOMAS.KABERLE,20102011,TOR,1303.15,3,19,15,34,37,22,0,0,0,99,217,28,74,2,8,1486,1095,981,965,40,34,0,30153114.945
TOMAS.KOPECKY,20102011,CHI,1243.6166666666668,15,20,7,27,42,35,121,285,164,179,297,78,68,19,31,1307,919,932,797,38,44,0.4245614035087719,30153116.355
TOMAS.KUBALIK,20102011,CBJ,59,0,1,1,2,2,1,1,1,0,5,6,14,1,0,0,63,48,36,43,2,4,1,30153021.564999998
TOMAS.PLEKANEC,20102011,MTL,1722.5,24,22,16,38,62,46,855,1733,878,251,434,63,99,29,29,1748,1673,1151,1112,50,41,0.4933641084824005,30153186.04
TOMAS.TATAR,20102011,DET,86.41666666666667,1,0,0,0,1,1,0,0,0,6,17,7,6,1,0,95,65,92,65,3,2,0,30153021.310000002
TOMAS.VINCOUR,20102011,DAL,226.25,1,0,1,1,2,1,3,4,1,26,52,36,13,4,3,227,194,221,189,3,9,0.75,30153033.985
TOMMY.WINGELS,20102011,S.J,25.55,0,0,0,0,0,0,1,3,2,1,2,6,0,1,0,7,26,7,26,0,1,0.3333333333333333,15076511.95
TONI.LYDMAN,20102011,ANA,1850.2333333333333,3,13,8,21,24,16,0,0,0,104,208,150,54,6,22,1370,2027,1184,1299,71,48,0,30153151.81
TORREY.MITCHELL,20102011,S.J,1151.5333333333333,10,7,11,18,28,17,119,234,115,149,253,91,50,21,23,1131,972,1071,805,33,25,0.5085470085470085,30153098.595
TRAVIS.HAMONIC,20102011,NYI,1337.5,5,12,7,19,24,17,0,0,0,117,260,117,93,18,30,1216,1325,937,1003,42,44,0,30153121.005000003
TRAVIS.MOEN,20102011,MTL,1157.9,6,8,3,11,17,14,10,24,14,112,156,143,25,27,23,830,1281,767,921,26,33,0.4166666666666667,30153127.395
TRAVIS.MORIN,20102011,DAL,26.6,0,0,0,0,0,0,8,14,6,2,3,1,0,0,0,18,17,18,17,0,0,0.5714285714285714,30153018.47
TRAVIS.ZAJAC,20102011,N.J,1622.1999999999998,13,16,15,31,44,29,707,1278,571,172,289,55,71,11,8,1513,1223,1024,907,41,47,0.55320813771518,30153134.965
TRENT.HUNTER,20102011,NYI,215.23333333333335,1,1,2,3,4,2,0,2,2,30,68,36,18,0,6,225,205,187,194,4,9,0,30153036.85
TREVOR.DALEY,20102011,DAL,1843.7833333333333,8,6,13,19,27,14,0,0,0,131,293,32,83,11,17,1650,1823,1275,1429,54,51,0,30153165.635
TREVOR.GILLIES,20102011,NYI,119.68333333333334,2,0,0,0,2,2,0,1,1,9,17,44,4,15,27,73,173,69,169,5,8,0,30153043.15
TREVOR.LEWIS,20102011,L.A,927.0666666666666,4,5,7,12,16,9,173,440,267,116,201,118,28,13,4,647,863,587,616,18,24,0.3931818181818182,30153096.875
TROY.BODIE,20102011,ANA,87.48333333333333,0,0,1,1,1,0,0,0,0,5,8,18,1,3,2,57,98,55,72,1,4,0,30153024.905
TROY.BODIE,20102011,CAR,315.48333333333335,1,2,0,2,3,3,0,1,1,39,75,68,25,14,12,324,343,321,332,6,10,0,30153051.34
TROY.BROUWER,20102011,CHI,1294.3666666666668,17,13,6,19,36,30,17,33,16,132,238,284,49,24,17,1331,961,988,815,39,37,0.5151515151515151,30153105.67
TUOMO.RUUTU,20102011,CAR,1369.1333333333332,19,19,18,37,56,38,259,631,372,148,303,306,83,34,25,1518,1209,1055,1061,49,43,0.410459587955626,30153155.700000003
TY.WISHART,20102011,NYI,336.35,1,1,3,4,5,2,0,0,0,23,53,26,18,1,5,315,327,288,272,14,12,0,30153041.485
TYLER.BOZAK,20102011,TOR,1581.0166666666667,15,9,8,17,32,24,786,1439,653,120,202,85,37,20,7,1549,1597,1079,1223,36,60,0.5462126476719944,30153183.14
TYLER.ECKFORD,20102011,N.J,34.86666666666667,0,0,0,0,0,0,0,0,0,1,4,3,2,0,0,27,25,22,24,0,1,0,15076510.5
TYLER.ENNIS,20102011,BUF,1401.65,22,20,11,31,53,42,2,9,7,227,372,49,72,21,17,1441,1191,1036,1081,53,45,0.2222222222222222,30153149.765
TYLER.KENNEDY,20102011,PIT,1285.1,23,17,8,25,48,40,31,66,35,266,451,111,102,17,15,1494,959,1128,868,36,33,0.4696969696969697,30153112.81
TYLER.MYERS,20102011,BUF,1963.7,11,15,14,29,40,26,0,0,0,131,302,127,104,11,27,1917,1776,1347,1198,60,59,0,30153131.96
TYLER.SEGUIN,20102011,BOS,1041.1166666666668,14,12,3,15,29,26,159,326,167,153,244,30,41,10,10,1026,950,863,904,35,30,0.48773006134969327,30153130.185000002
TYLER.SLOAN,20102011,WSH,424.23333333333335,1,1,3,4,5,2,0,0,0,12,32,30,15,5,7,359,437,324,399,10,18,0,30153059.575000003
TYSON.STRACHAN,20102011,STL,352.06666666666666,0,1,0,1,1,1,0,0,0,28,60,23,18,10,8,320,324,302,277,8,18,0,30153042.299999997
VALTTERI.FILPPULA,20102011,DET,1382.5333333333333,18,16,13,29,47,34,546,1070,524,139,271,42,72,25,13,1392,1175,1026,996,50,45,0.5102803738317757,30153148.565
VERNON.FIDDLER,20102011,ARI,1143.4333333333334,6,10,3,13,19,16,680,1268,588,101,169,88,38,29,20,843,1387,759,914,29,29,0.5362776025236593,30153146.465
VICTOR.HEDMAN,20102011,T.B,2060.5666666666666,3,11,18,29,32,14,0,0,0,125,293,76,104,18,39,1873,1833,1576,1393,76,67,0,30153141.43
VICTOR.ORESKOVICH,20102011,VAN,247.13333333333335,0,2,1,3,3,2,1,4,3,33,43,60,3,1,6,179,223,179,221,3,8,0.25,30153043.675
VIKTOR.STALBERG,20102011,CHI,909.8166666666667,13,9,3,12,25,22,5,10,5,145,238,118,35,23,22,943,711,884,696,37,35,0.5,30153091.155
VILLE.LEINO,20102011,PHI,1481.8333333333335,22,18,18,36,58,40,90,170,80,129,221,46,51,23,10,1500,1275,1156,1191,64,50,0.5294117647058824,30153158.03
VINCENT.LECAVALIER,20102011,T.B,1556.4,30,29,13,42,72,59,777,1535,758,265,434,113,86,21,24,1753,1376,1098,1168,56,39,0.5061889250814332,30153200.615000002
VINNY.PROSPAL,20102011,NYR,542.1166666666667,10,6,8,14,24,16,71,134,63,70,107,58,23,5,4,542,432,358,402,16,11,0.5298507462686567,30153070.54
VLADIMIR.SOBOTKA,20102011,STL,1051.55,7,14,7,21,28,21,216,419,203,75,140,137,38,23,22,898,923,775,681,29,33,0.5155131264916468,30153098.244999997
VLADIMIR.ZHARKOV,20102011,N.J,430.58333333333337,2,0,2,2,4,2,2,6,4,40,59,14,5,3,2,355,322,308,287,7,7,0.3333333333333333,30153046.41
WADE.BELAK,20102011,NSH,56.650000000000006,0,0,0,0,0,0,0,0,0,4,5,20,0,3,6,35,61,35,61,0,1,0,30153025.03
WARREN.PETERS,20102011,MIN,95.83333333333334,1,0,0,0,1,1,49,79,30,11,19,24,2,1,2,73,95,72,94,2,4,0.620253164556962,30153028.97
WAYNE.SIMMONDS,20102011,L.A,1164.85,15,7,11,18,33,22,8,23,15,129,247,136,67,26,25,1073,1063,926,1014,39,39,0.34782608695652173,30153132.705
WILLIAM.THOMAS,20102011,FLA,9.816666666666666,0,0,0,0,0,0,0,0,0,1,1,0,0,0,0,5,16,5,16,0,0,0,15076510.45
WILLIE.MITCHELL,20102011,L.A,1389.2333333333333,6,2,4,6,12,8,0,0,0,67,164,43,62,9,11,1116,1394,1010,985,47,44,0,30153108.09
WOJTEK.WOLSKI,20102011,ARI,528.7833333333333,6,6,4,10,16,12,14,24,10,57,90,23,15,6,5,515,437,409,408,18,22,0.5833333333333334,30153064.12
WOJTEK.WOLSKI,20102011,NYR,596.95,7,8,7,15,22,15,1,7,6,88,141,30,28,6,4,626,414,461,363,19,8,0.14285714285714285,30153056.025
YANN.SAUVE,20102011,VAN,65,0,0,0,0,0,0,0,0,0,6,9,9,3,0,0,62,54,61,53,2,4,0,30153020.95
YANNICK.WEBER,20102011,MTL,705.2166666666667,3,3,7,10,13,6,0,0,0,68,169,50,59,4,7,728,625,581,498,19,16,0,30153059.215
ZAC.DALPE,20102011,CAR,115.85,3,0,1,1,4,3,7,25,18,16,28,10,6,1,1,106,149,106,143,6,6,0.28,30153034.815
ZAC.RINALDO,20102011,PHI,5.766666666666667,0,0,0,0,0,0,0,0,0,0,1,5,0,1,2,6,5,6,5,0,1,0,15076509.01
ZACH.BOGOSIAN,20102011,ATL,1590.6666666666665,5,5,6,11,16,10,0,0,0,155,308,111,84,8,14,1398,1551,1063,1219,33,59,0,30153145.28
ZACH.BOYCHUK,20102011,CAR,246.61666666666667,4,1,2,3,7,5,1,5,4,44,63,50,12,5,2,247,267,223,257,8,10,0.2,30153047.14
ZACH.HAMILL,20102011,BOS,31.416666666666664,0,0,1,1,1,0,5,16,11,1,4,0,2,0,0,15,21,15,21,1,0,0.3125,15076510.825
ZACH.PARISE,20102011,N.J,258.15000000000003,3,2,1,3,6,5,4,11,7,49,65,12,7,5,2,280,210,206,181,8,7,0.36363636363636365,30153037.485
ZACK.SMITH,20102011,OTT,693.35,4,2,3,5,9,6,209,388,179,78,134,128,32,16,36,609,628,546,518,14,25,0.538659793814433,30153080.445
ZACK.STORTINI,20102011,EDM,226.98333333333335,0,3,1,4,4,3,14,33,19,16,36,46,11,17,17,165,210,157,209,7,9,0.42424242424242425,30153043.355
ZBYNEK.MICHALEK,20102011,PIT,1785.65,5,9,6,15,20,14,0,0,0,125,274,58,95,10,14,1577,1679,1264,1140,45,48,0,30153120.65
ZDENO.CHARA,20102011,BOS,2723.9333333333334,16,14,21,35,51,30,2,2,0,326,666,209,205,28,40,2850,2504,2076,1814,100,53,1,30153182.085
ZENON.KONOPKA,20102011,NYI,835.5666666666666,2,3,4,7,9,5,620,1072,452,56,76,110,7,45,63,535,1054,458,775,16,31,0.5783582089552238,30153138.85
AARON.GAGNON,20112012,WPG,66.13333333333334,0,0,0,0,0,0,18,40,22,6,12,1,3,0,0,73,59,72,58,0,1,0.45,30168023.869999997
AARON.JOHNSON,20112012,CBJ,924.4,3,6,7,13,16,9,0,0,0,63,118,99,29,10,9,746,860,638,708,29,37,0,30168094.125
AARON.NESS,20112012,NYI,152.43333333333334,0,0,0,0,0,0,0,0,0,6,18,2,5,0,1,120,154,107,148,3,3,0,30168034.1
AARON.PALUSHAJ,20112012,MTL,287.51666666666665,1,1,3,4,5,2,0,4,4,37,70,28,19,9,6,303,238,294,235,8,7,0,30168039.015
AARON.ROME,20112012,VAN,667.4333333333334,4,2,3,5,9,6,0,0,0,42,106,68,36,7,16,593,589,530,528,16,20,0,30168071.595
AARON.VOLPATTI,20112012,VAN,206.2833333333333,1,0,0,0,1,1,4,4,0,17,35,61,12,8,11,152,194,151,190,5,6,1,30168039.64
ADAM.BURISH,20112012,DAL,831.2166666666667,6,7,5,12,18,13,217,389,172,82,140,68,27,17,21,700,837,611,623,21,21,0.5578406169665809,30168095.975
ADAM.CRACKNELL,20112012,STL,15.283333333333333,1,0,0,0,1,1,0,1,1,1,2,1,0,0,0,15,13,15,12,1,0,0,30168019.700000003
ADAM.HALL,20112012,T.B,676.35,2,4,1,5,7,6,276,464,188,63,89,89,8,9,7,388,756,349,434,14,24,0.5948275862068966,30168076.955
ADAM.HENRIQUE,20112012,N.J,1757.6666666666665,21,24,18,42,63,45,649,1365,716,170,258,114,39,23,6,1435,1359,1123,1023,57,44,0.47545787545787543,30168169.09
ADAM.LARSSON,20112012,N.J,1422.4333333333334,3,8,6,14,17,11,0,0,0,71,168,101,70,7,12,1190,1018,982,910,46,47,0,30168100.37
ADAM.MCQUAID,20112012,BOS,1076.5666666666666,2,2,4,6,8,4,0,0,0,63,157,104,68,16,25,928,997,883,869,43,29,0,30168097.41
ADAM.PARDY,20112012,DAL,592.9,0,0,3,3,3,0,0,0,0,29,56,39,19,6,7,522,576,501,513,18,26,0,30168067.134999998
ADRIAN.AUCOIN,20112012,ARI,1494.4166666666667,2,1,8,9,11,3,0,0,0,101,221,111,65,12,27,1290,1425,1155,1127,51,38,0,30168123.67
AKIM.ALIU,20112012,CGY,22.066666666666666,2,0,1,1,3,2,0,0,0,3,4,6,1,5,2,16,18,16,18,3,0,0,15084012.275
ALEC.MARTINEZ,20112012,L.A,1040.1833333333334,7,6,2,8,15,13,0,1,1,102,230,73,76,9,8,1228,661,926,597,25,20,0,30168060.89
ALES.HEMSKY,20112012,EDM,1214.4,10,13,13,26,36,23,2,6,4,136,255,22,70,15,17,1163,1004,919,905,31,36,0.3333333333333333,30168117.455
ALEX.BOLDUC,20112012,ARI,14.316666666666666,0,0,0,0,0,0,1,1,0,1,2,1,0,0,1,14,15,14,15,0,1,1,30168019.740000002
ALEX.BURMISTROV,20112012,WPG,1266.35,13,7,8,15,28,20,248,564,316,123,231,118,51,24,20,1172,1073,935,826,37,32,0.4397163120567376,30168118.21
ALEX.BURROWS,20112012,VAN,1572.1166666666668,29,18,6,24,53,47,7,21,14,215,367,96,72,32,37,1724,1224,1239,881,54,34,0.3333333333333333,30168117.2
ALEX.EDLER,20112012,VAN,2078.3166666666666,13,16,21,37,50,29,0,3,3,240,519,157,177,11,22,2216,1750,1430,1285,56,64,0,30168139.335
ALEX.GIROUX,20112012,CBJ,109.76666666666665,1,0,0,0,1,1,1,1,0,18,27,11,6,1,3,118,85,86,76,4,4,1,30168025.65
ALEX.GOLIGOSKI,20112012,DAL,1616.7666666666667,9,13,7,20,29,22,0,0,0,140,338,49,113,10,8,1647,1308,1212,1027,50,48,0,30168109.275
ALEX.OVECHKIN,20112012,WSH,1821.35,43,16,15,31,74,59,7,16,9,353,699,273,193,31,18,1942,1632,1276,1489,55,60,0.4375,30168201.415
ALEX.PICARD,20112012,PIT,223.41666666666669,0,2,1,3,3,2,0,0,0,10,19,12,6,2,2,220,149,205,140,13,9,0,30168027.895
ALEX.PIETRANGELO,20112012,STL,2205.3166666666666,12,22,20,42,54,34,0,0,0,221,497,104,152,12,14,2177,1874,1522,1259,50,40,0,30168135.72
ALEX.PLANTE,20112012,EDM,31.933333333333337,0,1,0,1,1,1,0,0,0,0,1,5,1,1,1,25,29,25,28,2,2,0,30168021.21
ALEX.RADULOV,20112012,NSH,319.18333333333334,4,5,4,9,13,9,2,5,3,34,69,9,19,4,3,305,255,249,239,14,9,0.4,30168044.62
ALEX.SEMIN,20112012,WSH,1537.4333333333334,24,23,11,34,58,47,1,12,11,218,468,39,139,21,30,1694,1269,1232,1171,56,46,0.08333333333333333,30168149.225
ALEX.STEEN,20112012,STL,1010.5,16,8,7,15,31,24,60,113,53,155,327,28,102,22,17,1122,783,781,547,35,13,0.5309734513274337,30168069.145000003
ALEX.SULZER,20112012,BUF,289.53333333333336,3,1,3,4,7,4,0,0,0,22,51,11,18,1,3,303,250,279,231,16,12,0,30168038.035
ALEX.SULZER,20112012,VAN,191.7,0,1,0,1,1,1,0,0,0,11,28,6,14,2,1,156,184,154,160,9,3,0,30168032.12
ALEX.TANGUAY,20112012,CGY,1218.9166666666667,13,24,11,35,48,37,25,67,42,84,160,22,38,14,14,1119,1137,724,867,43,31,0.373134328358209,30168131.115000002
ALEX.URBOM,20112012,N.J,67.98333333333333,1,0,0,0,1,1,0,0,0,3,5,5,0,1,3,42,55,41,51,4,4,0,30168024.310000002
ALEXEI.EMELIN,20112012,MTL,1158.7666666666667,3,3,1,4,7,6,0,0,0,62,146,236,59,22,15,1025,1173,916,986,33,56,0,30168115.695
ALEXEI.PONIKAROVSKY,20112012,CAR,728.6833333333334,7,3,5,8,15,10,3,8,5,98,184,94,48,10,13,859,604,611,535,13,24,0.375,30168072.645
ALEXEI.PONIKAROVSKY,20112012,N.J,825.8666666666667,8,9,10,19,27,17,3,9,6,84,142,99,28,10,10,637,550,618,500,33,17,0.3333333333333333,30168070.32
ANDRE.DEVEAUX,20112012,NYR,48.38333333333333,0,0,1,1,1,0,1,1,0,2,4,16,0,4,6,40,32,36,32,4,1,1,30168021.505000003
ANDRE.PETERSSON,20112012,OTT,5.033333333333333,0,0,0,0,0,0,0,0,0,0,0,0,0,0,0,2,1,2,1,0,0,0,15084009.05
ANDREAS.ENGQVIST,20112012,MTL,79.16666666666666,0,0,0,0,0,0,24,60,36,3,11,9,3,0,2,64,82,60,63,1,2,0.4,30168025.86
ANDREAS.LILJA,20112012,PHI,769.2833333333333,0,3,2,5,5,3,0,0,0,46,70,75,13,6,20,627,809,600,711,28,21,0,30168095.66
ANDREAS.NODL,20112012,CAR,579.3166666666666,3,3,1,4,7,6,1,2,1,60,116,60,23,3,3,522,580,505,558,10,14,0.5,30168078.845
ANDREAS.NODL,20112012,PHI,123.5,0,1,0,1,1,1,2,6,4,6,12,8,3,2,1,78,122,70,78,1,2,0.3333333333333333,30168026.799999997
ANDREI.KOSTITSYN,20112012,MTL,804.65,12,6,6,12,24,18,3,16,13,93,172,81,51,10,9,742,751,586,697,30,33,0.1875,30168099.97
ANDREI.KOSTITSYN,20112012,NSH,407.7166666666667,7,5,4,9,16,12,1,4,3,41,85,48,25,3,7,403,322,345,304,19,8,0.25,30168050.97
ANDREI.LOKTIONOV,20112012,L.A,496.93333333333334,3,4,0,4,7,7,64,149,85,60,114,7,35,5,2,489,395,442,378,11,12,0.42953020134228187,30168056.96
ANDREI.MARKOV,20112012,MTL,234.1,0,2,1,3,3,2,0,0,0,17,38,7,16,2,2,258,190,150,156,4,9,0,30168033.244999997
ANDREJ.MESZAROS,20112012,PHI,1300.6333333333332,6,11,7,18,24,17,0,0,0,115,245,147,87,11,19,1243,1254,1008,961,48,41,0,30168110.985
ANDREJ.SEKERA,20112012,BUF,1352.5833333333333,3,3,5,8,11,6,0,1,1,88,185,56,60,11,9,1137,1178,955,930,44,40,0,30168104.185
ANDREW.ALBERTS,20112012,VAN,629.05,2,0,1,1,3,2,0,0,0,19,61,91,31,8,16,461,585,443,514,22,18,0,30168069.905
ANDREW.BRUNETTE,20112012,CHI,1137.1166666666668,13,11,4,15,28,24,7,15,8,81,125,25,17,7,3,1098,869,822,823,31,49,0.4666666666666667,30168113.5
ANDREW.COGLIANO,20112012,ANA,1205.8833333333332,13,9,4,13,26,22,162,385,223,114,206,88,50,15,6,960,1196,841,920,40,43,0.42077922077922075,30168131.08
ANDREW.DESJARDINS,20112012,S.J,785.8833333333333,5,9,4,13,18,14,213,397,184,85,142,102,28,15,16,698,765,682,649,23,19,0.5365239294710328,30168096.22
ANDREW.EBBETT,20112012,VAN,182.85000000000002,5,0,1,1,6,5,17,32,15,28,40,17,3,1,3,176,136,141,120,5,5,0.53125,30168033.765
ANDREW.FERENCE,20112012,BOS,1510.8666666666668,7,8,12,20,27,15,1,1,0,125,259,82,83,14,16,1300,1453,1119,1172,53,49,1,30168136.43
ANDREW.GORDON,20112012,ANA,401.6333333333333,2,2,1,3,5,4,0,5,5,38,73,48,15,6,2,278,453,259,318,5,14,0,30168054.835
ANDREW.JOUDREY,20112012,CBJ,9.266666666666667,0,0,0,0,0,0,1,1,0,1,1,0,0,0,0,4,8,4,8,0,0,1,15084010.04
ANDREW.LADD,20112012,WPG,1604.4,28,12,9,21,49,40,32,59,27,265,430,76,80,19,23,1761,1331,1269,1050,48,55,0.5423728813559322,30168137.645
ANDREW.MACDONALD,20112012,NYI,1753.1166666666666,5,1,11,12,17,6,0,0,0,71,202,48,90,17,13,1451,1760,1214,1360,43,50,0,30168151.895000003
ANDREW.MURRAY,20112012,S.J,300.48333333333335,1,2,1,3,4,3,5,15,10,33,52,66,7,5,2,251,258,238,223,9,6,0.3333333333333333,30168041.475
ANDREW.SHAW,20112012,CHI,604.4333333333334,12,8,2,10,22,20,41,88,47,82,142,89,32,22,15,582,454,465,401,21,26,0.4659090909090909,30168068.41
ANDY.GREENE,20112012,N.J,1620.95,1,8,8,16,17,9,0,0,0,77,189,62,58,10,12,1248,1280,1078,1002,55,51,0,30168108.9
ANDY.MCDONALD,20112012,STL,646.45,15,9,8,17,32,24,99,173,74,90,146,8,33,10,5,701,489,448,383,21,15,0.5722543352601156,30168069.060000002
ANDY.MIELE,20112012,ARI,62.56666666666666,0,0,0,0,0,0,7,28,21,4,7,11,2,0,3,60,71,43,66,0,3,0.25,30168027.08
ANDY.SUTTON,20112012,EDM,867.5666666666666,3,3,4,7,10,6,0,0,0,41,78,112,22,10,34,719,861,689,702,30,25,0,30168092.35
ANTHONY.STEWART,20112012,CAR,625.5999999999999,9,5,6,11,20,14,3,17,14,64,105,92,18,8,8,522,599,479,576,23,26,0.17647058823529413,30168088.950000003
ANTOINE.VERMETTE,20112012,ARI,665.4666666666667,8,9,3,12,20,17,361,623,262,67,120,115,29,10,16,653,648,485,562,27,18,0.579454253611557,30168095.765
ANTOINE.VERMETTE,20112012,CBJ,1034.45,8,11,8,19,27,19,453,804,351,106,181,66,28,14,5,942,838,674,613,27,39,0.5634328358208955,30168099.46
ANTON.BABCHUK,20112012,CGY,463.65000000000003,2,5,2,7,9,7,0,0,0,48,124,17,50,1,3,473,385,310,354,13,9,0,30168053.310000002
ANTON.LANDER,20112012,EDM,594.4,2,0,4,4,6,2,149,344,195,54,84,32,16,5,6,377,626,352,465,10,18,0.4331395348837209,30168079.86
ANTON.STRALMAN,20112012,NYR,1244.7666666666667,5,10,8,18,23,15,0,0,0,81,168,99,60,5,12,1088,1035,885,931,37,29,0,30168114.35
ANTON.VOLCHENKOV,20112012,N.J,1679.9833333333331,3,5,4,9,12,8,0,0,0,79,192,233,72,16,23,1149,1476,1029,978,45,43,0,30168108.41
ANTTI.MIETTINEN,20112012,WPG,526.8166666666666,5,4,4,8,13,9,9,21,12,58,104,38,26,2,0,467,520,394,433,12,16,0.42857142857142855,30168066.98
ANZE.KOPITAR,20112012,L.A,2190.75,33,30,33,63,96,63,941,1785,844,286,502,103,97,28,13,2507,1769,1694,1233,67,49,0.527170868347339,30168185.045
ARRON.ASHAM,20112012,PIT,603.0333333333333,5,9,2,11,16,14,6,11,5,50,93,99,24,19,23,501,508,486,504,23,30,0.5454545454545454,30168077.18
ARTEM.ANISIMOV,20112012,NYR,1493.9499999999998,19,16,11,27,46,35,191,412,221,151,300,92,76,20,14,1335,1323,1006,1098,44,33,0.46359223300970875,30168156.314999998
ARTURS.KULDA,20112012,WPG,97.83333333333334,0,0,0,0,0,0,0,0,0,8,14,13,3,3,2,75,101,73,99,4,2,0,30168028.880000003
B.J..CROMBEEN,20112012,STL,391.15,2,2,0,2,4,4,3,12,9,58,97,30,22,16,24,319,293,314,277,6,9,0.25,30168049.23
BARRET.JACKMAN,20112012,STL,1845.1,1,6,7,13,14,7,0,0,0,91,201,121,66,31,28,1456,1813,1312,1222,48,38,0,30168132.185000002
BEN.EAGER,20112012,EDM,538.0999999999999,8,4,1,5,13,12,0,2,2,69,121,73,27,19,33,409,525,403,520,16,15,0,30168085.965
BEN.HOLMSTROM,20112012,PHI,33.6,0,0,0,0,0,0,15,30,15,3,4,8,0,0,1,18,30,18,26,1,1,0.5,30168021.75
BEN.LOVEJOY,20112012,PIT,471.5833333333333,1,2,2,4,5,3,0,0,0,48,101,32,35,2,5,464,400,441,361,14,15,0,30168047.87
BEN.MAXWELL,20112012,ANA,46.53333333333334,0,1,0,1,1,1,16,34,18,6,8,8,1,1,1,37,49,37,48,1,0,0.47058823529411764,30168024.799999997
BEN.MAXWELL,20112012,WPG,54.46666666666667,1,3,1,4,5,4,10,25,15,4,7,3,3,1,0,39,42,37,39,5,2,0.4,30168024.085
BEN.SMITH,20112012,CHI,127.56666666666666,2,0,0,0,2,2,7,14,7,18,24,6,4,1,0,111,113,106,108,4,10,0.5,30168030.29
BENN.FERRIERO,20112012,S.J,421.73333333333335,7,0,1,1,8,7,3,12,9,68,108,43,25,3,5,427,404,385,389,12,12,0.25,30168061.125
BENOIT.POULIOT,20112012,BOS,992.1833333333333,17,10,7,17,34,27,8,19,11,113,185,112,28,16,17,1060,759,900,728,43,28,0.42105263157894735,30168098.305
BILL.SWEATT,20112012,VAN,10.683333333333334,0,0,0,0,0,0,0,0,0,2,3,1,1,0,0,6,12,6,9,0,0,0,15084010
BILL.THOMAS,20112012,FLA,61.18333333333333,1,0,0,0,1,1,0,3,3,9,17,10,6,0,0,56,46,55,41,1,1,0,30168021.65
BLAIR.JONES,20112012,CGY,302.75,1,3,0,3,4,4,101,235,134,37,60,25,13,5,3,249,286,194,218,3,2,0.4297872340425532,30168048.990000002
BLAIR.JONES,20112012,T.B,185.66666666666669,2,0,2,2,4,2,27,67,40,20,29,24,3,4,5,134,154,123,137,4,7,0.40298507462686567,30168036.42
BLAKE.COMEAU,20112012,CGY,934.1833333333333,5,5,5,10,15,10,27,83,56,117,234,108,76,10,12,758,787,658,634,21,20,0.3253012048192771,30168082.555
BLAKE.COMEAU,20112012,NYI,209.15,0,0,0,0,0,0,2,8,6,20,49,36,19,2,3,178,217,164,199,0,11,0.25,30168038.55
BLAKE.GEOFFRION,20112012,MTL,158.85,2,0,0,0,2,2,1,4,3,17,36,11,13,5,5,126,146,120,140,4,2,0.25,30168033.64
BLAKE.GEOFFRION,20112012,NSH,227.56666666666666,0,2,1,3,3,2,67,141,74,12,29,29,10,4,7,153,227,139,190,4,6,0.475177304964539,30168043.345
BLAKE.WHEELER,20112012,WPG,1526.0333333333333,17,31,16,47,64,48,4,10,6,208,371,113,61,27,25,1778,1270,1314,1153,61,61,0.4,30168151.78
BOBBY.BUTLER,20112012,OTT,680.95,6,4,6,10,16,10,3,3,0,92,170,36,40,7,9,732,603,641,572,30,22,1,30168074.09
BOBBY.RYAN,20112012,ANA,1504.8000000000002,31,20,6,26,57,51,20,69,49,204,373,113,75,30,21,1430,1254,1059,1059,52,46,0.2898550724637681,30168153.9
BOBBY.SANGUINETTI,20112012,CAR,35.81666666666666,0,0,0,0,0,0,0,0,0,5,8,1,2,0,0,36,26,15,22,1,1,0,30168020.35
BOYD.GORDON,20112012,ARI,1479.4666666666667,8,9,7,16,24,17,851,1483,632,130,196,57,40,10,7,1030,1761,927,1159,35,32,0.5738368172623062,30168176.064999998
BRACKEN.KEARNS,20112012,FLA,36.18333333333334,0,0,0,0,0,0,1,2,1,0,2,6,2,2,2,20,34,20,34,0,0,0.5,30168022.16
BRAD.BOYES,20112012,BUF,855.85,8,10,5,15,23,18,126,267,141,100,170,29,33,5,3,883,703,619,647,20,17,0.47191011235955055,30168098.915
BRAD.MALONE,20112012,COL,90.38333333333333,0,2,0,2,2,2,1,8,7,6,12,13,2,3,0,62,62,61,62,2,1,0.125,30168025.42
BRAD.MARCHAND,20112012,BOS,1465.8333333333335,29,13,15,28,57,42,6,12,6,184,306,81,67,33,27,1672,1117,1285,893,58,35,0.5,30168111.345
BRAD.MILLS,20112012,N.J,168.08333333333334,0,0,1,1,1,0,65,107,42,16,27,34,4,6,7,105,157,99,128,2,11,0.6074766355140186,30168034.785
BRAD.RICHARDS,20112012,NYR,2105.666666666667,31,27,23,50,81,58,899,1753,854,298,552,68,134,15,15,2168,1726,1378,1485,57,60,0.5128351397604107,30168232.485
BRAD.RICHARDSON,20112012,L.A,870.3166666666666,6,2,1,3,9,8,44,74,30,111,212,79,55,25,17,908,689,854,604,20,26,0.5945945945945946,30168069.435000002
BRAD.STAUBITZ,20112012,MIN,279.7166666666667,0,0,0,0,0,0,3,5,2,17,32,64,7,20,22,142,288,141,288,2,9,0.6,30168057.22
BRAD.STAUBITZ,20112012,MTL,124.61666666666667,1,0,0,0,1,1,0,1,1,10,23,31,7,7,9,101,97,100,95,2,1,0,30168028.57
BRAD.STUART,20112012,DET,1802.2666666666667,6,7,6,13,19,13,0,0,0,100,216,194,71,16,13,1385,1700,1264,1149,64,54,0,30168122.509999998
BRAD.WINCHESTER,20112012,S.J,529.7833333333333,6,3,1,4,10,9,20,33,13,72,112,80,21,16,25,478,455,443,444,11,15,0.6060606060606061,30168071.535
BRADLEY.MILLS,20112012,N.J,25.7,0,0,0,0,0,0,12,19,7,2,5,2,2,1,2,13,20,13,13,0,1,0.631578947368421,15084010.64
BRANDON.BOLLIG,20112012,CHI,130.08333333333331,1,0,0,0,1,1,0,0,0,20,32,32,8,10,17,87,112,85,110,2,4,0,30168033.1
BRANDON.DUBINSKY,20112012,NYR,1383.0500000000002,10,15,11,26,36,25,228,439,211,154,281,222,65,30,40,1251,1223,954,962,38,29,0.5193621867881549,30168137.495
BRANDON.MANNING,20112012,PHI,54.900000000000006,0,0,0,0,0,0,0,0,0,6,7,6,1,0,0,51,44,49,44,2,1,0,30168022
BRANDON.MCMILLAN,20112012,ANA,280.4,0,1,3,4,4,1,23,67,44,26,36,21,4,2,8,154,347,134,235,7,17,0.34328358208955223,30168050.165
BRANDON.PIRRI,20112012,CHI,67.58333333333333,0,0,2,2,2,0,26,54,28,5,12,5,5,1,0,54,65,45,58,3,1,0.48148148148148145,30168024.799999997
BRANDON.PRUST,20112012,NYR,1222.1,6,7,5,12,18,13,3,5,2,89,140,197,23,45,53,807,1230,752,944,31,33,0.6,30168135.244999997
BRANDON.SAAD,20112012,CHI,52.733333333333334,0,0,1,1,1,0,0,0,0,3,6,4,1,0,0,39,35,35,34,2,0,0,30168021.125
BRANDON.SEGAL,20112012,T.B,65.83333333333333,0,0,0,0,0,0,1,4,3,8,11,12,1,0,2,47,56,47,56,0,2,0.25,30168024.74
BRANDON.SUTTER,20112012,CAR,1426.6333333333332,17,12,3,15,32,29,654,1295,641,171,293,53,61,22,9,1151,1572,986,1130,30,31,0.505019305019305,30168178.905
BRANDON.YIP,20112012,COL,99.18333333333334,0,0,0,0,0,0,0,2,2,12,18,14,2,2,3,77,76,71,75,2,1,0,30168026.270000003
BRANDON.YIP,20112012,NSH,364.0666666666667,4,4,1,5,9,8,2,7,5,40,61,48,8,5,9,277,364,253,353,11,11,0.2857142857142857,30168064.155
BRAYDEN.MCNABB,20112012,BUF,445.9666666666667,1,2,5,7,8,3,0,0,0,23,52,49,19,8,6,370,405,316,323,14,12,0,30168050.005
BRAYDEN.SCHENN,20112012,PHI,919.7,15,7,5,12,27,22,233,510,277,108,191,164,48,23,18,908,809,718,739,27,37,0.4568627450980392,30168116.275
BRAYDON.COBURN,20112012,PHI,2084.3,4,12,10,22,26,16,0,1,1,125,295,200,93,15,28,1709,2128,1466,1503,68,73,0,30168166.8
BRENDAN.BELL,20112012,NYR,11.433333333333334,0,0,0,0,0,0,0,0,0,2,4,0,0,0,0,12,13,12,13,0,1,0,15084010.45
BRENDAN.MIKKELSON,20112012,T.B,590.4166666666667,1,2,0,2,3,3,0,0,0,45,95,42,32,4,5,506,502,414,456,16,20,0,30168063.34
BRENDAN.MORRISON,20112012,CGY,384.81666666666666,4,5,2,7,11,9,150,298,148,32,56,5,12,9,3,312,343,264,307,11,12,0.5033557046979866,30168061.14
BRENDAN.MORRISON,20112012,CHI,172.2,1,0,0,0,1,1,46,103,57,16,22,6,4,1,3,145,132,133,122,2,5,0.44660194174757284,30168033.1
BRENDAN.SMITH,20112012,DET,218.83333333333334,1,4,1,5,6,5,0,0,0,13,31,17,10,6,5,233,138,191,125,9,5,0,30168028.785
BRENDEN.DILLON,20112012,DAL,19.983333333333334,0,0,0,0,0,0,0,0,0,6,6,4,0,0,0,22,27,17,14,0,0,0,15084010.55
BRENDEN.MORROW,20112012,DAL,971.2,11,7,8,15,26,18,11,27,16,88,158,130,32,19,40,940,889,686,766,28,26,0.4074074074074074,30168113.03
BRENT.BURNS,20112012,S.J,1951.2166666666667,12,14,13,27,39,26,0,0,0,214,495,81,172,16,20,2186,1798,1547,1361,52,43,0,30168142.134999998
BRENT.SEABROOK,20112012,CHI,2108.65,10,10,17,27,37,20,0,0,0,174,342,224,104,11,12,2038,1823,1593,1332,72,64,0,30168136.134999998
BRETT.BULMER,20112012,MIN,99.28333333333333,0,0,3,3,3,0,0,0,0,7,13,17,3,3,3,64,92,61,90,3,2,0,30168028.605
BRETT.CARSON,20112012,CGY,22.71666666666667,0,0,0,0,0,0,0,0,0,1,3,0,2,0,0,26,18,26,17,0,2,0,15084010
BRETT.CLARK,20112012,T.B,1506.8,2,7,5,12,14,9,0,0,0,61,168,118,70,4,10,1157,1531,941,1141,40,60,0,30168135.814999998
BRETT.CONNOLLY,20112012,T.B,780.05,4,4,7,11,15,8,20,52,32,94,156,58,27,9,18,650,679,555,634,22,24,0.38461538461538464,30168092.415
BRETT.FESTERLING,20112012,WPG,65.58333333333334,0,0,0,0,0,0,0,0,0,2,4,7,1,0,1,47,59,47,43,2,1,0,30168021.9
BRETT.LEBDA,20112012,CBJ,494.30000000000007,1,1,2,3,4,2,0,0,0,36,70,21,19,3,7,402,450,350,398,22,22,0,30168058.33
BRETT.MACLEAN,20112012,WPG,42.41666666666667,0,0,2,2,2,0,0,0,0,6,9,3,1,1,1,51,41,45,40,3,2,0,30168021.759999998
BRETT.STERLING,20112012,STL,30.25,0,0,0,0,0,0,3,4,1,5,8,1,1,1,0,44,19,33,19,1,2,0.75,30168019.18
BRETT.SUTTER,20112012,CAR,113.6,0,2,1,3,3,2,14,21,7,11,22,23,4,2,3,76,113,73,100,5,5,0.6666666666666666,30168030.405
BRIAN.BOYLE,20112012,NYR,1533.95,14,11,7,18,32,25,777,1521,744,198,352,296,82,30,31,1205,1577,995,1122,40,39,0.5108481262327417,30168178.905
BRIAN.CAMPBELL,20112012,FLA,2401.5333333333333,5,25,27,52,57,30,0,0,0,140,294,54,93,16,4,2380,1911,1614,1500,47,51,0,30168168.335
BRIAN.GIONTA,20112012,MTL,602.4833333333333,8,6,1,7,15,14,14,33,19,75,154,35,33,9,8,576,553,396,388,18,18,0.42424242424242425,30168063.575
BRIAN.LEE,20112012,OTT,512.5833333333334,1,3,4,7,8,4,0,0,0,15,49,73,17,3,12,407,490,378,370,14,16,0,30168055.18
BRIAN.LEE,20112012,T.B,341.8166666666667,0,3,5,8,8,3,0,0,0,17,38,54,7,0,4,251,345,229,298,12,13,0,30168051.875
BRIAN.MCGRATTAN,20112012,NSH,159.60000000000002,0,1,1,2,2,1,0,0,0,10,21,29,4,7,12,117,132,117,132,3,4,0,30168033.895
BRIAN.ROLSTON,20112012,BOS,409.25,4,6,8,14,18,10,32,65,33,56,104,47,30,2,4,395,282,314,256,18,13,0.49230769230769234,30168044.950000003
BRIAN.ROLSTON,20112012,NYI,694.1333333333333,4,2,3,5,9,6,11,26,15,112,203,56,51,2,3,654,557,476,487,13,22,0.4230769230769231,30168068.485
BRIAN.STRAIT,20112012,PIT,144.73333333333335,0,0,1,1,1,0,0,0,0,6,14,13,0,4,2,117,127,112,119,6,5,0,30168030.065
BROOKS.LAICH,20112012,WSH,1799.5500000000002,18,25,5,30,48,43,777,1626,849,217,341,136,61,26,17,1541,1883,1080,1272,43,45,0.477859778597786,30168214.265
BROOKS.ORPIK,20112012,PIT,1779.9833333333333,2,7,8,15,17,9,0,0,0,47,127,277,49,14,28,1512,1731,1351,1234,72,66,0,30168129.939999998
BRUNO.GERVAIS,20112012,T.B,713.3666666666667,6,3,3,6,12,9,0,0,0,57,117,42,36,1,4,608,616,538,526,26,30,0,30168070.235
BRYAN.ALLEN,20112012,CAR,1571.15,1,5,6,11,12,6,0,0,0,87,210,111,75,11,35,1276,1714,1169,1277,43,55,0,30168147.009999998
BRYAN.BICKELL,20112012,CHI,962.3,11,8,7,15,26,19,0,1,1,98,186,160,50,16,17,915,785,811,755,31,39,0,30168098.835
BRYAN.LITTLE,20112012,WPG,1496.1000000000001,24,14,8,22,46,38,733,1477,744,162,291,44,66,13,12,1620,1246,1137,973,45,53,0.4962762356127285,30168155.450000003
BRYAN.RODNEY,20112012,EDM,13.283333333333333,0,0,0,0,0,0,0,0,0,0,2,1,2,0,0,9,19,9,19,0,1,0,15084011.1
BRYCE.SALVADOR,20112012,N.J,2195.133333333333,4,9,9,18,22,13,0,0,0,82,178,160,71,16,37,1424,1940,1288,1415,53,49,0,30168165.485
BYRON.BITZ,20112012,VAN,107.83333333333333,1,2,1,3,4,3,0,3,3,6,10,20,2,2,6,73,88,73,87,4,2,0,30168029.744999997
CADE.FAIRCHILD,20112012,STL,48.266666666666666,0,0,1,1,1,0,0,0,0,1,5,1,1,0,0,48,33,40,30,1,2,0,30168020.325
CAL.CLUTTERBUCK,20112012,MIN,1210.3833333333332,15,6,6,12,27,21,5,15,10,161,284,288,58,33,37,1000,1148,705,888,23,30,0.3333333333333333,30168132.43
CAL.O'REILLY,20112012,ARI,277.51666666666665,2,2,1,3,5,4,76,170,94,13,23,3,5,1,1,225,262,187,249,7,11,0.4470588235294118,30168051.525
CAL.O'REILLY,20112012,NSH,70.48333333333332,0,1,0,1,1,1,20,44,24,1,3,1,2,0,1,37,61,25,51,1,3,0.45454545454545453,30168025.700000003
CAL.O'REILLY,20112012,PIT,73.11666666666667,0,1,0,1,1,1,24,54,30,3,7,1,2,2,0,76,57,63,52,0,3,0.4444444444444444,30168024.33
CALVIN.DE HAAN,20112012,NYI,13.016666666666666,0,0,0,0,0,0,0,0,0,2,3,2,0,0,0,17,8,12,5,1,0,0,15084009.1
CAM.ATKINSON,20112012,CBJ,415.2166666666667,7,6,1,7,14,13,0,1,1,66,108,23,22,2,7,434,345,306,302,20,18,0,30168054.395
CAM.BARKER,20112012,EDM,459.01666666666665,2,0,0,0,2,2,0,0,0,35,80,36,32,3,10,403,439,288,386,14,15,0,30168059.28
CAM.FOWLER,20112012,ANA,1907.3666666666668,5,10,12,22,27,15,1,1,0,123,267,42,97,6,9,1951,1495,1299,1253,50,71,1,30168136.4
CAM.JANSSEN,20112012,N.J,224.73333333333335,0,1,0,1,1,1,2,5,3,17,24,74,2,10,16,127,169,125,167,2,10,0.4,30168040.23
CARL.GUNNARSSON,20112012,TOR,1649.4333333333334,4,4,9,13,17,8,0,1,1,89,199,113,75,11,10,1393,1662,1144,1191,47,51,0,30168132.935000002
CARL.HAGELIN,20112012,NYR,1247.7833333333333,14,15,11,26,40,29,5,16,11,158,259,99,54,18,19,1161,1071,1057,987,52,38,0.3125,30168127.605
CARL.KLINGBERG,20112012,WPG,32.983333333333334,0,0,0,0,0,0,0,0,0,7,10,1,1,0,2,39,19,39,19,0,1,0,15084010.4
CARL.SNEEP,20112012,PIT,16.316666666666666,0,1,0,1,1,1,0,0,0,0,0,2,0,0,0,18,7,18,7,2,1,0,15084009.4
CARLO.COLAIACOVO,20112012,STL,1340.2,2,8,11,19,21,10,0,0,0,80,201,82,76,8,15,1379,1034,1049,903,35,30,0,30168097.305
CARSON.MCMILLAN,20112012,MIN,121.66666666666667,1,1,1,2,3,2,5,14,9,8,19,19,5,1,3,86,133,84,126,4,3,0.35714285714285715,30168033.935000002
CARTER.ASHTON,20112012,TOR,156.25,0,0,0,0,0,0,1,2,1,22,32,32,7,4,5,117,136,116,135,0,10,0.5,30168033.33
CARTER.CAMPER,20112012,BOS,20.1,1,0,0,0,1,1,6,14,8,1,1,1,0,0,0,7,37,7,37,1,0,0.42857142857142855,15084015.14
CASEY.CIZIKAS,20112012,NYI,159.01666666666668,0,3,1,4,4,3,47,115,68,12,24,26,9,1,3,122,143,121,135,7,5,0.40869565217391307,30168035.515
CASEY.WELLMAN,20112012,MIN,178.3,2,2,2,4,6,4,6,9,3,25,47,6,10,3,0,180,192,151,174,5,8,0.6666666666666666,30168038.32
CHAD.LAROSE,20112012,CAR,1123.25,19,8,5,13,32,27,18,43,25,199,332,131,69,15,23,1211,1101,920,909,31,43,0.4186046511627907,30168126.045
CHAD.RAU,20112012,MIN,98,2,0,0,0,2,2,35,65,30,7,12,2,2,0,0,64,88,51,85,2,3,0.5384615384615384,30168030.5
CHAY.GENOWAY,20112012,MIN,18.266666666666666,0,0,1,1,1,0,0,0,0,1,1,0,0,1,0,15,17,11,13,1,1,0,15084010.385
CHRIS.BUTLER,20112012,CGY,1469.3333333333335,2,2,8,10,12,4,0,0,0,62,149,70,51,7,13,1178,1542,1013,1175,42,47,0,30168137.87
CHRIS.CAMPOLI,20112012,MTL,739.6333333333333,2,2,7,9,11,4,0,0,0,43,86,43,24,10,4,646,669,488,582,21,24,0,30168080.025
CHRIS.CONNER,20112012,DET,84.5,1,2,0,2,3,3,0,0,0,10,17,4,3,0,0,68,94,65,72,3,1,0,30168026.950000003
CHRIS.HIGGINS,20112012,VAN,1236.2333333333333,18,13,13,26,44,31,12,33,21,176,268,71,35,13,9,1236,1048,984,828,43,33,0.36363636363636365,30168113.235
CHRIS.KELLY,20112012,BOS,1320.85,21,12,9,21,42,33,462,890,428,134,222,92,42,16,17,1147,1240,1015,929,56,32,0.5191011235955056,30168140.064999998
CHRIS.KREIDER,20112012,NYR,236.73333333333332,5,2,0,2,7,7,4,8,4,29,56,29,16,1,3,241,178,212,165,6,9,0.5,30168035.52
CHRIS.KUNITZ,20112012,PIT,1616.05,28,20,18,38,66,48,20,41,21,247,422,202,75,21,27,2204,1157,1375,991,73,46,0.4878048780487805,30168125.11
CHRIS.MUELLER,20112012,NSH,36.58333333333333,0,0,0,0,0,0,15,27,12,4,6,1,0,0,0,30,34,29,30,2,2,0.5555555555555556,30168021.4
CHRIS.NEIL,20112012,OTT,1016.1666666666667,15,9,7,16,31,24,1,3,2,135,207,298,40,42,56,1082,783,820,741,29,36,0.3333333333333333,30168109.435
CHRIS.PHILLIPS,20112012,OTT,1679.6333333333332,5,7,8,15,20,12,0,0,0,95,219,150,79,12,10,1485,1762,1268,1218,44,43,0,30168133.17
CHRIS.PORTER,20112012,STL,488.4666666666667,4,1,2,3,7,5,8,19,11,61,96,124,18,6,4,410,398,401,378,13,14,0.42105263157894735,30168057.68
CHRIS.PRONGER,20112012,PHI,292.18333333333334,1,3,8,11,12,4,0,0,0,23,46,15,19,2,5,268,259,152,143,9,4,0,30168032.52
CHRIS.STEWART,20112012,STL,1295.15,17,11,4,15,32,28,3,13,10,179,283,123,47,17,36,1297,1129,1013,1037,36,35,0.23076923076923078,30168143.689999998
CHRIS.SUMMERS,20112012,ARI,261.4666666666667,0,1,1,2,2,1,0,0,0,10,33,50,17,2,4,213,253,202,210,7,12,0,30168037.545
CHRIS.TANEV,20112012,VAN,493.98333333333335,0,1,1,2,2,1,0,0,0,22,52,12,24,5,2,460,437,439,371,17,8,0,30168047.625
CHRIS.THORBURN,20112012,WPG,732.5666666666667,4,6,1,7,11,10,39,66,27,69,120,151,24,20,24,512,778,502,675,17,22,0.5909090909090909,30168102.384999998
CHRIS.VANDEVELDE,20112012,EDM,49.3,1,0,0,0,1,1,18,40,22,1,2,4,1,1,1,20,46,19,29,2,0,0.45,30168022.78
CHRISTIAN.EHRHOFF,20112012,BUF,1521.8166666666666,5,11,13,24,29,16,0,0,0,136,303,47,96,17,19,1566,1330,1090,1095,53,49,0,30168125.744999997
CHUCK.KOBASEW,20112012,COL,687.2166666666667,7,6,1,7,14,13,7,22,15,64,112,61,29,11,14,520,665,468,534,15,25,0.3181818181818182,30168082.465000004
CLARKE.MACARTHUR,20112012,TOR,1156.6166666666668,20,12,11,23,43,32,5,11,6,148,280,60,85,17,17,1200,968,968,912,42,37,0.45454545454545453,30168119.145000003
CLAUDE.GIROUX,20112012,PHI,1884.8833333333332,36,43,31,74,110,79,950,1779,829,277,518,77,132,40,18,2138,1622,1258,1160,67,50,0.5340078695896571,30168199.325
CLAY.WILSON,20112012,CGY,66.25,0,0,0,0,0,0,0,0,0,7,15,1,7,0,2,68,48,44,40,1,0,0,30168021.25
CLAYTON.STONER,20112012,MIN,897.3166666666666,1,1,2,3,4,2,0,0,0,47,103,72,31,14,23,667,919,621,753,27,27,0,30168098.54
CODY.ALMOND,20112012,MIN,102.13333333333333,1,0,0,0,1,1,25,58,33,7,13,15,4,1,5,64,135,63,113,1,6,0.43103448275862066,30168034.259999998
CODY.BASS,20112012,CBJ,127.21666666666667,0,1,0,1,1,1,5,8,3,13,15,22,2,9,7,75,117,70,97,3,3,0.625,30168030.740000002
CODY.EAKIN,20112012,WSH,278.29999999999995,4,1,3,4,8,5,21,40,19,31,51,15,13,5,2,239,234,226,229,12,10,0.525,30168043.515
CODY.FRANSON,20112012,TOR,922.85,5,5,10,15,20,10,0,0,0,65,173,102,78,7,11,946,793,780,740,32,35,0,30168085.47
CODY.GOLOUBEF,20112012,CBJ,6,0,0,0,0,0,0,0,0,0,0,0,1,0,0,0,4,9,4,9,1,0,0,15084010
CODY.HODGSON,20112012,BUF,345.33333333333337,3,4,1,5,8,7,152,296,144,51,81,12,17,4,1,314,331,233,267,8,13,0.5135135135135135,30168055.445
CODY.HODGSON,20112012,VAN,801.9333333333334,16,11,5,16,32,27,177,414,237,103,178,25,39,12,4,790,617,560,547,30,24,0.427536231884058,30168095.275
CODY.MCCORMICK,20112012,BUF,391.5333333333333,1,2,1,3,4,3,8,17,9,43,88,67,23,11,14,359,318,355,313,5,12,0.47058823529411764,30168049.605
CODY.MCLEOD,20112012,COL,539.55,6,1,4,5,11,7,2,3,1,62,105,122,18,24,38,442,466,430,449,16,17,0.6666666666666666,30168072.87
COLBY.ARMSTRONG,20112012,TOR,270.29999999999995,1,0,2,2,3,1,7,18,11,14,26,37,7,6,3,194,250,188,239,4,12,0.3888888888888889,30168045.34
COLBY.ROBAK,20112012,FLA,37.7,0,0,0,0,0,0,0,0,0,1,4,1,3,0,0,28,44,27,42,3,2,0,30168022.1
COLIN.FRASER,20112012,L.A,806.5833333333333,3,2,5,7,10,5,213,457,244,70,129,188,32,27,24,628,719,601,564,17,20,0.4660831509846827,30168086.215
COLIN.GREENING,20112012,OTT,1376.3666666666668,17,13,8,21,38,30,28,63,35,196,313,212,58,14,16,1519,1191,1200,1096,47,51,0.4444444444444444,30168140.11
COLIN.MCDONALD,20112012,PIT,42.35,0,0,0,0,0,0,0,0,0,6,11,8,1,0,0,45,38,42,36,1,1,0,30168021.299999997
COLIN.STUART,20112012,BUF,12.383333333333333,0,0,0,0,0,0,0,0,0,0,0,0,0,0,0,6,15,6,15,0,3,0,30168019.95
COLIN.WHITE,20112012,S.J,848.05,2,1,2,3,5,3,0,0,0,34,74,68,27,3,9,684,805,649,621,21,27,0,30168076.68
COLIN.WILSON,20112012,NSH,1150.5166666666667,16,11,9,20,36,27,41,80,39,121,200,46,39,13,6,1130,912,837,849,38,34,0.5125,30168118.495
COLTEN.TEUBERT,20112012,EDM,303.4,0,1,0,1,1,1,0,0,0,13,33,67,15,4,11,260,306,258,293,8,13,0,30168048.490000002
COLTON.GILLIES,20112012,CBJ,417.51666666666665,2,2,2,4,6,4,4,13,9,24,52,90,12,5,11,268,412,258,376,8,14,0.3076923076923077,30168064.46
COLTON.GILLIES,20112012,MIN,339.05,0,1,1,2,2,1,3,4,1,24,43,71,12,4,5,189,349,180,291,4,10,0.75,30168052.884999998
COLTON.ORR,20112012,TOR,22.4,1,0,0,0,1,1,0,1,1,3,3,7,0,2,1,13,35,13,35,1,0,0,30168023.520000003
COREY.PERRY,20112012,ANA,1710.35,37,19,4,23,60,56,19,48,29,277,466,69,85,46,47,1851,1315,1159,1026,39,48,0.3958333333333333,30168154.619999997
COREY.POTTER,20112012,EDM,1236.75,4,9,7,16,20,13,0,0,0,98,216,90,74,12,11,1103,1061,853,915,32,47,0,30168111.645
COREY.TROPP,20112012,BUF,342.95,3,2,3,5,8,5,0,5,5,30,48,47,9,5,8,282,351,274,341,12,12,0,30168058.725
CORY.EMMERTON,20112012,DET,601.05,7,2,2,4,11,9,159,335,176,65,106,39,20,8,8,466,493,444,441,17,16,0.4746268656716418,30168074.29
CORY.SARICH,20112012,CGY,998.7333333333333,1,2,4,6,7,3,0,0,0,36,107,144,47,13,27,816,871,778,740,28,26,0,30168086.93
CRAIG.ADAMS,20112012,PIT,968.6166666666667,5,8,5,13,18,13,137,301,164,77,133,172,28,12,11,589,950,535,553,21,29,0.45514950166112955,30168087.575
CRAIG.SMITH,20112012,NSH,1038.3166666666666,14,13,10,23,37,27,173,393,220,175,314,49,63,11,12,992,855,719,782,30,36,0.4402035623409669,30168123.03
CURTIS.GLENCROSS,20112012,CGY,1207.1333333333334,26,11,11,22,48,37,41,82,41,110,177,81,39,16,23,989,1190,733,862,36,43,0.5,30168135.225
DAINIUS.ZUBRUS,20112012,N.J,1967.2833333333333,20,20,14,34,54,40,220,498,278,149,232,187,35,19,23,1513,1445,1174,1039,56,47,0.44176706827309237,30168150.34
DALE.WEISE,20112012,VAN,563.35,4,3,0,3,7,7,1,5,4,49,84,122,20,19,20,416,532,408,525,13,14,0.2,30168081.68
DALTON.PROUT,20112012,CBJ,58.96666666666667,0,0,0,0,0,0,0,0,0,2,4,5,1,0,0,49,59,48,58,2,2,0,30168023.950000003
DAN.BOYLE,20112012,S.J,2214.133333333333,9,14,27,41,50,23,0,0,0,261,548,65,182,16,20,2549,1889,1629,1509,65,55,0,30168158.085
DAN.CARCILLO,20112012,CHI,319.2,2,5,4,9,11,7,2,4,2,27,55,76,13,13,24,304,240,285,237,16,8,0.5,30168044.560000002
DAN.GIRARDI,20112012,NYR,2689.5333333333338,8,15,16,31,39,23,0,0,0,157,337,263,112,13,12,2251,2681,1773,1859,72,64,0,30168205.43
DAN.HAMHUIS,20112012,VAN,2043.1333333333332,4,18,15,33,37,22,0,0,0,154,363,114,135,12,18,1962,1786,1492,1217,72,45,0,30168119.245
DANA.TYRELL,20112012,T.B,273.3833333333333,0,3,2,5,5,3,0,3,3,23,41,20,8,5,3,186,287,176,210,6,11,0,30168042.200000003
DANE.BYERS,20112012,CBJ,64.7,0,0,0,0,0,0,0,0,0,8,8,4,0,5,6,44,59,41,49,1,1,0,30168024.5
DANIEL.ALFREDSSON,20112012,OTT,1492.65,29,21,11,32,61,50,21,50,29,206,357,56,78,15,9,1694,1158,1140,908,46,38,0.42,30168124.315
DANIEL.PAILLE,20112012,BOS,860.7166666666667,10,4,2,6,16,14,4,10,6,94,148,70,25,9,6,651,881,617,715,22,30,0.4,30168102.65
DANIEL.SEDIN,20112012,VAN,1394.9166666666665,30,23,16,39,69,53,6,19,13,233,429,22,92,12,20,1789,903,1128,801,50,35,0.3157894736842105,30168110.66
DANIEL.WINNIK,20112012,COL,1115.3333333333335,5,6,7,13,18,11,22,47,25,155,249,63,42,14,19,940,1047,824,736,22,33,0.46808510638297873,30168096.695
DANIEL.WINNIK,20112012,S.J,349,3,2,1,3,6,5,12,22,10,32,69,37,22,5,8,322,342,316,295,8,7,0.5454545454545454,30168048.455
DANNY.BRIERE,20112012,PHI,1410.1833333333334,24,25,13,38,62,49,485,960,475,200,348,71,88,30,28,1530,1224,1008,1078,47,47,0.5052083333333334,30168173.975
DANNY.CLEARY,20112012,DET,1274.5166666666667,12,11,10,21,33,23,21,55,34,209,324,101,52,17,15,1255,1117,1003,813,39,36,0.38181818181818183,30168105.71
DANY.HEATLEY,20112012,MIN,1715.7833333333333,24,16,12,28,52,40,36,67,31,238,433,70,103,13,14,1749,1500,1136,1279,42,42,0.5373134328358209,30168173.119999997
DARCY.HORDICHUK,20112012,EDM,187.05,1,2,0,2,3,3,0,1,1,27,37,67,6,16,15,116,152,116,151,3,6,0,30168039.11
DARREN.HELM,20112012,DET,989.9833333333333,9,10,6,16,25,19,405,780,375,124,248,98,74,30,6,863,903,792,639,34,27,0.5192307692307693,30168092.4
DARROLL.POWE,20112012,MIN,1146.6666666666667,6,5,2,7,13,11,46,105,59,109,189,151,33,20,23,723,1340,686,965,21,37,0.4380952380952381,30168139.04
DARRYL.BOYCE,20112012,CBJ,198.28333333333333,0,2,1,3,3,2,76,148,72,13,23,20,7,10,7,109,205,101,172,3,8,0.5135135135135135,30168043.064999998
DARRYL.BOYCE,20112012,TOR,171.05,1,1,0,1,2,2,8,15,7,12,32,26,11,6,4,128,168,123,137,3,6,0.5333333333333333,30168033.08
DAVE.BOLLAND,20112012,CHI,1371.0666666666666,19,14,7,21,40,33,628,1307,679,149,243,61,55,12,23,1205,1208,877,856,35,50,0.48048967100229534,30168149.265
DAVID.BACKES,20112012,STL,1822.6666666666667,26,19,12,31,57,45,747,1507,760,245,416,253,74,39,44,1834,1525,1283,1112,47,36,0.49568679495686796,30168181.82
DAVID.BOOTH,20112012,FLA,93.01666666666667,0,0,1,1,1,0,0,0,0,14,18,12,2,3,1,89,66,52,61,0,5,0,30168025.205
DAVID.BOOTH,20112012,VAN,913.2833333333333,16,7,7,14,30,23,10,19,9,152,262,81,68,15,12,1045,680,877,631,26,26,0.5263157894736842,30168080.175
DAVID.CLARKSON,20112012,N.J,1665.4333333333334,33,12,13,25,58,45,117,283,166,269,425,241,73,48,45,1530,1041,1045,939,49,38,0.4134275618374558,30168146.785
DAVID.DESHARNAIS,20112012,MTL,1490.1666666666665,16,26,18,44,60,42,678,1371,693,96,160,33,35,17,12,1573,1266,1033,1079,58,43,0.49452954048140046,30168175.740000002
DAVID.JONES,20112012,COL,1133.9666666666667,20,11,6,17,37,31,16,34,18,136,247,85,52,8,12,1117,1012,819,875,32,39,0.47058823529411764,30168125.62
DAVID.KREJCI,20112012,BOS,1605.7833333333333,24,23,18,41,65,47,594,1158,564,156,277,78,60,18,20,1790,1306,1312,1112,61,64,0.5129533678756477,30168165.09
DAVID.LEGWAND,20112012,NSH,1631.2666666666667,22,26,11,37,59,48,576,1238,662,164,254,47,47,16,17,1514,1393,1146,1097,51,49,0.46526655896607433,30168179.325
DAVID.MCINTYRE,20112012,MIN,76.4,1,0,1,1,2,1,2,7,5,6,13,8,4,0,1,55,91,53,81,2,3,0.2857142857142857,30168028.055
DAVID.MOSS,20112012,CGY,448.45,2,3,4,7,9,5,93,219,126,82,136,43,26,5,6,420,421,358,314,9,14,0.4246575342465753,30168055.72
DAVID.PERRON,20112012,STL,1196.2166666666667,22,13,12,25,47,35,2,12,10,130,236,46,45,20,18,1226,945,803,801,43,28,0.16666666666666666,30168118.130000003
DAVID.RUNDBLAD,20112012,ARI,84.69999999999999,0,2,1,3,3,2,0,0,0,8,20,11,10,0,0,93,69,71,62,4,4,0,30168023.225
DAVID.RUNDBLAD,20112012,OTT,365.58333333333337,1,1,2,3,4,2,0,0,0,26,67,23,28,2,3,428,281,310,255,9,19,0,30168038.369999997
DAVID.SAVARD,20112012,CBJ,513.8166666666666,2,2,6,8,10,4,0,0,0,34,70,30,26,2,8,478,397,349,365,15,14,0,30168055.02
DAVID.SCHLEMKO,20112012,ARI,925.2666666666667,1,3,6,9,10,4,0,0,0,64,133,56,46,6,5,782,1031,708,817,34,32,0,30168099.96
DAVID.STECKEL,20112012,TOR,974.9166666666667,8,2,3,5,13,10,643,1108,465,79,143,170,33,8,5,718,1002,630,673,17,32,0.58032490974729245,30168108.475
DAVID.ULLSTROM,20112012,NYI,318.28333333333336,4,1,2,3,7,5,6,10,4,40,67,32,17,2,4,274,263,238,250,11,13,0.6,30168045.66
DAVID.VAN DER GULIK,20112012,COL,205.06666666666666,1,3,2,5,6,4,11,38,27,20,33,32,6,3,1,146,180,139,143,11,7,0.2894736842105263,30168034.869999997
DAVIS.DREWISKE,20112012,L.A,113.08333333333333,2,0,0,0,2,2,0,0,0,11,22,5,9,1,1,105,87,102,79,2,2,0,30168025.21
DAYMOND.LANGKOW,20112012,ARI,1396.4333333333334,12,12,12,24,36,24,522,1188,666,129,231,121,41,9,8,1274,1222,1009,993,47,46,0.4393939393939394,30168155.02
DENNIS.SEIDENBERG,20112012,BOS,2110.133333333333,6,8,12,20,26,14,0,0,0,191,384,183,125,8,20,2132,1861,1589,1330,63,58,0,30168131.979999997
DENNIS.WIDEMAN,20112012,WSH,2249.866666666667,11,22,15,37,48,33,0,0,0,198,422,131,123,13,25,2108,2058,1503,1584,59,67,0,30168187.854999997
DEREK.DORSETT,20112012,CBJ,1131.4,12,6,2,8,20,18,14,27,13,136,206,199,33,49,62,811,1059,663,792,23,32,0.5185185185185185,30168124.2
DEREK.JOSLIN,20112012,CAR,465.6166666666667,2,2,0,2,4,4,1,1,0,36,78,47,24,9,9,408,493,357,444,10,25,1,30168067.380000003
DEREK.MACKENZIE,20112012,CBJ,693.0666666666666,7,3,4,7,14,10,234,429,195,61,94,189,15,19,12,429,625,389,459,14,15,0.5454545454545454,30168082.35
DEREK.MEECH,20112012,WPG,22.883333333333333,0,0,0,0,0,0,0,0,0,2,4,1,1,0,2,26,17,23,17,1,0,0,15084010.5
DEREK.MORRIS,20112012,ARI,1485.4666666666667,4,4,6,10,14,8,0,0,0,97,204,139,65,6,31,1191,1677,1038,1201,42,48,0,30168145.21
DEREK.ROY,20112012,BUF,1545.9499999999998,17,11,16,27,44,28,671,1327,656,176,326,35,94,20,27,1537,1364,1038,1018,46,44,0.5056518462697814,30168156.09
DEREK.SMITH,20112012,CGY,748.9833333333333,2,5,2,7,9,7,0,0,0,44,107,27,26,7,6,659,647,551,605,22,25,0,30168081.47
DEREK.STEPAN,20112012,NYR,1935.7833333333333,18,25,17,42,60,43,489,1101,612,207,360,177,82,10,11,1807,1632,1161,1258,55,41,0.444141689373297,30168193.535
DEREK.WHITMORE,20112012,BUF,25.033333333333335,0,0,0,0,0,0,0,0,0,2,5,3,2,1,0,27,14,26,12,0,0,0,15084009.31
DERICK.BRASSARD,20112012,CBJ,1208.9166666666665,14,16,11,27,41,30,278,617,339,125,233,137,77,26,19,1232,975,777,873,34,43,0.4505672609400324,30168136.405
DERYK.ENGELLAND,20112012,PIT,1247.8166666666666,4,6,8,14,18,10,0,0,0,87,196,188,68,16,19,1129,1147,1088,1002,50,41,0,30168110.259999998
DEVANTE.SMITH-PELLY,20112012,ANA,590.15,7,3,3,6,13,10,6,21,15,66,118,103,23,6,7,454,602,393,480,14,21,0.2857142857142857,30168076.674999997
DEVIN.SETOGUCHI,20112012,MIN,1214.0666666666666,19,7,10,17,36,26,3,11,8,174,307,73,78,21,13,1181,973,810,862,26,41,0.2727272727272727,30168120.33
DION.PHANEUF,20112012,TOR,2073.7166666666667,12,14,16,30,42,26,0,0,0,202,424,214,131,28,36,2017,1924,1397,1408,53,64,0,30168164.83
DJ.KING,20112012,WSH,6.966666666666667,0,0,0,0,0,0,0,0,0,1,1,2,0,0,0,5,7,5,7,0,0,0,15084009.85
DMITRY.KULIKOV,20112012,FLA,1416.5,4,13,10,23,27,17,0,0,0,119,264,124,82,13,20,1262,1183,914,1001,37,43,0,30168124.380000003
DMITRY.ORLOV,20112012,WSH,1012.4833333333333,3,7,9,16,19,10,0,1,1,51,112,99,34,6,5,893,894,796,802,33,30,0,30168098.485
DOMINIC.MOORE,20112012,S.J,361,0,3,3,6,6,3,116,221,105,34,69,17,17,5,4,334,361,292,302,7,16,0.5248868778280543,30168053.415
DOMINIC.MOORE,20112012,T.B,911.5666666666666,4,9,6,15,19,13,319,573,254,74,140,37,40,19,24,695,892,571,644,19,29,0.5567190226876091,30168102.4
DOUG.JANIK,20112012,DET,130.51666666666665,0,1,0,1,1,1,0,0,0,6,25,7,10,1,3,121,100,116,91,7,5,0,30168024.61
DOUGLAS.MURRAY,20112012,S.J,1184.0500000000002,0,3,0,3,3,3,0,0,0,72,144,136,46,9,18,959,1303,899,1030,28,28,0,30168124.490000002
DRAYSON.BOWMAN,20112012,CAR,494.05,6,4,3,7,13,10,0,0,0,70,124,54,35,5,2,498,445,435,421,18,17,0,30168061.925
DREW.DOUGHTY,20112012,L.A,2440.2,14,21,17,38,52,35,0,0,0,212,455,168,147,28,36,2508,1920,1680,1386,59,51,0,30168149.905
DREW.MILLER,20112012,DET,1087.5333333333333,14,8,4,12,26,22,5,26,21,140,205,81,34,11,10,868,1005,831,700,37,31,0.19230769230769232,30168094.91
DREW.STAFFORD,20112012,BUF,1411.8333333333335,20,25,5,30,50,45,45,86,41,225,376,101,81,17,25,1404,1249,1026,1033,48,39,0.5232558139534884,30168147.195
DUNCAN.KEITH,20112012,CHI,2171.75,4,17,20,37,41,21,0,0,0,178,429,51,153,9,17,2173,1918,1615,1424,70,70,0,30168142.59
DUSTIN.BROWN,20112012,L.A,2068.4833333333336,30,27,17,44,74,57,26,59,33,273,498,386,115,74,38,2324,1597,1559,1210,64,41,0.4406779661016949,30168153.305
DUSTIN.BYFUGLIEN,20112012,WPG,1589.7,12,19,21,40,52,31,0,0,0,223,479,112,128,7,30,1788,1283,1271,1107,55,61,0,30168129.195
DUSTIN.JEFFREY,20112012,PIT,314.8,4,1,1,2,6,5,109,225,116,33,61,19,16,1,1,288,248,247,220,7,12,0.48444444444444446,30168045.145
DUSTIN.PENNER,20112012,L.A,1195.4333333333334,10,15,3,18,28,25,14,33,19,156,272,125,48,14,28,1217,935,1011,881,31,33,0.42424242424242425,30168116.175
DWIGHT.KING,20112012,L.A,653.0999999999999,10,8,4,12,22,18,2,3,1,75,118,74,13,2,9,678,493,564,473,20,15,0.6666666666666666,30168072.65
DYLAN.OLSEN,20112012,CHI,369.70000000000005,0,0,1,1,1,0,0,0,0,17,39,43,15,2,3,295,345,285,292,9,14,0,30168045.345
DYLAN.REESE,20112012,NYI,478.3833333333333,1,2,4,6,7,3,0,0,0,26,65,22,23,2,4,424,426,396,386,20,20,0,30168053.67
ED.JOVANOVSKI,20112012,FLA,1225.6833333333334,3,5,3,8,11,8,0,0,0,65,137,90,46,13,16,997,1102,775,860,29,39,0,30168107.854999997
ERIC.BELANGER,20112012,EDM,1149.2333333333333,4,7,5,12,16,11,557,1007,450,118,217,36,53,10,15,864,1183,692,815,21,33,0.5531281032770605,30168126.755
ERIC.BOULTON,20112012,N.J,335.83333333333337,0,0,0,0,0,0,1,3,2,25,38,89,7,16,29,173,299,171,293,0,12,0.3333333333333333,30168058.2
ERIC.BREWER,20112012,T.B,1907.9833333333333,1,8,10,18,19,9,0,0,0,83,221,197,87,6,23,1439,2049,1191,1432,65,72,0,30168163.96
ERIC.FEHR,20112012,WPG,339.48333333333335,2,0,1,1,3,2,0,0,0,54,90,22,19,3,6,305,284,284,279,4,9,0,30168047.305
ERIC.NYSTROM,20112012,DAL,1016.6333333333332,16,3,2,5,21,19,13,28,15,102,187,176,42,14,9,806,1040,761,854,27,37,0.4642857142857143,30168117.909999996
ERIC.STAAL,20112012,CAR,1766.85,24,31,15,46,70,55,882,1681,799,262,476,48,114,36,23,1908,1667,1261,1260,51,65,0.5246876859012493,30168202.215
ERIC.TANGRADI,20112012,PIT,230.78333333333336,0,2,1,3,3,2,0,2,2,23,44,46,10,4,5,227,160,193,153,9,10,0,30168031.665
ERIC.WELLWOOD,20112012,PHI,391.65,5,2,2,4,9,7,18,38,20,49,79,29,11,5,2,297,380,273,309,17,8,0.47368421052631576,30168054.869999997
ERIK.CHRISTENSEN,20112012,MIN,347.48333333333335,6,0,1,1,7,6,98,188,90,34,68,14,22,2,4,275,319,197,290,4,17,0.5212765957446809,30168057.865000002
ERIK.CHRISTENSEN,20112012,NYR,162.43333333333334,1,3,1,4,5,4,61,114,53,10,21,12,5,1,1,142,138,100,130,4,4,0.5350877192982456,30168036.275
ERIK.COLE,20112012,MTL,1519.4333333333334,35,15,11,26,61,50,24,56,32,241,408,186,99,31,25,1685,1234,1118,1073,57,43,0.42857142857142855,30168150.695
ERIK.CONDRA,20112012,OTT,1229.0833333333335,9,11,6,17,26,20,11,27,16,150,259,17,54,13,15,1084,1243,979,812,34,30,0.4074074074074074,30168101.02
ERIK.GUDBRANSON,20112012,FLA,1142.0166666666667,2,4,2,6,8,6,0,0,0,81,176,176,53,24,30,943,1038,877,940,27,44,0,30168115.689999998
ERIK.GUSTAFSSON,20112012,PHI,610.45,2,4,1,5,7,6,0,0,0,27,75,12,30,4,2,525,582,493,529,31,17,0,30168068.915
ERIK.JOHNSON,20112012,COL,1521.4,4,13,9,22,26,17,0,0,0,155,308,123,100,13,10,1597,1341,1178,1049,46,47,0,30168114.555
ERIK.KARLSSON,20112012,OTT,2228.2166666666667,20,36,22,58,78,56,0,1,1,292,669,76,250,22,23,2707,1795,1888,1539,84,71,0,30168158.12
ETHAN.MOREAU,20112012,L.A,294.76666666666665,1,2,1,3,4,3,2,5,3,29,53,53,16,2,10,229,271,209,246,4,6,0.4,30168046.424999997
EVAN.BROPHEY,20112012,COL,12.533333333333335,0,0,0,0,0,0,3,5,2,0,0,4,0,1,0,9,10,9,10,1,1,0.6,30168018.98
EVAN.OBERG,20112012,T.B,29.5,0,0,0,0,0,0,0,0,0,3,4,3,1,1,0,26,17,24,17,2,0,0,30168019.060000002
EVANDER.KANE,20112012,WPG,1296.2666666666669,30,16,11,27,57,46,15,44,29,287,461,172,76,28,23,1406,1066,1051,959,53,44,0.3409090909090909,30168139.955
EVGENI.MALKIN,20112012,PIT,1708.6,53,47,17,64,117,100,623,1301,678,363,662,32,164,49,37,2336,1213,1371,1027,78,50,0.47886241352805536,30168183.285
EVGENY.DADONOV,20112012,FLA,150.73333333333332,2,1,0,1,3,3,0,6,6,21,29,13,1,1,1,147,122,141,119,5,8,0,30168031.36
EVGENY.GRACHEV,20112012,STL,242.68333333333334,1,1,1,2,3,2,1,5,4,14,23,23,4,3,1,181,195,172,189,6,10,0.2,30168038.645
FABIAN.BRUNNSTROM,20112012,DET,45.31666666666666,0,0,1,1,1,0,0,0,0,6,11,4,4,1,2,52,26,46,26,1,3,0,30168019.535
FEDOR.TYUTIN,20112012,CBJ,1593.4166666666665,5,8,12,20,25,13,0,0,0,124,246,100,83,14,23,1450,1315,971,933,38,50,0,30168109.840000004
FILIP.KUBA,20112012,OTT,1887.7833333333333,6,9,19,28,34,15,0,0,0,88,217,58,88,5,18,1841,1870,1415,1299,69,52,0,30168136.275
FRANCIS.BOUILLON,20112012,NSH,1307.6833333333334,4,3,7,10,14,7,0,0,0,46,130,125,58,18,16,1031,1278,959,1115,54,51,0,30168130.355
FRANCIS.WATHIER,20112012,DAL,5.416666666666667,0,0,0,0,0,0,0,0,0,0,0,3,0,0,0,4,5,4,5,0,0,0,15084009.55
FRANCOIS.BEAUCHEMIN,20112012,ANA,2095.383333333333,8,7,7,14,22,15,1,2,1,139,285,153,87,13,17,1702,2041,1336,1325,48,66,0.5,30168149.345
FRANS.NIELSEN,20112012,NYI,1431.1166666666666,17,13,17,30,47,30,523,1155,632,133,232,28,51,9,3,1317,1286,881,911,40,38,0.45281385281385284,30168150.835
FRAZER.MCLAREN,20112012,S.J,34.15,0,0,0,0,0,0,0,0,0,2,5,6,1,2,3,24,33,24,33,1,1,0,30168022.02
FRÉDÉRIC.ST-DENIS,20112012,MTL,246.85000000000002,1,1,1,2,3,2,0,0,0,11,26,7,12,1,5,205,226,180,181,7,5,0,30168035.935000002
GABRIEL.BOURQUE,20112012,NSH,679.8666666666667,10,6,7,13,23,16,1,6,5,72,119,87,27,5,6,610,614,600,599,29,31,0.16666666666666666,30168085.064999998
GABRIEL.DUMONT,20112012,MTL,25.683333333333334,0,0,0,0,0,0,3,18,15,1,1,7,0,1,0,23,16,23,12,0,1,0.16666666666666666,30168019.43
GABRIEL.LANDESKOG,20112012,COL,1526.1833333333334,22,15,14,29,51,37,8,36,28,270,406,219,70,16,23,1632,1227,1226,977,51,35,0.2222222222222222,30168128.23
GEORGE.PARROS,20112012,ANA,293.43333333333334,1,3,0,3,4,4,0,0,0,17,29,57,5,16,21,202,275,201,272,6,5,0,30168053.61
GILBERT.BRULE,20112012,ARI,476.6166666666667,7,6,4,10,17,13,11,25,14,68,108,77,15,8,4,448,424,397,404,26,18,0.44,30168065.77
GRANT.CLITSOME,20112012,CBJ,868.3666666666667,4,3,6,9,13,7,0,1,1,74,154,59,46,5,11,771,677,545,582,18,21,0,30168078.8
GRANT.CLITSOME,20112012,WPG,202.83333333333331,0,1,1,2,2,1,0,0,0,13,31,26,9,1,4,163,198,148,166,5,8,0,30168035.285
GREG.NEMISZ,20112012,CGY,69.38333333333333,0,0,0,0,0,0,19,48,29,2,7,3,0,2,0,54,51,53,51,3,2,0.3958333333333333,30168023.93
GREG.RALLO,20112012,FLA,3.5166666666666666,0,0,0,0,0,0,0,0,0,1,1,0,0,0,0,2,1,2,1,0,0,0,15084009.1
GREG.ZANON,20112012,BOS,366.43333333333334,1,1,1,2,3,2,0,0,0,17,49,54,15,0,2,321,291,307,252,17,13,0,30168038.125
GREG.ZANON,20112012,MIN,726.2666666666667,2,0,2,2,4,2,0,0,0,27,57,77,21,2,8,549,776,512,606,21,22,0,30168081.12
GREGORY.CAMPBELL,20112012,BOS,1074.2333333333333,8,2,8,10,18,10,367,735,368,81,140,122,28,19,20,767,1118,711,834,26,33,0.4993197278911565,30168128.72
GUILLAUME.DESBIENS,20112012,CGY,71.08333333333334,0,0,0,0,0,0,1,2,1,2,8,16,3,6,5,40,54,40,54,0,1,0.5,30168024.6
GUILLAUME.LATENDRESSE,20112012,MIN,243.05,5,3,1,4,9,8,2,4,2,36,61,37,9,5,10,233,227,159,204,8,4,0.5,30168046.755000003
GUSTAV.NYQUIST,20112012,DET,226.16666666666666,1,4,2,6,7,5,0,0,0,20,39,8,8,1,1,221,142,213,141,8,6,0,30168030.310000002
HAL.GILL,20112012,MTL,887.2166666666667,1,2,5,7,8,3,0,0,0,33,78,48,31,10,12,616,989,551,618,21,30,0,30168081.075000003
HAL.GILL,20112012,NSH,490.71666666666664,0,1,4,5,5,1,0,0,0,19,37,34,12,0,4,338,496,331,390,21,16,0,30168057.4
HARRY.ZOLNIERCZYK,20112012,PHI,285.06666666666666,3,2,1,3,6,5,12,28,16,49,81,67,14,16,13,238,260,231,240,8,19,0.42857142857142855,30168047.665
HENRIK.SEDIN,20112012,VAN,1671.9499999999998,16,46,24,70,86,62,682,1378,696,126,224,35,53,23,27,2147,1109,1345,981,65,38,0.4949201741654572,30168157.060000002
HENRIK.TALLINDER,20112012,N.J,888.85,0,5,1,6,6,5,0,0,0,46,101,36,31,5,8,679,764,570,567,19,30,0,30168073.425
HENRIK.ZETTERBERG,20112012,DET,1742.25,24,31,17,48,72,55,584,1194,610,290,519,49,128,21,19,1923,1278,1273,969,68,51,0.48911222780569513,30168147.645
IAN.COLE,20112012,STL,434.4666666666667,1,0,4,4,5,1,0,0,0,19,54,20,19,8,11,414,349,380,312,14,10,0,30168044.53
IAN.WHITE,20112012,DET,1862.4666666666667,8,10,13,23,31,18,0,0,0,201,427,60,132,11,11,1971,1344,1417,1095,76,48,0,30168104.085
ILYA.KOVALCHUK,20112012,N.J,2404.6833333333334,45,31,26,57,102,76,15,43,28,379,725,47,190,17,18,2318,1681,1430,1328,61,64,0.3488372093023256,30168181.62
J-F.JACQUES,20112012,ANA,39.733333333333334,0,0,0,0,0,0,0,0,0,7,12,6,0,1,3,31,41,30,37,1,0,0,30168022.71
J.T..BROWN,20112012,T.B,69.28333333333333,0,0,1,1,1,0,0,0,0,13,24,2,10,2,0,76,60,70,54,3,1,0,30168021.395
JACK.HILLEN,20112012,NSH,789.2666666666667,2,2,2,4,6,4,0,0,0,52,115,42,40,6,11,617,811,587,713,30,22,0,30168092.06
JACK.JOHNSON,20112012,CBJ,575.8499999999999,4,4,6,10,14,8,0,0,0,56,93,35,21,3,6,512,584,307,415,17,14,0,30168068.38
JACK.JOHNSON,20112012,L.A,1373.3,8,9,7,16,24,17,0,0,0,120,257,72,81,8,12,1416,1174,914,921,26,36,0,30168113.355
JACK.SKILLE,20112012,FLA,550.4333333333334,4,6,0,6,10,10,8,16,8,76,134,99,29,15,13,457,527,440,495,11,21,0.5,30168076.57
JACOB.JOSEFSON,20112012,N.J,578.1166666666667,2,4,4,8,10,6,222,432,210,45,70,19,9,7,3,436,436,406,358,16,6,0.5138888888888888,30168062.6
JADEN.SCHWARTZ,20112012,STL,81.81666666666666,2,0,1,1,3,2,1,2,1,6,9,1,2,1,0,62,68,47,66,2,2,0.5,30168026.775
JAKE.DOWELL,20112012,DAL,396.91666666666663,2,4,1,5,7,6,93,196,103,39,69,80,16,11,12,376,342,363,295,9,13,0.4744897959183674,30168052.105
JAKE.GARDINER,20112012,TOR,1618.85,7,13,10,23,30,20,0,0,0,79,207,52,73,11,9,1576,1568,1257,1261,61,60,0,30168142.41
JAKOB.SILFVERBERG,20112012,OTT,18.35,0,0,0,0,0,0,0,2,2,1,5,1,3,0,1,20,19,19,19,0,0,0,30168019.75
JAKUB.KINDL,20112012,DET,772.95,1,7,4,11,12,8,0,0,0,69,119,61,29,9,11,734,590,650,555,28,20,0,30168070.240000002
JAKUB.VORACEK,20112012,PHI,1446.2666666666667,20,26,13,39,59,46,11,29,18,209,383,57,107,21,20,1703,1124,1027,958,55,41,0.3793103448275862,30168129.775
JAMAL.MAYERS,20112012,CHI,820.1500000000001,6,6,3,9,15,12,320,578,258,73,125,106,18,22,21,599,792,550,588,18,22,0.5536332179930796,30168097.744999997
JAMES.NEAL,20112012,PIT,1628.3166666666666,42,24,21,45,87,66,4,15,11,357,646,119,159,36,40,2228,1165,1352,1015,69,53,0.26666666666666666,30168137.345
JAMES.VAN RIEMSDYK,20112012,PHI,748.6666666666666,12,11,3,14,26,23,3,6,3,130,221,48,52,11,13,847,616,584,545,26,26,0.5,30168082.205
JAMES.WISNIEWSKI,20112012,CBJ,1190.25,6,10,11,21,27,16,0,1,1,99,215,50,61,15,17,1105,1063,711,834,28,39,0,30168112.425
JAMES.WYMAN,20112012,T.B,12,0,0,0,0,0,0,0,0,0,2,2,2,0,0,0,8,12,8,12,0,0,0,30168019.5
JAMIE.BENN,20112012,DAL,1283.3166666666666,26,16,20,36,62,42,347,751,404,203,366,136,82,25,25,1330,1080,992,898,53,42,0.4620505992010652,30168142.229999997
JAMIE.LANGENBRUNNER,20112012,STL,1108.9833333333333,7,11,7,18,25,18,13,33,20,135,218,78,50,13,20,1072,898,935,755,30,28,0.3939393939393939,30168094.725
JAMIE.MCBAIN,20112012,CAR,1503.75,8,11,8,19,27,19,0,0,0,127,292,15,108,7,2,1602,1431,1159,1215,49,54,0,30168137.72
JAMIE.MCGINN,20112012,COL,283.28333333333336,8,3,2,5,13,11,4,4,0,55,84,21,11,4,4,312,234,223,203,10,13,1,30168044.9
JAMIE.MCGINN,20112012,S.J,765.5666666666666,12,8,4,12,24,20,2,3,1,104,173,137,29,11,11,698,711,622,675,30,30,0.6666666666666666,30168099.39
JAN.HEJDA,20112012,COL,1675.3000000000002,5,6,7,13,18,11,1,1,0,78,207,142,74,9,11,1283,1722,1131,1268,35,53,1,30168148.255
JAN.MURSAK,20112012,DET,188.91666666666666,1,0,2,2,3,1,1,3,2,22,39,21,8,2,0,153,149,150,149,4,2,0.3333333333333333,30168033.11
JANNIK.HANSEN,20112012,VAN,1303.6999999999998,17,17,6,23,40,34,13,29,16,144,252,124,52,22,17,1093,1283,1012,943,47,35,0.4482758620689655,30168126.34
JARED.BOLL,20112012,CBJ,438.3,2,1,0,1,3,3,3,5,2,35,65,96,11,29,31,308,374,301,369,6,14,0.6,30168064.46
JARED.COWEN,20112012,OTT,1668.3833333333332,5,4,7,11,16,9,0,0,0,66,158,245,69,10,22,1404,1638,1228,1116,45,56,0,30168119.825000003
JARED.SPURGEON,20112012,MIN,1511.9499999999998,3,10,10,20,23,13,0,0,0,92,191,36,55,12,3,1282,1407,885,1077,29,30,0,30168136.22
JAROD.PALMER,20112012,MIN,80.03333333333333,1,0,0,0,1,1,1,2,1,14,19,3,3,0,1,74,67,65,64,2,3,0.5,30168025.189999998
JAROME.IGINLA,20112012,CGY,1689.8333333333333,32,25,10,35,67,57,214,426,212,251,451,124,104,19,17,1618,1554,1092,1349,56,56,0.5023474178403756,30168202.4
JAROMIR.JAGR,20112012,PHI,1357.2166666666667,20,24,18,42,62,44,0,2,2,195,373,15,88,18,16,1547,1001,1021,886,47,41,0,30168120.58
JAROSLAV.SPACEK,20112012,CAR,553.9666666666667,5,4,3,7,12,9,0,0,0,37,87,17,35,4,3,639,501,490,432,23,17,0,30168057.865000002
JAROSLAV.SPACEK,20112012,MTL,185.88333333333333,0,3,0,3,3,3,0,0,0,5,14,12,5,1,1,158,195,133,160,4,3,0,30168036.06
JARRET.STOLL,20112012,L.A,1642.9499999999998,8,9,9,18,26,17,834,1535,701,166,310,237,71,13,39,1497,1355,1044,886,28,25,0.5433224755700325,30168136.064999998
JASON.ARNOTT,20112012,STL,1090.6333333333332,18,9,8,17,35,27,403,810,407,153,251,29,44,15,13,1207,789,840,738,35,21,0.49753086419753084,30168119.07
JASON.BLAKE,20112012,ANA,636.4166666666667,7,3,2,5,12,10,0,1,1,109,179,41,28,8,3,642,504,513,479,14,18,0,30168070.630000003
JASON.CHIMERA,20112012,WSH,1375.3,24,12,10,22,46,36,38,72,34,233,333,157,49,26,30,1242,1246,1069,1052,47,41,0.5277777777777778,30168149.83
JASON.DEMERS,20112012,S.J,1006.4666666666666,4,1,6,7,11,5,0,0,0,75,162,62,52,11,11,1071,860,787,787,28,34,0,30168094.009999998
JASON.GARRISON,20112012,FLA,1925.5833333333335,17,7,9,16,33,24,1,2,1,180,373,139,110,8,17,1762,1638,1285,1162,42,42,0.5,30168133.345
JASON.JAFFRAY,20112012,WPG,84.55,0,0,1,1,1,0,8,15,7,10,12,16,2,3,2,79,74,75,73,1,2,0.5333333333333333,30168025.925
JASON.POMINVILLE,20112012,BUF,1613.75,30,26,16,42,72,56,179,375,196,235,407,30,90,20,6,1587,1436,958,1021,49,48,0.47733333333333333,30168159.76
JASON.SPEZZA,20112012,OTT,1740.5833333333335,37,29,23,52,89,66,972,1816,844,253,494,36,123,17,21,2128,1448,1417,1220,66,56,0.5352422907488987,30168193.825
JASON.WILLIAMS,20112012,PIT,84.58333333333333,1,0,1,1,2,1,0,1,1,4,13,1,3,0,2,88,68,55,62,1,0,0,30168025.275
JASON.ZUCKER,20112012,MIN,66.15,0,2,0,2,2,2,0,0,0,10,16,5,4,2,1,45,73,40,71,2,4,0,30168027.520000003
JAY.BEAGLE,20112012,WSH,707.1833333333333,5,0,2,2,7,5,210,375,165,62,97,91,16,5,11,474,728,443,552,13,13,0.56,30168088.9
JAY.BOUWMEESTER,20112012,CGY,2128.5166666666664,5,13,10,23,28,18,0,0,0,107,240,68,76,14,12,1669,2159,1267,1496,46,59,0,30168179.439999998
JAY.HARRISON,20112012,CAR,1479.0166666666667,9,8,6,14,23,17,0,0,0,128,291,117,104,15,23,1391,1519,1096,1175,37,46,0,30168139.45
JAY.MCCLEMENT,20112012,COL,1100.2166666666667,10,4,3,7,17,14,447,871,424,95,169,72,40,11,13,741,1152,667,737,24,35,0.513203214695752,30168118.564999998
JAY.PANDOLFO,20112012,NYI,677.2,1,1,0,1,2,2,61,136,75,44,70,48,11,5,4,400,796,376,567,5,19,0.4485294117647059,30168089.09
JAY.ROSEHILL,20112012,TOR,183.16666666666669,0,0,0,0,0,0,1,4,3,15,21,53,6,8,15,121,160,120,159,1,5,0.25,30168038.02
JED.ORTMEYER,20112012,MIN,340.15,1,0,1,1,2,1,4,9,5,41,79,53,16,8,6,229,368,221,317,4,12,0.4444444444444444,30168055.515
JEFF.CARTER,20112012,CBJ,765.4166666666666,15,5,4,9,24,20,377,739,362,130,220,8,37,5,7,802,646,494,552,21,30,0.510148849797023,30168102.880000003
JEFF.CARTER,20112012,L.A,650.4166666666667,14,4,4,8,22,18,46,91,45,108,200,30,45,6,2,654,565,422,449,15,18,0.5054945054945055,30168075.1
JEFF.HALPERN,20112012,WSH,886.0666666666666,4,7,5,12,16,11,375,643,268,64,106,56,23,11,12,651,849,603,612,20,20,0.583203732503888,30168094.985
JEFF.PETRY,20112012,EDM,1588.5166666666669,2,15,7,22,24,17,0,0,0,111,239,126,77,11,13,1328,1529,1106,1143,50,53,0,30168132.885
JEFF.SCHULTZ,20112012,WSH,980.8166666666667,1,3,2,5,6,4,0,0,0,23,69,54,30,1,7,752,1009,726,834,23,32,0,30168103.560000002
JEFF.SKINNER,20112012,CAR,1191.9833333333333,20,17,7,24,44,37,67,159,92,209,371,44,85,49,23,1293,1008,864,861,40,40,0.42138364779874216,30168127.395
JEFF.TAFFE,20112012,MIN,64.55000000000001,0,1,1,2,2,1,1,6,5,7,13,7,4,0,0,52,81,40,78,3,1,0.16666666666666666,30168027.865000002
JEFF.WOYWITKA,20112012,NYR,281.0833333333333,1,2,3,5,6,3,0,0,0,13,34,18,16,0,4,228,240,220,216,8,6,0,30168039.075
JEREMY.MORIN,20112012,CHI,26.583333333333332,0,0,0,0,0,0,0,0,0,2,3,4,0,0,0,20,17,20,17,0,1,0,30168019.65
JEREMY.WELSH,20112012,CAR,16.533333333333335,0,0,0,0,0,0,4,13,9,2,3,3,1,0,2,19,12,19,12,0,0,0.3076923076923077,15084010.51
JEROME.SAMSON,20112012,CAR,196.43333333333334,2,2,1,3,5,4,0,0,0,31,55,10,12,4,4,221,186,183,177,5,8,0,30168037.615000002
JERRED.SMITHSON,20112012,FLA,231.35,0,2,0,2,2,2,105,170,65,13,20,53,5,1,3,159,212,154,174,6,8,0.6176470588235294,30168039.16
JERRED.SMITHSON,20112012,NSH,632.3833333333333,1,1,3,4,5,2,285,513,228,25,53,98,11,5,15,350,735,316,474,11,19,0.5555555555555556,30168083.575000003
JESSE.WINCHESTER,20112012,OTT,383.9,2,4,2,6,8,6,139,260,121,56,101,56,22,9,8,305,401,269,259,9,11,0.5346153846153846,30168051.25
JIM.O'BRIEN,20112012,OTT,389.5333333333333,3,3,1,4,7,6,136,287,151,44,78,37,21,4,2,309,380,279,273,11,9,0.4738675958188153,30168052.755
JIM.SLATER,20112012,WPG,1150.9499999999998,13,6,2,8,21,19,634,1164,530,118,181,163,24,13,17,783,1438,720,1020,29,40,0.5446735395189003,30168168.34
JIM.VANDERMEER,20112012,S.J,260.3666666666667,1,0,2,2,3,1,0,0,0,19,41,14,15,6,9,241,249,234,218,5,2,0,30168039.21
JIMMY.HAYES,20112012,CHI,337.9,5,2,2,4,9,7,6,11,5,45,68,53,10,5,7,299,270,276,265,8,12,0.5454545454545454,30168049.54
JIRI.HUDLER,20112012,DET,1353.4,27,13,12,25,52,40,2,7,5,132,234,51,46,18,23,1442,958,1083,884,63,48,0.2857142857142857,30168117.509999998
JIRI.TLUSTY,20112012,CAR,1177.5666666666666,17,9,10,19,36,26,3,11,8,136,226,83,45,9,11,1045,1258,913,1040,43,42,0.2727272727272727,30168141.66
JOAKIM.ANDERSSON,20112012,DET,33.333333333333336,0,0,0,0,0,0,5,6,1,3,3,5,0,1,0,27,24,27,24,1,1,0.8333333333333334,30168020.259999998
JOAKIM.LINDSTROM,20112012,COL,222.68333333333334,2,0,2,2,4,2,2,5,3,21,48,1,18,3,0,223,188,155,179,5,11,0.4,30168036.41
JOCHEN.HECHT,20112012,BUF,370.26666666666665,4,3,1,4,8,7,135,299,164,40,69,14,14,1,3,294,346,248,271,11,11,0.451505016722408,30168056.335
JODY.SHELLEY,20112012,PHI,169.63333333333333,0,0,1,1,1,0,0,2,2,19,30,49,4,6,11,124,155,121,155,2,8,0,30168037.134999998
JOE.COLBORNE,20112012,TOR,136.88333333333333,1,1,2,3,4,2,28,78,50,7,8,20,0,2,2,96,126,84,119,7,5,0.358974358974359,30168034.89
JOE.CORVO,20112012,BOS,1485.2666666666669,4,13,8,21,25,17,0,0,0,176,360,30,118,9,5,1643,1193,1262,1066,60,47,0,30168108.29
JOE.FINLEY,20112012,BUF,38.96666666666667,0,0,0,0,0,0,0,0,0,1,4,3,2,2,3,31,37,31,36,0,3,0,30168022.07
JOE.PAVELSKI,20112012,S.J,1795.2666666666667,31,20,10,30,61,51,540,940,400,282,529,56,117,27,15,2108,1540,1368,1134,54,38,0.574468085106383,30168158.72
JOE.PISKULA,20112012,CGY,54.483333333333334,0,0,0,0,0,0,0,0,0,2,6,6,2,0,1,45,58,45,56,0,5,0,30168024.1
JOE.THORNTON,20112012,S.J,1787.9,20,31,31,62,82,51,601,1065,464,171,283,47,55,30,14,2220,1398,1398,1103,55,35,0.564319248826291,30168158.564999998
JOE.VITALE,20112012,PIT,784.7833333333333,4,6,4,10,14,10,413,741,328,71,125,108,25,23,19,604,683,579,600,20,26,0.5573549257759784,30168097.6
JOEL.RECHLICZ,20112012,WSH,5.933333333333334,0,0,0,0,0,0,0,0,0,0,0,2,0,0,0,2,5,2,5,0,0,0,30168018.65
JOEL.WARD,20112012,WSH,1060.4833333333333,7,8,8,16,23,15,34,64,30,90,167,103,45,13,12,847,943,807,824,34,22,0.53125,30168106.89
JOEY.CRABB,20112012,TOR,900.75,11,7,8,15,26,18,1,10,9,75,144,101,34,14,12,702,920,661,706,29,31,0.1,30168099.68
JOFFREY.LUPUL,20112012,TOR,1228.3166666666666,25,26,15,41,66,51,21,58,37,191,342,110,83,23,24,1422,1149,989,1050,57,58,0.3620689655172414,30168152.994999997
JOHAN.FRANZEN,20112012,DET,1444.0666666666666,30,17,10,27,57,47,80,181,101,225,401,73,73,13,23,1592,913,1081,799,58,29,0.4419889502762431,30168114.33
JOHN-MICHAEL.LILES,20112012,TOR,1409.0333333333333,7,10,8,18,25,17,0,0,0,106,238,68,86,14,9,1388,1205,986,1025,36,48,0,30168121.939999998
JOHN.CARLSON,20112012,WSH,2128.883333333333,11,10,14,24,35,21,0,1,1,179,358,113,108,17,15,1728,2127,1395,1560,59,68,0,30168182.869999997
JOHN.ERSKINE,20112012,WSH,376.46666666666664,0,1,2,3,3,1,0,0,0,23,51,47,16,3,16,296,356,291,325,13,12,0,30168052.130000003
JOHN.MADDEN,20112012,FLA,467.26666666666665,3,0,0,0,3,3,182,380,198,38,57,28,6,5,2,285,450,272,362,4,10,0.4789473684210526,30168069.630000003
JOHN.MCCARTHY,20112012,S.J,94.35,0,0,0,0,0,0,18,43,25,14,16,10,1,1,1,97,99,95,98,1,3,0.4186046511627907,30168029.58
JOHN.MITCHELL,20112012,NYR,767.6333333333333,5,6,6,12,17,11,141,270,129,75,136,112,32,13,4,719,566,625,539,23,16,0.5222222222222223,30168076.119999997
JOHN.MOORE,20112012,CBJ,1060.05,2,2,3,5,7,4,0,0,0,64,138,47,46,3,4,771,1088,724,901,22,44,0,30168113.305
JOHN.SCOTT,20112012,CHI,201.2,0,0,1,1,1,0,0,0,0,8,19,29,5,7,14,166,152,166,148,8,8,0,30168032.595
JOHN.SCOTT,20112012,NYR,33.31666666666667,0,0,0,0,0,0,0,0,0,1,1,10,0,1,1,15,27,15,27,0,1,0,30168021.509999998
JOHN.TAVARES,20112012,NYI,1686.6,31,36,14,50,81,67,813,1585,772,286,464,27,98,42,13,1886,1450,1315,1290,63,64,0.5129337539432177,30168211.29
JOHNNY.BOYCHUK,20112012,BOS,1743.1833333333334,6,8,4,12,18,14,0,0,0,184,383,166,120,18,20,1697,1561,1517,1195,72,52,0,30168113.88
JOHNNY.ODUYA,20112012,CHI,579.0166666666667,1,2,5,7,8,3,0,0,0,39,103,21,42,3,0,540,474,442,364,19,17,0,30168045.505
JOHNNY.ODUYA,20112012,WPG,1217.6999999999998,2,3,3,6,8,5,0,0,0,52,137,53,48,12,15,956,1155,838,906,27,32,0,30168108.994999997
JON.DISALVATORE,20112012,MIN,14.45,0,0,0,0,0,0,0,0,0,2,2,1,0,0,1,10,11,9,11,0,0,0,15084010.45
JON.MATSUMOTO,20112012,FLA,5.066666666666666,0,0,0,0,0,0,1,1,0,0,0,0,0,0,0,10,2,10,2,0,0,1,15084008.79
JONATHAN.ERICSSON,20112012,DET,1278.3833333333332,1,5,4,9,10,6,0,0,0,68,144,138,50,11,25,1095,1085,1010,849,44,32,0,30168091.759999998
JONATHAN.TOEWS,20112012,CHI,1363.5,31,19,11,30,61,50,753,1258,505,204,281,43,40,25,17,1515,1053,1060,769,55,43,0.5985691573926868,30168129.795
JONATHON.BLUM,20112012,NSH,591.9666666666667,3,1,3,4,7,4,0,0,0,25,58,17,22,3,3,436,627,356,470,15,27,0,30168069.755000003
JONI.PITKANEN,20112012,CAR,669.1333333333333,5,5,7,12,17,10,0,0,0,62,115,27,27,4,9,689,628,430,472,17,25,0,30168071.965
JORDAN.CARON,20112012,BOS,566.7,7,5,3,8,15,12,1,2,1,59,89,66,18,3,7,478,486,447,445,20,21,0.5,30168068.645
JORDAN.EBERLE,20112012,EDM,1372.5833333333335,34,27,14,41,75,61,12,27,15,180,314,45,74,16,5,1348,1142,954,1027,64,50,0.4444444444444444,30168153.89
JORDAN.LEOPOLD,20112012,BUF,1767.2833333333333,10,7,7,14,24,17,0,0,0,110,222,54,79,4,10,1537,1731,1213,1289,60,53,0,30168148.265
JORDAN.NOLAN,20112012,L.A,388.8666666666667,3,3,0,3,6,6,1,1,0,32,63,94,13,11,11,355,278,340,272,10,7,1,30168045.450000003
JORDAN.STAAL,20112012,PIT,1360.7666666666669,31,19,9,28,59,50,641,1259,618,161,290,113,59,16,18,1363,1177,991,825,50,46,0.5091342335186656,30168144.075
JORDIE.BENN,20112012,DAL,41.86666666666667,0,0,1,1,1,0,0,0,0,1,3,3,1,0,0,28,38,23,29,0,0,0,30168021.174999997
JORDIN.TOOTOO,20112012,NSH,1036.15,6,19,5,24,30,25,4,12,8,138,241,160,62,29,30,817,1015,781,984,33,35,0.3333333333333333,30168139.375
JOSH.BAILEY,20112012,NYI,1217.6166666666668,13,11,8,19,32,24,323,736,413,104,177,64,43,10,11,977,1215,794,932,34,43,0.4388586956521739,30168146.67
JOSH.GORGES,20112012,MTL,1855.7166666666667,2,7,6,13,15,9,0,0,0,59,145,131,56,8,19,1393,1919,1199,1299,61,44,0,30168146.93
JOSH.GREEN,20112012,EDM,82.63333333333333,1,1,0,1,2,2,16,37,21,14,22,4,2,2,2,89,74,70,65,1,7,0.43243243243243246,30168026.96
JOSH.HENNESSY,20112012,BOS,20.316666666666666,0,0,0,0,0,0,8,13,5,2,3,2,0,1,1,21,18,21,18,1,0,0.6153846153846154,15084010.93
JT.WYMAN,20112012,T.B,409.85,2,5,4,9,11,7,22,57,35,29,59,31,14,5,4,255,426,244,331,15,13,0.38596491228070173,30168059.18
JUSSI.JOKINEN,20112012,CAR,1395.3166666666666,12,17,17,34,46,29,458,831,373,118,241,41,57,17,25,1504,1290,983,985,39,40,0.5511432009626955,30168145.115000002
JUSTIN.ABDELKADER,20112012,DET,1060.0666666666666,8,12,2,14,22,20,263,501,238,128,211,157,42,33,22,888,941,853,736,32,30,0.5249500998003992,30168106.3
JUSTIN.BRAUN,20112012,S.J,1181.25,2,5,4,9,11,7,0,0,0,122,263,49,84,11,12,1184,980,950,790,29,33,0,30168084.509999998
JUSTIN.FALK,20112012,MIN,916.15,1,3,4,7,8,4,0,0,0,46,104,78,35,14,21,648,1013,570,762,21,36,0,30168103.64
JUSTIN.FAULK,20112012,CAR,1507.7166666666667,8,5,7,12,20,13,0,0,0,101,220,113,70,9,12,1425,1432,1020,1095,36,41,0,30168131.165
JUSTIN.WILLIAMS,20112012,L.A,1774.4166666666665,26,25,22,47,73,51,11,27,16,299,523,46,104,35,28,2208,1307,1655,1165,59,42,0.4074074074074074,30168139.34
KARL.ALZNER,20112012,WSH,2060.0666666666666,1,6,11,17,18,7,0,0,0,69,171,98,66,7,13,1464,2214,1339,1582,56,51,0,30168180.345
KASPARS.DAUGAVINS,20112012,OTT,747.0333333333333,5,4,2,6,11,9,23,60,37,77,149,59,33,8,6,612,860,557,628,21,26,0.38333333333333336,30168088.55
KEATON.ELLERBY,20112012,FLA,624.2166666666667,0,1,4,5,5,1,0,0,0,45,106,80,39,3,6,518,611,499,534,17,22,0,30168068.78
KEITH.AUCOIN,20112012,WSH,442.6666666666667,3,6,4,10,13,9,79,173,94,30,63,20,19,5,1,447,361,363,338,17,12,0.45664739884393063,30168056.46
KEITH.AULIE,20112012,T.B,209.55,0,0,1,1,1,0,0,0,0,4,12,37,5,2,5,147,211,145,204,7,12,0,30168040.595
KEITH.AULIE,20112012,TOR,274.06666666666666,0,0,2,2,2,0,0,0,0,14,27,41,6,3,8,214,325,207,273,9,11,0,30168048.43
KEITH.BALLARD,20112012,VAN,789.75,1,1,6,7,8,2,0,0,0,43,111,66,39,19,23,683,745,628,640,20,23,0,30168081.240000002
KEITH.YANDLE,20112012,ARI,2174.9666666666667,12,23,16,39,51,35,0,0,0,218,497,35,158,18,28,2268,1792,1656,1599,77,60,0,30168177.33
KENNDAL.MCARDLE,20112012,WPG,54.983333333333334,0,0,0,0,0,0,0,0,0,3,7,10,4,0,2,27,62,26,60,1,3,0,30168025.4
KENT.HUSKINS,20112012,STL,411.18333333333334,2,0,5,5,7,2,0,0,0,17,42,6,15,3,5,360,350,342,319,15,8,0,30168047.655
KEVIN.BIEKSA,20112012,VAN,1967.7666666666667,9,8,23,31,40,17,0,1,1,183,387,169,127,27,36,1932,1719,1536,1242,67,57,0,30168125.695
KEVIN.KLEIN,20112012,NSH,1511.2333333333331,6,10,9,19,25,16,0,0,0,102,208,101,65,6,2,1032,1625,948,1216,40,50,0,30168153.085
KEVIN.MARSHALL,20112012,PHI,87.6,0,0,0,0,0,0,0,0,0,6,11,8,4,0,4,82,95,78,92,5,6,0,30168027.45
KEVIN.PORTER,20112012,COL,321.3833333333333,4,1,2,3,7,5,14,46,32,32,50,36,12,3,3,249,268,224,249,9,11,0.30434782608695654,30168048.04
KEVIN.SHATTENKIRK,20112012,STL,1942.6166666666668,10,18,16,34,44,28,1,4,3,204,384,82,109,14,32,1983,1523,1313,1126,53,34,0.25,30168130.33
KEVIN.WESTGARTH,20112012,L.A,131.53333333333333,1,1,0,1,2,2,0,1,1,13,23,31,4,6,11,104,116,104,115,5,8,0,30168032.36
KIMMO.TIMONEN,20112012,PHI,1835.6666666666665,5,19,23,42,47,24,1,1,0,141,277,82,79,16,30,1866,1626,1097,958,48,42,1,30168115.174999997
KRIS.FREDHEIM,20112012,MIN,35.93333333333334,0,0,0,0,0,0,0,0,0,0,2,1,1,0,1,14,45,14,41,0,2,0,15084014.45
KRIS.LETANG,20112012,PIT,1404.85,11,17,19,36,47,28,0,0,0,157,306,94,95,26,23,1676,1104,1014,836,65,40,0,30168098.735
KRIS.NEWBURY,20112012,NYR,41.2,0,0,0,0,0,0,6,17,11,2,4,14,1,3,5,25,48,25,45,2,3,0.35294117647058826,30168024.42
KRIS.RUSSELL,20112012,CBJ,210.81666666666666,2,0,1,1,3,2,0,0,0,20,35,9,9,5,5,233,164,161,148,8,8,0,30168032.875
KRIS.RUSSELL,20112012,STL,899.9000000000001,4,4,3,7,11,8,0,0,0,43,109,60,45,8,7,790,718,639,624,32,16,0,30168076.605
KRIS.VERSTEEG,20112012,FLA,1557.6166666666668,26,21,12,33,59,47,30,80,50,198,319,67,59,17,27,1511,1221,1003,1013,45,40,0.375,30168151.17
KRISTIAN.HUSELIUS,20112012,CBJ,32.4,0,0,0,0,0,0,0,0,0,2,6,0,1,0,1,39,21,29,20,0,1,0,15084010.65
KRISTOPHER.FOUCAULT,20112012,MIN,8.833333333333334,0,0,0,0,0,0,0,0,0,0,0,0,0,0,0,5,5,4,5,0,0,0,15084009.55
KRYS.BARCH,20112012,DAL,67.2,0,0,0,0,0,0,0,0,0,2,7,17,2,4,7,60,64,60,63,0,2,0,30168025.34
KRYS.BARCH,20112012,FLA,307.65,2,1,2,3,5,3,2,7,5,22,36,50,4,10,20,207,263,205,257,7,5,0.2857142857142857,30168051.18
KRYS.KOLANOS,20112012,CGY,128.1,0,0,1,1,1,0,17,30,13,29,45,13,8,2,2,122,98,105,96,2,3,0.5666666666666667,30168027.975
KURTIS.FOSTER,20112012,ANA,136.05,1,0,1,1,2,1,0,0,0,16,28,17,7,0,4,134,137,94,126,2,5,0,30168033.025
KURTIS.FOSTER,20112012,MIN,194.05,0,0,0,0,0,0,0,0,0,15,28,10,8,1,2,182,172,122,151,6,6,0,30168033.509999998
KURTIS.FOSTER,20112012,N.J,480.4166666666667,3,1,8,9,12,4,0,0,0,53,99,19,31,0,6,467,348,278,310,10,13,0,30168051.25
KYLE.BRODZIAK,20112012,MIN,1561.7,22,15,7,22,44,37,707,1428,721,158,281,81,58,17,22,1271,1661,941,1181,32,43,0.4950980392156863,30168199.125
KYLE.CHIPCHURA,20112012,ARI,674.45,4,11,5,16,20,15,179,376,197,50,95,87,24,16,12,595,672,586,626,28,23,0.47606382978723405,30168096.545
KYLE.CLIFFORD,20112012,L.A,777.0166666666667,5,5,2,7,12,10,1,8,7,90,148,183,24,29,34,638,602,616,566,17,23,0.125,30168082.58
KYLE.OKPOSO,20112012,NYI,1348.3,24,13,8,21,45,37,68,142,74,152,279,51,64,15,17,1314,1240,1066,1121,47,52,0.4788732394366197,30168154.07
KYLE.PALMIERI,20112012,ANA,207.36666666666667,4,2,1,3,7,6,2,2,0,34,70,20,18,2,2,197,177,167,176,11,7,1,30168037.675
KYLE.QUINCEY,20112012,COL,1207.2666666666667,5,6,11,17,22,11,0,1,1,131,269,68,94,10,30,1168,1040,853,768,32,34,0,30168090.475
KYLE.QUINCEY,20112012,DET,448.98333333333335,2,1,2,3,5,3,0,0,0,48,85,39,24,2,12,436,351,342,250,13,11,0,30168039.17
KYLE.TURRIS,20112012,ARI,76.48333333333333,0,0,0,0,0,0,21,51,30,9,15,2,4,2,2,74,72,69,68,0,2,0.4117647058823529,30168026.21
KYLE.TURRIS,20112012,OTT,966.8,13,12,7,19,32,25,344,740,396,144,252,27,69,12,13,1107,819,899,734,32,26,0.4648648648648649,30168109.855
KYLE.WELLWOOD,20112012,WPG,1151.3333333333333,18,13,14,27,45,31,135,250,115,93,159,10,29,12,2,1249,838,970,779,41,34,0.54,30168106.12
KYLE.WILSON,20112012,NSH,40.71666666666667,0,0,0,0,0,0,0,1,1,2,4,7,0,0,0,25,35,23,34,0,2,0,30168022.1
LADISLAV.SMID,20112012,EDM,1630.5333333333333,5,1,7,8,13,6,0,0,0,47,92,186,28,12,22,1142,1692,1078,1187,50,50,0,30168140.795
LANCE.BOUMA,20112012,CGY,274.40000000000003,1,1,0,1,2,2,11,22,11,26,48,45,7,7,4,188,269,184,240,3,8,0.5,30168046.96
LANE.MACDERMID,20112012,BOS,44.516666666666666,0,0,0,0,0,0,0,0,0,6,6,10,0,3,1,34,35,34,30,1,3,0,30168021.130000003
LARS.ELLER,20112012,MTL,1209.5833333333335,16,10,2,12,28,26,319,685,366,129,260,71,78,17,26,982,1136,820,909,31,38,0.4656934306569343,30168139.479999997
LAURI.KORPIKOSKI,20112012,ARI,1606.2333333333333,17,14,6,20,37,31,29,105,76,159,323,106,84,19,8,1236,1923,1059,1351,44,47,0.2761904761904762,30168181.4
LEE.STEMPNIAK,20112012,CGY,990.4166666666667,14,7,7,14,28,21,7,26,19,130,231,55,59,12,7,926,820,702,646,30,26,0.2692307692307692,30168089.175
LENNART.PETRELL,20112012,EDM,578,4,5,0,5,9,9,7,22,15,36,76,122,27,8,10,345,610,330,503,9,20,0.3181818181818182,30168081.16
LINUS.OMARK,20112012,EDM,188.33333333333331,3,0,0,0,3,3,2,7,5,24,47,7,11,4,7,171,176,137,161,2,8,0.2857142857142857,30168037.97
LOGAN.COUTURE,20112012,S.J,1584.5333333333333,32,25,11,36,68,57,488,956,468,263,456,52,104,13,8,1855,1288,1221,1037,38,37,0.5104602510460251,30168161.175
LOUI.ERIKSSON,20112012,DAL,1620.4666666666667,26,27,17,44,70,53,7,16,9,187,301,20,59,18,6,1563,1453,1105,1077,56,49,0.4375,30168152.185000002
LOUIS.LEBLANC,20112012,MTL,470.3166666666666,5,3,2,5,10,8,28,64,36,58,97,68,18,6,13,365,434,343,413,16,13,0.4375,30168069.43
LUBOMIR.VISNOVSKY,20112012,ANA,1413.6,6,8,13,21,27,14,1,1,0,112,243,63,82,4,18,1470,1081,972,957,47,39,1,30168111.505000003
LUCA.SBISA,20112012,ANA,1434.35,5,7,9,16,21,12,0,0,0,88,211,186,75,15,24,1187,1397,1031,1103,41,49,0,30168130.675
LUKE.ADAM,20112012,BUF,644.9000000000001,10,4,6,10,20,14,113,258,145,89,167,26,33,6,7,625,512,471,479,20,22,0.437984496124031,30168079.68
LUKE.SCHENN,20112012,TOR,1266.7833333333333,2,8,12,20,22,10,0,0,0,81,189,270,63,13,22,1106,1415,1048,1183,50,59,0,30168140.28
MAGNUS.PAAJARVI,20112012,EDM,540.25,2,2,4,6,8,4,2,7,5,79,129,18,28,7,2,476,432,400,385,8,13,0.2857142857142857,30168057.7
MAKSIM.MAYOROV,20112012,CBJ,106.65,1,1,0,1,2,2,0,0,0,9,10,11,0,1,1,68,84,66,80,2,5,0,30168028.26
MANNY.MALHOTRA,20112012,VAN,1011.4000000000001,7,4,6,10,17,11,577,979,402,62,106,47,25,12,7,571,1160,525,814,24,39,0.5893769152196119,30168132.65
MARC-ANDRE.BERGERON,20112012,T.B,832.2166666666667,4,8,12,20,24,12,0,0,0,80,198,37,75,5,10,881,669,630,569,36,28,0,30168068.85
MARC-ANDRE.BOURDON,20112012,PHI,739.8333333333333,4,0,3,3,7,4,0,0,0,45,107,75,38,9,18,704,679,641,617,30,27,0,30168076.365
MARC-ANDRE.GRAGNANI,20112012,BUF,720.55,1,2,9,11,12,3,1,1,0,35,67,12,19,2,10,771,543,540,477,26,14,1,30168061.535
MARC-ANDRE.GRAGNANI,20112012,VAN,215.76666666666665,1,1,1,2,3,2,0,0,0,12,17,7,3,1,3,238,181,195,165,5,8,0,30168034.185
MARC-ANTOINE.POULIOT,20112012,ARI,202.41666666666669,1,3,2,5,6,4,43,100,57,29,48,19,8,2,2,202,180,201,178,8,7,0.43,30168038.939999998
MARC-EDOUARD.VLASIC,20112012,S.J,2003.3333333333335,4,9,10,19,23,13,0,0,0,123,304,48,104,20,16,1874,1943,1658,1505,61,54,0,30168153.35
MARC.METHOT,20112012,CBJ,922.4,1,3,2,5,6,4,0,0,0,42,89,106,30,1,12,624,892,555,693,16,30,0,30168093.71
MARC.STAAL,20112012,NYR,1421,5,2,3,5,10,7,0,0,0,91,183,91,57,17,14,1069,1393,929,1128,37,43,0,30168138.295
MARCEL.GOC,20112012,FLA,1131.4499999999998,13,12,7,19,32,25,572,1090,518,110,171,47,33,4,5,1008,1024,805,730,31,26,0.5247706422018349,30168120.345
MARCO.SCANDELLA,20112012,MIN,1370.7333333333331,3,2,7,9,12,5,0,0,0,77,176,46,63,12,8,1066,1400,821,1074,22,44,0,30168134.195
MARCO.STURM,20112012,FLA,588.6666666666667,3,2,0,2,5,5,7,11,4,69,103,62,22,7,8,474,489,425,399,10,20,0.6363636363636364,30168059.85
MARCO.STURM,20112012,VAN,83.28333333333333,0,0,0,0,0,0,2,2,0,3,6,3,2,2,1,86,65,58,48,1,5,1,30168022.15
MARCUS.FOLIGNO,20112012,BUF,221.41666666666669,6,1,6,7,13,7,0,3,3,23,43,44,7,4,3,221,202,201,193,18,10,0,30168040.14
MARCUS.JOHANSSON,20112012,WSH,1618.25,15,21,13,34,49,36,319,736,417,112,212,81,61,18,4,1501,1568,1097,1328,55,56,0.43342391304347827,30168192.015
MARCUS.KRUGER,20112012,CHI,1200.15,9,9,7,16,25,18,309,667,358,102,152,27,24,11,11,1086,1003,888,757,38,31,0.46326836581709147,30168111.295
MAREK.ZIDLICKY,20112012,MIN,847.2,0,8,5,13,13,8,0,0,0,50,117,34,47,4,12,788,697,554,590,20,21,0,30168077.865000002
MAREK.ZIDLICKY,20112012,N.J,1067.4166666666665,3,10,2,12,15,13,0,0,0,63,130,80,46,8,17,1006,731,700,612,28,25,0,30168077.23
MARIAN.GABORIK,20112012,NYR,1998.9333333333334,46,26,15,41,87,72,0,2,2,336,553,83,105,18,16,2069,1597,1333,1403,67,50,0,30168203.105
MARIAN.HOSSA,20112012,CHI,1669.1833333333334,29,32,15,47,76,61,3,9,6,258,451,78,114,23,10,1673,1350,1131,973,55,44,0.3333333333333333,30168135.975
MARK.BELL,20112012,ANA,32.18333333333333,0,0,0,0,0,0,12,22,10,0,3,7,3,1,1,17,33,17,33,0,0,0.5454545454545454,30168022.19
MARK.BOROWIECKI,20112012,OTT,24.98333333333333,0,0,0,0,0,0,0,0,0,1,2,4,1,1,1,22,22,21,21,0,1,0,15084011.16
MARK.CULLEN,20112012,FLA,47.983333333333334,0,0,1,1,1,0,14,26,12,1,5,2,1,2,1,36,38,36,38,2,0,0.5384615384615384,30168022.205
MARK.EATON,20112012,NYI,995.1333333333333,1,2,1,3,4,3,0,0,0,44,83,53,23,1,5,720,1126,672,884,22,41,0,30168115.085
MARK.FAYNE,20112012,N.J,2143.15,4,4,10,14,18,8,0,0,0,124,297,99,115,10,16,1671,1629,1384,1294,63,62,0,30168130.65
MARK.FISTRIC,20112012,DAL,990.5833333333333,0,0,2,2,2,0,1,1,0,30,89,235,29,9,18,743,982,700,740,22,25,1,30168090.78
MARK.FLOOD,20112012,WPG,506.5,3,2,1,3,6,5,0,0,0,30,77,10,27,1,5,422,479,345,409,12,13,0,30168061.785
MARK.FRASER,20112012,N.J,57.35,0,0,0,0,0,0,0,0,0,0,5,6,3,3,4,39,44,35,39,2,4,0,30168021.98
MARK.GIORDANO,20112012,CGY,1404.2333333333333,9,10,7,17,26,19,0,0,0,125,271,84,102,22,36,1254,1286,863,942,40,38,0,30168119.045
MARK.LETESTU,20112012,CBJ,828.8833333333333,11,7,5,12,23,18,302,590,288,105,161,53,29,4,3,866,649,568,522,28,30,0.511864406779661,30168088.395
MARK.LETESTU,20112012,PIT,141.25,0,1,0,1,1,1,73,132,59,9,27,7,7,0,1,135,122,94,106,3,8,0.553030303030303,30168031.07
MARK.MANCARI,20112012,VAN,49.86666666666667,0,0,0,0,0,0,0,2,2,5,10,5,4,0,0,41,39,41,38,0,0,0,30168021.4
MARK.OLVER,20112012,COL,310.75,4,2,1,3,7,6,33,91,58,26,40,43,9,4,6,300,278,284,264,8,9,0.3626373626373626,30168049.634999998
MARK.SCHEIFELE,20112012,WPG,76.61666666666666,1,0,0,0,1,1,18,51,33,5,12,3,4,2,0,72,60,52,45,1,1,0.35294117647058826,30168023.84
MARK.STONE,20112012,OTT,8.716666666666667,0,1,0,1,1,1,0,0,0,0,2,0,1,0,0,12,8,6,7,1,0,0,15084010
MARK.STREIT,20112012,NYI,1917.0666666666666,7,22,17,39,46,29,0,1,1,149,319,110,121,15,23,1979,1575,1357,1332,54,64,0,30168153.075
MARK.STUART,20112012,WPG,1376.15,3,4,7,11,14,7,0,0,0,60,169,196,69,24,35,1081,1572,1013,1067,36,48,0,30168124.965
MARTIN.ERAT,20112012,NSH,1500.6333333333332,20,19,23,42,62,39,67,148,81,119,229,67,62,20,18,1315,1313,904,1084,47,44,0.4527027027027027,30168157.455
MARTIN.HANZAL,20112012,ARI,1379.4666666666667,11,16,12,28,39,27,634,1244,610,163,289,296,58,20,39,1444,1176,1034,929,43,29,0.5096463022508039,30168146.259999998
MARTIN.HAVLAT,20112012,S.J,782.3666666666667,9,16,5,21,30,25,0,6,6,110,191,8,46,8,15,843,696,606,600,21,16,0,30168091.255
MARTIN.ST. LOUIS,20112012,T.B,1742.7166666666667,25,30,19,49,74,55,18,41,23,184,343,17,81,23,8,1738,1536,1169,1315,74,69,0.43902439024390244,30168180.575
MARTY.REASONER,20112012,NYI,708.1833333333334,1,1,4,5,6,2,303,572,269,69,110,43,25,5,16,472,765,455,607,7,31,0.5297202797202797,30168099.37
MASON.RAYMOND,20112012,VAN,920.0833333333333,10,7,3,10,20,17,10,28,18,141,225,41,50,13,9,932,860,762,717,30,29,0.35714285714285715,30168095.855
MAT.CLARK,20112012,ANA,22.05,0,0,0,0,0,0,0,0,0,2,3,2,1,0,0,23,20,23,20,0,2,0,30168019.8
MATHIEU.DARCHE,20112012,MTL,739.8666666666667,5,3,4,7,12,8,6,19,13,77,131,79,28,11,9,590,689,496,511,12,18,0.3157894736842105,30168075.2
MATHIEU.PERREAULT,20112012,WSH,812.5333333333333,16,9,5,14,30,25,245,483,238,62,131,56,36,14,14,847,636,727,604,39,27,0.5072463768115942,30168092.315
MATS.ZUCCARELLO,20112012,NYR,100.43333333333332,2,0,1,1,3,2,0,0,0,10,19,8,4,1,3,113,54,58,43,2,2,0,30168023.085
MATT.BARTKOWSKI,20112012,BOS,18.383333333333333,0,0,0,0,0,0,0,0,0,0,1,5,0,0,0,15,16,15,16,0,2,0,30168019.65
MATT.BELESKEY,20112012,ANA,718.5166666666667,4,6,5,11,15,10,11,26,15,75,156,104,45,21,22,592,665,564,657,24,26,0.4230769230769231,30168092.375
MATT.BRADLEY,20112012,FLA,489.3166666666667,3,1,4,5,8,4,12,28,16,34,60,134,20,12,8,333,486,316,451,10,12,0.42857142857142855,30168072
MATT.CALVERT,20112012,CBJ,118.66666666666666,0,0,3,3,3,0,0,0,0,4,12,8,5,2,4,99,84,93,80,4,8,0,30168025.045
MATT.CARKNER,20112012,OTT,373.48333333333335,1,1,1,2,3,2,0,0,0,18,56,62,25,7,17,347,369,342,313,13,12,0,30168046.995
MATT.CARLE,20112012,PHI,2166.2166666666662,5,16,21,37,42,21,0,0,0,147,330,65,125,10,22,2101,1876,1542,1489,68,66,0,30168159.924999997
MATT.COOKE,20112012,PIT,1383.0833333333335,19,8,15,23,42,27,20,37,17,150,255,181,52,27,26,1177,1212,949,849,46,43,0.5405405405405406,30168114.345
MATT.CULLEN,20112012,MIN,1382.15,14,15,6,21,35,29,627,1178,551,164,267,46,67,14,11,1255,1273,834,923,33,41,0.532258064516129,30168149.52
MATT.D'AGOSTINI,20112012,STL,819.9833333333333,10,5,4,9,19,15,10,31,21,109,219,56,54,6,16,892,598,664,556,24,14,0.3225806451612903,30168075.41
MATT.DONOVAN,20112012,NYI,55.71666666666666,0,0,0,0,0,0,0,0,0,6,10,3,1,0,0,41,41,37,36,1,3,0,30168021.549999997
MATT.DUCHENE,20112012,COL,944.7333333333333,14,7,7,14,28,21,200,391,191,132,249,43,68,20,3,1084,772,772,690,23,27,0.5115089514066496,30168098.225
MATT.ELLIS,20112012,BUF,583.1,3,1,4,5,8,4,117,244,127,84,139,34,27,4,7,482,514,476,469,15,18,0.47950819672131145,30168071.67
MATT.FRASER,20112012,DAL,3.95,0,0,0,0,0,0,0,0,0,1,1,0,0,0,0,2,8,2,8,0,0,0,15084010.15
MATT.FRATTIN,20112012,TOR,737.25,8,7,0,7,15,15,2,8,6,92,181,81,42,8,11,654,650,596,628,26,26,0.25,30168088.259999998
MATT.GILROY,20112012,OTT,278.5333333333333,1,0,2,2,3,1,0,0,0,26,48,10,13,2,1,313,237,277,220,8,7,0,30168036.32
MATT.GILROY,20112012,T.B,933.2,2,7,7,14,16,9,0,0,0,60,125,49,46,6,8,758,869,675,709,40,35,0,30168087.735
MATT.GREENE,20112012,L.A,1689.0833333333333,6,6,8,14,20,12,0,0,0,93,232,317,74,11,32,1374,1567,1290,1041,39,38,0,30168110.36
MATT.HALISCHUK,20112012,NSH,856.9,15,9,5,14,29,24,11,31,20,96,139,43,23,14,10,543,873,499,666,31,23,0.3548387096774194,30168108.005000003
MATT.HENDRICKS,20112012,WSH,1170.7666666666667,5,4,2,6,11,9,207,381,174,118,198,280,41,34,34,822,1156,774,901,23,28,0.5433070866141733,30168128.67
MATT.HUNWICK,20112012,COL,595.9333333333333,3,2,1,3,6,5,0,1,1,40,76,24,26,2,5,564,522,476,435,12,16,0,30168059.845
MATT.KASSIAN,20112012,MIN,133.1,2,0,0,0,2,2,0,0,0,13,19,32,3,13,13,95,132,93,131,3,5,0,30168036.23
MATT.MARTIN,20112012,NYI,972.6166666666667,7,6,1,7,14,13,10,23,13,130,210,374,32,29,34,748,978,654,769,11,24,0.43478260869565216,30168114.915
MATT.MOULSON,20112012,NYI,1582.8,36,19,14,33,69,55,2,4,2,219,358,33,78,15,3,1731,1374,1207,1245,61,55,0.5,30168171.88
MATT.NISKANEN,20112012,PIT,1419.5,5,7,12,19,24,12,0,0,0,126,287,110,96,7,25,1648,1039,1199,892,54,40,0,30168087.72
MATT.READ,20112012,PHI,1515.3333333333333,27,10,15,25,52,37,169,425,256,163,303,94,61,17,8,1303,1349,900,899,49,37,0.3976470588235294,30168137.505000003
MATT.STAJAN,20112012,CGY,793.6333333333333,8,5,5,10,18,13,331,638,307,77,121,49,28,13,9,677,751,604,601,24,23,0.5188087774294671,30168096.245
MATT.TAORMINA,20112012,N.J,496.03333333333336,1,3,2,5,6,4,0,0,0,33,63,18,22,3,2,391,381,346,344,17,10,0,30168050.93
MATT.WALKER,20112012,PHI,43.85,0,0,0,0,0,0,0,0,0,2,8,1,3,2,4,37,50,37,50,3,5,0,30168023.47
MATT.WATKINS,20112012,ARI,6.616666666666666,0,0,0,0,0,0,0,5,5,0,0,1,0,0,0,2,8,2,8,0,1,0,15084010.35
MATTHEW.LOMBARDI,20112012,TOR,841.1833333333334,8,7,3,10,18,15,151,306,155,101,153,58,27,1,5,667,881,610,707,23,39,0.4934640522875817,30168107.775
MATTIAS.EKHOLM,20112012,NSH,24.833333333333336,0,0,0,0,0,0,0,0,0,1,4,0,2,0,0,23,19,22,18,0,1,0,30168019.35
MATTIAS.RITOLA,20112012,T.B,54.16666666666667,0,0,0,0,0,0,2,3,1,14,19,4,3,0,3,45,53,37,35,0,2,0.6666666666666666,30168022.130000003
MATTIAS.TEDENBY,20112012,N.J,462.2833333333333,1,4,1,5,6,5,1,3,2,46,72,25,19,13,8,323,362,305,342,10,22,0.3333333333333333,30168056.395000003
MAX.PACIORETTY,20112012,MTL,1442.6,33,18,13,31,64,51,1,5,4,286,468,104,83,25,24,1615,1188,1122,1051,56,50,0.2,30168151.015
MAX.SAUVE,20112012,BOS,3.716666666666667,0,0,0,0,0,0,0,0,0,0,1,0,1,0,0,2,3,2,3,0,0,0,15084009.2
MAX.TALBOT,20112012,PHI,1483.25,23,13,4,17,40,36,297,671,374,130,215,176,43,29,28,1136,1584,978,1015,46,46,0.4426229508196721,30168158.27
MAXIM.LAPIERRE,20112012,VAN,972.1833333333334,9,6,5,11,20,15,255,489,234,115,185,263,39,30,32,706,941,665,798,25,30,0.5214723926380368,30168124.825
MAXIME.MACENAUER,20112012,ANA,313.6333333333333,1,2,1,3,4,3,113,227,114,14,22,17,3,2,9,181,381,163,206,5,8,0.4977973568281938,30168048.064999998
MICHAEL.DEL ZOTTO,20112012,NYR,2160.8166666666666,12,17,21,38,50,29,0,0,0,148,317,218,107,15,24,1982,1796,1233,1424,59,50,0,30168175.525
MICHAEL.FROLIK,20112012,CHI,880.5333333333333,7,8,2,10,17,15,16,48,32,129,244,59,69,11,8,737,754,668,610,13,28,0.3333333333333333,30168082.45
MICHAEL.GRABNER,20112012,NYI,1212.4333333333334,20,7,5,12,32,27,3,5,2,174,275,16,48,12,6,1008,1209,853,960,35,46,0.6,30168134.915
MICHAEL.RYDER,20112012,DAL,1425.3166666666666,35,17,10,27,62,52,34,71,37,211,384,86,99,12,22,1448,1220,1076,1085,58,44,0.4788732394366197,30168153.48
MICHAEL.SAUER,20112012,NYR,355.9166666666667,1,1,1,2,3,2,0,0,0,14,30,21,9,2,5,272,357,237,286,16,7,0,30168048.095
MICHAEL.STONE,20112012,ARI,203.1,1,2,0,2,3,3,0,0,0,13,26,17,5,1,1,179,255,169,235,10,5,0,30168045.16
MICHAL.HANDZUS,20112012,S.J,990.2166666666667,7,14,3,17,24,21,422,838,416,85,137,54,25,4,8,843,1023,654,809,23,30,0.5035799522673031,30168134.345
MICHAL.REPIK,20112012,FLA,176.11666666666667,2,2,1,3,5,4,3,5,2,35,47,24,3,5,3,173,129,154,125,4,6,0.6,30168032.895
MICHAL.ROZSIVAL,20112012,ARI,1370.9,1,4,7,11,12,5,0,0,0,60,127,93,45,7,19,1091,1365,1012,1080,38,33,0,30168126.295
MICHEAL.HALEY,20112012,NYI,111.23333333333335,0,0,0,0,0,0,1,2,1,13,21,31,7,10,14,79,95,76,90,0,1,0.5,30168029.54
MIKA.ZIBANEJAD,20112012,OTT,116.10000000000001,0,0,1,1,1,0,22,50,28,12,25,15,6,1,1,101,110,83,97,1,4,0.44,30168029.365000002
MIKAEL.BACKLUND,20112012,CGY,630.6666666666666,4,3,4,7,11,7,225,496,271,85,139,25,26,7,8,577,554,480,467,14,26,0.4536290322580645,30168079.62
MIKAEL.SAMUELSSON,20112012,FLA,878.5333333333333,13,11,8,19,32,24,13,34,21,139,234,95,59,11,9,877,674,646,622,26,24,0.38235294117647056,30168091.33
MIKAEL.SAMUELSSON,20112012,VAN,95.3,1,1,1,2,3,2,0,0,0,13,29,5,12,2,3,133,56,67,43,2,3,0,30168021.445
MIKE.ANGELIDIS,20112012,T.B,38.983333333333334,1,0,0,0,1,1,4,7,3,8,11,6,3,2,1,31,28,31,28,1,2,0.5714285714285714,30168021.43
MIKE.BLUNDEN,20112012,MTL,365.15,2,2,0,2,4,4,2,5,3,34,55,104,7,4,8,252,362,248,342,9,9,0.4,30168060.07
MIKE.BROWN,20112012,TOR,463.8333333333333,2,2,0,2,4,4,0,1,1,56,103,120,18,18,17,360,464,351,390,7,17,0,30168063.28
MIKE.CAMMALLERI,20112012,CGY,518.1333333333333,11,5,3,8,19,16,94,199,105,64,98,10,23,6,8,506,457,341,392,18,15,0.4723618090452261,30168073.045
MIKE.CAMMALLERI,20112012,MTL,677.2,9,7,6,13,22,16,10,29,19,111,183,7,38,14,5,669,586,413,463,22,20,0.3448275862068966,30168075.689999998
MIKE.COMMODORE,20112012,DET,195.38333333333335,0,1,1,2,2,1,0,0,0,16,32,32,10,3,6,191,166,184,163,5,2,0,30168033.354999997
MIKE.COMMODORE,20112012,T.B,182.7,0,0,0,0,0,0,0,0,0,7,22,21,12,2,7,120,180,116,132,9,5,0,30168030.27
MIKE.CONNOLLY,20112012,COL,24.683333333333334,0,0,0,0,0,0,0,0,0,1,1,2,0,0,1,24,16,17,11,0,0,0,15084010
MIKE.DUCO,20112012,VAN,48.333333333333336,0,2,0,2,2,2,0,0,0,4,6,17,2,2,1,31,50,31,50,4,3,0,30168024.52
MIKE.FISHER,20112012,NSH,1596.6166666666668,25,15,15,30,55,40,673,1405,732,178,299,149,55,16,19,1301,1508,935,1194,52,45,0.4790035587188612,30168202.955
MIKE.GREEN,20112012,WSH,1005.9000000000001,5,1,5,6,11,6,0,0,0,91,219,45,81,6,11,961,925,717,744,32,21,0,30168087.485
MIKE.HOFFMAN,20112012,OTT,9.016666666666666,0,0,0,0,0,0,0,0,0,0,2,1,0,0,0,10,10,10,9,0,0,0,15084009.85
MIKE.KNUBLE,20112012,WSH,1104.2666666666669,8,7,6,13,21,15,14,27,13,99,169,98,29,4,20,850,1057,713,863,23,32,0.5185185185185185,30168122.4
MIKE.KOMISAREK,20112012,TOR,749.5333333333333,1,2,2,4,5,3,0,0,0,34,85,104,34,8,14,552,766,529,609,22,35,0,30168080.33
MIKE.LUNDIN,20112012,MIN,343.51666666666665,0,0,2,2,2,0,0,0,0,9,26,3,7,5,2,242,403,217,304,8,11,0,30168051.45
MIKE.MOTTAU,20112012,BOS,102.05,0,0,0,0,0,0,0,0,0,3,12,13,4,0,0,71,91,68,85,1,4,0,30168026.75
MIKE.MOTTAU,20112012,NYI,411.28333333333336,0,1,1,2,2,1,0,0,0,19,42,27,16,4,6,323,422,302,356,12,19,0,30168054.615000002
MIKE.RIBEIRO,20112012,DAL,1483.5166666666667,18,25,20,45,63,43,341,808,467,142,247,113,52,15,21,1417,1333,1015,1092,47,44,0.422029702970297,30168174.39
MIKE.RICHARDS,20112012,L.A,1787.85,22,22,15,37,59,44,706,1403,697,212,447,152,112,34,32,1740,1587,1069,1147,37,40,0.5032074126870991,30168186.405
MIKE.RUPP,20112012,NYR,523.2166666666667,4,0,1,1,5,4,21,41,20,48,72,130,10,24,32,362,456,351,443,9,13,0.5121951219512195,30168075.155
MIKE.SANTORELLI,20112012,FLA,744.2333333333333,9,1,1,2,11,10,176,389,213,117,178,49,36,7,11,696,616,589,584,15,23,0.4524421593830334,30168091.884999998
MIKE.WEAVER,20112012,FLA,1823.3,1,2,11,13,14,3,0,0,0,57,132,138,46,19,7,1284,1899,1178,1366,49,60,0,30168156.465
MIKE.WEBER,20112012,BUF,947.3499999999999,1,1,2,3,4,2,0,0,0,51,122,123,54,14,22,739,909,681,735,18,38,0,30168090.79
MIKHAIL.GRABOVSKI,20112012,TOR,1302.9666666666667,23,22,6,28,51,45,466,905,439,163,326,56,94,18,15,1416,1115,1126,971,51,44,0.5149171270718232,30168142.119999997
MIKKEL.BOEDKER,20112012,ARI,1389.0333333333333,15,12,5,17,32,27,2,5,3,118,227,140,58,16,5,1164,1287,1012,1152,43,41,0.4,30168149.465
MIKKO.KOIVU,20112012,MIN,1174.25,12,23,9,32,44,35,587,1123,536,129,218,62,50,11,13,1095,1018,649,775,25,21,0.5227070347284061,30168141.715000004
MILAN.HEJDUK,20112012,COL,1378.05,14,16,7,23,37,30,2,8,6,170,291,35,72,8,7,1500,1139,1092,1027,40,45,0.25,30168129.685
MILAN.JURCINA,20112012,NYI,1220.5,3,3,4,7,10,6,0,0,0,127,265,173,76,2,16,1088,1247,929,1000,27,57,0,30168118.92
MILAN.KYTNAR,20112012,EDM,5.516666666666667,0,0,0,0,0,0,0,1,1,1,2,0,1,0,0,3,0,3,0,0,0,0,15084008.8
MILAN.LUCIC,20112012,BOS,1521.3166666666666,26,25,13,38,64,51,15,32,17,161,297,231,74,24,40,1777,1166,1351,1073,67,55,0.46875,30168138.165
MILAN.MICHALEK,20112012,OTT,1658.9,36,19,7,26,62,55,1,8,7,231,424,51,84,20,18,1868,1484,1281,1140,58,49,0.125,30168154.615000002
NATE.GUENIN,20112012,ANA,167.28333333333333,2,0,0,0,2,2,0,0,0,5,15,26,7,0,3,116,140,115,139,9,2,0,30168032.8
NATE.PROSSER,20112012,MIN,981.6166666666667,1,4,6,10,11,5,0,0,0,32,79,34,30,11,20,756,1045,629,811,21,36,0,30168108.61
NATE.THOMPSON,20112012,T.B,1007.95,9,3,3,6,15,12,293,591,298,85,135,107,28,10,9,622,1046,561,693,19,42,0.4957698815566836,30168112.695
NATHAN.GERBE,20112012,BUF,880.8666666666667,6,14,5,19,25,20,6,18,12,137,217,53,48,25,16,729,794,657,711,30,28,0.3333333333333333,30168102.415
NATHAN.HORTON,20112012,BOS,732.9166666666666,17,10,4,14,31,27,2,3,1,90,155,32,41,8,19,922,559,687,506,34,31,0.6666666666666666,30168073.46
NAZEM.KADRI,20112012,TOR,297.35,5,2,0,2,7,7,4,15,11,28,58,25,22,6,5,311,251,244,236,11,8,0.26666666666666666,30168043.57
NICK.BONINO,20112012,ANA,623.8499999999999,5,6,7,13,18,11,195,454,259,63,104,18,16,3,4,558,605,496,579,24,22,0.42951541850220265,30168096.155
NICK.FOLIGNO,20112012,OTT,1307.05,16,19,15,34,50,35,72,162,90,170,268,215,54,37,48,1369,1055,1139,968,46,52,0.4444444444444444,30168133.875
NICK.JOHNSON,20112012,MIN,1110.9666666666667,8,14,4,18,26,22,3,13,10,146,222,58,40,12,14,907,1100,830,1055,35,39,0.23076923076923078,30168147.09
NICK.LEDDY,20112012,CHI,1930.9166666666665,4,15,19,34,38,19,0,0,0,103,225,75,82,11,5,1832,1521,1456,1238,64,70,0,30168127.485
NICK.PALMIERI,20112012,MIN,93.58333333333334,0,0,0,0,0,0,0,1,1,13,18,12,2,0,1,83,99,79,98,1,4,0,30168029.15
NICK.PALMIERI,20112012,N.J,308.58333333333337,4,1,2,3,7,5,2,10,8,42,67,27,8,1,7,241,267,215,260,9,15,0.2,30168050.740000002
NICK.SCHULTZ,20112012,EDM,401.16666666666663,0,2,0,2,2,2,0,0,0,13,35,23,9,1,5,288,394,265,314,7,9,0,30168051.96
NICK.SCHULTZ,20112012,MIN,1214.9,1,0,2,2,3,1,0,0,0,38,96,60,32,1,15,838,1338,732,1031,22,30,0,30168132.96
NICK.SPALING,20112012,NSH,1367.8833333333332,10,6,9,15,25,16,494,993,499,114,180,50,30,20,9,975,1493,906,1101,38,45,0.49748237663645517,30168165.884999998
NICKLAS.BACKSTROM,20112012,WSH,1084.6666666666665,16,23,13,36,52,39,469,924,455,120,205,51,39,9,17,1147,899,760,734,32,34,0.5075757575757576,30168130.975
NICKLAS.GROSSMANN,20112012,DAL,987.25,0,2,3,5,5,2,0,0,0,38,90,96,27,3,13,713,1104,663,824,26,32,0,30168105.705
NICKLAS.GROSSMANN,20112012,PHI,575.4166666666667,0,1,6,7,7,1,0,0,0,21,58,90,21,2,8,412,571,375,462,19,19,0,30168065.82
NICKLAS.LIDSTROM,20112012,DET,1782.5333333333333,11,10,13,23,34,21,0,0,0,162,341,44,105,3,15,1983,1319,1322,993,59,38,0,30168100.805
NICLAS.BERGFORS,20112012,NSH,88.80000000000001,1,0,1,1,2,1,0,0,0,11,14,0,2,1,1,73,81,59,78,3,5,0,30168027.485
NIK.ANTROPOV,20112012,WPG,1139.5500000000002,15,15,5,20,35,30,282,651,369,95,178,94,37,11,21,1056,1021,778,767,35,35,0.43317972350230416,30168126.115000002
NIKITA.FILATOV,20112012,OTT,88.36666666666667,0,0,1,1,1,0,0,1,1,6,15,8,4,1,2,89,79,70,76,2,2,0,30168025.735
NIKITA.NIKITIN,20112012,CBJ,1273.3166666666666,7,11,13,24,31,18,0,0,0,93,210,40,66,16,7,1167,1064,801,766,38,39,0,30168095.035
NIKITA.NIKITIN,20112012,STL,141.7,0,0,0,0,0,0,0,0,0,10,26,7,7,0,2,126,127,82,95,2,6,0,30168027.6
NIKLAS.HAGMAN,20112012,ANA,921.5333333333333,8,8,3,11,19,16,7,17,10,111,208,45,45,12,6,759,869,665,684,21,36,0.4117647058823529,30168094.674999997
NIKLAS.HAGMAN,20112012,CGY,113.45,1,2,1,3,4,3,1,3,2,14,28,3,8,0,1,99,90,82,86,4,0,0.3333333333333333,30168027.814999998
NIKLAS.HJALMARSSON,20112012,CHI,1501.3666666666668,1,7,6,13,14,8,0,0,0,68,166,47,66,7,9,1196,1334,1084,978,44,43,0,30168103.82
NIKLAS.KRONWALL,20112012,DET,1987.6666666666667,15,6,15,21,36,21,0,0,0,150,302,136,98,11,21,1790,1650,1244,1097,60,55,0,30168122.335
NIKOLAY.KULEMIN,20112012,TOR,1065.7166666666667,7,11,10,21,28,18,32,78,46,107,232,97,47,8,3,1014,1036,877,834,38,33,0.41025641025641024,30168106.060000002
NINO.NIEDERREITER,20112012,NYI,556.3499999999999,1,0,0,0,1,1,0,2,2,74,120,129,21,6,6,465,512,439,497,3,30,0,30168072.46
NOLAN.YONKMAN,20112012,FLA,6.316666666666666,0,0,0,0,0,0,0,0,0,0,1,0,1,0,0,4,3,4,3,0,0,0,15084009.1
OLIVER.EKMAN-LARSSON,20112012,ARI,2225.4333333333334,14,8,13,21,35,22,0,1,1,167,387,155,133,25,19,1995,1954,1548,1549,59,54,0,30168170.825
OLLI.JOKINEN,20112012,CGY,1554.7333333333331,23,25,13,38,61,48,620,1332,712,222,345,53,69,15,25,1476,1403,978,1167,51,57,0.46546546546546547,30168201.375
P.A..PARENTEAU,20112012,NYI,1492.2,18,29,20,49,67,47,10,26,16,166,271,98,55,23,37,1603,1232,1111,1104,50,55,0.38461538461538464,30168157.13
P.K..SUBBAN,20112012,MTL,1968.4666666666667,7,14,13,27,34,21,0,0,0,205,400,105,113,40,49,1859,1714,1226,1240,62,42,0,30168148.025
PASCAL.DUPUIS,20112012,PIT,1490.9166666666665,27,22,16,38,65,49,54,122,68,225,402,131,93,8,15,1371,1379,1174,1026,65,52,0.4426229508196721,30168138.14
PATRIC.HORNQVIST,20112012,NSH,1319.25,28,10,9,19,47,38,8,14,6,265,396,67,55,33,15,1361,981,993,914,44,34,0.5714285714285714,30168132.425
PATRICE.BERGERON,20112012,BOS,1642.5833333333335,22,32,11,43,65,54,1044,1762,718,209,384,91,84,21,13,1867,1281,1340,910,60,31,0.5925085130533485,30168137.795
PATRICE.CORMIER,20112012,WPG,57.28333333333333,0,0,0,0,0,0,22,30,8,8,13,12,4,1,0,53,37,53,37,2,1,0.7333333333333333,30168020.59
PATRICK.DWYER,20112012,CAR,1121.9833333333333,5,5,2,7,12,10,15,29,14,120,213,129,44,25,10,889,1255,807,915,20,23,0.5172413793103449,30168120
PATRICK.EAVES,20112012,DET,110.46666666666667,0,1,0,1,1,1,2,5,3,24,34,21,7,1,1,96,101,93,59,3,3,0.4,30168022.740000002
PATRICK.KALETA,20112012,BUF,828.75,5,3,2,5,10,8,10,19,9,69,130,139,29,34,33,552,809,525,559,15,21,0.5263157894736842,30168083.39
PATRICK.KANE,20112012,CHI,1788.0166666666667,23,31,16,47,70,54,249,604,355,269,479,23,116,35,18,1998,1256,1402,1119,67,57,0.41225165562913907,30168154.41
PATRICK.MARLEAU,20112012,S.J,1781.1666666666665,30,16,18,34,64,46,265,515,250,260,434,96,77,12,14,2072,1505,1315,1137,56,48,0.5145631067961165,30168159.07
PATRICK.MAROON,20112012,ANA,25.083333333333332,0,0,0,0,0,0,0,0,0,1,2,4,1,0,1,17,23,17,23,0,0,0,15084011.65
PATRICK.O'SULLIVAN,20112012,ARI,254.13333333333333,2,2,0,2,4,4,5,9,4,34,56,7,11,3,1,239,241,172,224,5,9,0.5555555555555556,30168045.130000003
PATRICK.SHARP,20112012,CHI,1594.3333333333335,34,19,17,36,70,53,149,313,164,305,528,103,125,15,13,1785,1159,1226,903,65,42,0.476038338658147,30168123.235
PATRIK.BERGLUND,20112012,STL,1654.1833333333334,21,15,8,23,44,36,621,1309,688,211,410,113,80,18,18,1583,1416,1062,1038,45,35,0.4744079449961803,30168167.020000003
PATRIK.ELIAS,20112012,N.J,2052.1833333333334,31,35,20,55,86,66,739,1687,948,218,382,97,89,20,12,1881,1451,1161,1013,59,50,0.43805572021339656,30168185.060000002
PAUL.BISSONNETTE,20112012,ARI,196.35,1,0,0,0,1,1,0,1,1,15,23,74,4,9,11,169,145,168,143,1,5,0,30168033.54
PAUL.BYRON,20112012,CGY,225.06666666666666,3,1,1,2,5,4,8,22,14,13,21,26,5,4,1,142,189,138,186,7,2,0.36363636363636365,30168041.384999998
PAUL.GAUSTAD,20112012,BUF,844.5833333333333,7,6,4,10,17,13,494,870,376,62,103,98,17,15,20,546,906,494,598,20,23,0.5678160919540229,30168106.060000002
PAUL.GAUSTAD,20112012,NSH,305.06666666666666,1,3,1,4,5,4,259,437,178,19,36,33,9,2,4,176,351,162,226,8,11,0.5926773455377574,30168051.555
PAUL.MARTIN,20112012,PIT,1745.5500000000002,3,12,12,24,27,15,0,0,0,94,203,28,75,13,9,1762,1486,1387,1125,64,63,0,30168112.33
PAUL.POSTMA,20112012,WPG,25.53333333333333,0,0,0,0,0,0,0,0,0,3,5,1,1,0,0,21,13,20,13,0,0,0,15084009.95
PAUL.STASTNY,20112012,COL,1487.75,21,19,13,32,53,40,789,1424,635,189,303,40,57,16,15,1621,1312,1155,1111,45,46,0.5540730337078652,30168173.445
PAUL.SZCZECHURA,20112012,BUF,102.93333333333334,1,3,0,3,4,4,28,67,39,11,18,7,4,1,2,83,101,76,95,5,5,0.417910447761194,30168031.98
PAVEL.DATSYUK,20112012,DET,1476.2166666666667,20,29,21,50,70,49,768,1367,599,175,321,83,75,23,8,1613,980,1065,722,51,26,0.5618141916605706,30168118.125
PAVEL.KUBINA,20112012,PHI,347.18333333333334,0,3,1,4,4,3,0,0,0,24,47,42,13,3,8,343,313,307,270,10,18,0,30168043.855
PAVEL.KUBINA,20112012,T.B,1035.35,3,4,4,8,11,7,0,0,0,56,116,95,39,10,24,821,1084,689,804,39,41,0,30168103.55
PETER.HARROLD,20112012,N.J,424.48333333333335,0,3,3,6,6,3,0,0,0,33,55,12,14,7,3,374,294,314,272,15,14,0,30168042.795
PETER.HOLLAND,20112012,ANA,30.816666666666663,1,0,0,0,1,1,7,18,11,1,3,4,0,1,1,16,44,16,44,2,2,0.3888888888888889,30168024.89
PETER.MUELLER,20112012,COL,468.8833333333333,7,8,1,9,16,15,6,10,4,82,154,14,39,0,4,519,432,407,404,12,15,0.6,30168064.814999998
PETER.REGIN,20112012,OTT,140.93333333333334,2,2,0,2,4,4,29,59,30,15,28,6,7,2,1,120,108,103,87,5,3,0.4915254237288136,30168028.729999997
PETR.SYKORA,20112012,N.J,1542.4333333333334,23,14,12,26,49,37,10,18,8,193,366,30,88,10,24,1388,1017,1109,950,55,40,0.5555555555555556,30168121.95
PETTERI.NOKELAINEN,20112012,ARI,54.68333333333333,0,1,0,1,1,1,18,31,13,3,8,5,3,1,0,51,36,44,35,1,2,0.5806451612903226,30168021.630000003
PETTERI.NOKELAINEN,20112012,MTL,438.03333333333336,3,3,0,3,6,6,147,278,131,34,61,41,15,6,10,275,452,264,330,8,12,0.5287769784172662,30168062.939999998
PHIL.KESSEL,20112012,TOR,1644.5166666666669,37,26,19,45,82,63,9,28,19,294,536,12,146,14,11,1853,1472,1295,1329,65,69,0.32142857142857145,30168179.925
PHILIP.LARSEN,20112012,DAL,987.55,3,3,5,8,11,6,0,0,0,69,165,89,64,6,8,967,895,832,813,37,32,0,30168092.035
PHILIPPE.CORNET,20112012,EDM,21.15,0,0,1,1,1,0,0,0,0,0,0,2,0,0,0,15,20,15,20,1,1,0,15084011.175
PHILIPPE.DUPUIS,20112012,TOR,314.8666666666667,0,0,0,0,0,0,29,58,29,30,49,37,10,2,7,198,311,181,198,0,3,0.5,30168040.880000003
PIERRE-CEDRIC.LABRIE,20112012,T.B,82.6,0,0,2,2,2,0,3,5,2,5,17,36,5,5,3,66,64,66,64,2,4,0.6,30168024.22
PIERRE-LUC.LETOURNEAU-LEBLOND,20112012,CGY,14.566666666666666,0,0,0,0,0,0,0,0,0,3,4,2,1,1,1,13,14,12,14,1,0,0,30168019.51
PIERRE-MARC.BOUCHARD,20112012,MIN,603.9833333333333,9,7,6,13,22,16,4,16,12,84,141,3,35,7,4,661,473,416,415,18,17,0.25,30168067.53
RADEK.DVORAK,20112012,DAL,1041.3,4,11,5,16,20,15,10,25,15,83,163,51,38,12,6,779,1168,719,873,27,43,0.4,30168118.295
RADEK.MARTINEK,20112012,CBJ,136.06666666666666,1,0,0,0,1,1,0,0,0,10,18,5,5,0,0,98,133,90,104,5,7,0,30168028.799999997
RADIM.VRBATA,20112012,ARI,1712.5500000000002,37,17,13,30,67,54,28,71,43,275,470,76,100,2,16,1779,1436,1210,1162,54,33,0.39436619718309857,30168162.965
RAFFI.TORRES,20112012,ARI,955.9,16,5,7,12,28,21,7,15,8,106,167,140,25,23,28,933,798,811,771,33,30,0.4666666666666667,30168108.935000002
RAITIS.IVANANS,20112012,CGY,11.083333333333334,0,0,0,0,0,0,0,0,0,0,1,3,0,0,0,5,13,5,13,0,1,0,15084010.7
RANDY.JONES,20112012,WPG,577.7666666666667,1,0,1,1,2,1,0,0,0,24,74,23,31,7,4,445,557,425,445,25,20,0,30168057.744999997
RAPHAEL.DIAZ,20112012,MTL,1062.2666666666669,3,3,7,10,13,6,1,2,1,61,167,40,72,4,15,970,1013,764,829,24,30,0.5,30168099.405
RAY.WHITNEY,20112012,ARI,1834.95,26,39,19,58,84,65,15,47,32,219,406,40,100,19,15,2059,1406,1370,1252,66,37,0.3191489361702128,30168168.314999998
REILLY.SMITH,20112012,DAL,25.2,0,0,0,0,0,0,1,1,0,2,4,0,2,0,1,24,33,22,31,0,3,1,30168021.490000002
RENE.BOURQUE,20112012,CGY,652.3333333333333,13,0,3,3,16,13,9,13,4,92,162,48,43,3,15,553,540,345,403,17,20,0.6923076923076923,30168068.515
RENE.BOURQUE,20112012,MTL,702.5,5,3,0,3,8,8,3,7,4,66,156,38,54,5,8,562,698,436,539,11,24,0.42857142857142855,30168077.17
RHETT.RAKHSHANI,20112012,NYI,60.733333333333334,0,0,0,0,0,0,0,0,0,3,11,1,2,2,1,45,81,39,78,0,0,0,30168027.77
RICH.PEVERLEY,20112012,BOS,1111.3666666666668,14,18,14,32,46,32,237,403,166,129,254,27,61,9,12,1160,975,780,725,37,23,0.5880893300248139,30168108.07
RICHARD.PARK,20112012,PIT,612.0333333333333,7,4,3,7,14,11,228,411,183,46,90,29,26,8,7,532,533,486,473,18,20,0.5547445255474452,30168075.675
RICK.NASH,20112012,CBJ,1564.9333333333334,30,22,7,29,59,52,6,19,13,305,505,104,113,42,18,1653,1384,1030,1156,48,55,0.3157894736842105,30168168.335
RILEY.NASH,20112012,CAR,52.86666666666667,0,1,0,1,1,1,11,35,24,2,6,1,0,0,1,44,40,37,36,2,0,0.3142857142857143,30168023.14
RILEY.SHEAHAN,20112012,DET,6.05,0,0,0,0,0,0,0,0,0,3,3,1,0,0,1,4,5,4,5,0,0,0,15084009.85
RJ.UMBERGER,20112012,CBJ,1400.75,20,12,7,19,39,32,150,306,156,200,302,102,49,26,12,1322,1220,819,947,39,44,0.49019607843137253,30168145.384999998
ROB.KLINKHAMMER,20112012,OTT,171.65,0,1,0,1,1,1,2,3,1,26,46,47,7,3,1,176,135,164,118,4,4,0.6666666666666666,30168027.91
ROB.SCUDERI,20112012,L.A,2124.8166666666666,1,3,6,9,10,4,0,0,0,74,185,74,72,5,11,1779,1970,1630,1468,58,60,0,30168145.4
ROBERT.BORTUZZO,20112012,PIT,65.4,0,0,0,0,0,0,0,0,0,3,7,9,2,2,1,63,55,62,50,4,3,0,30168021.82
ROBYN.REGEHR,20112012,BUF,1415.5500000000002,1,1,2,3,4,2,0,0,0,49,104,172,36,14,22,930,1487,876,1072,29,38,0,30168132.54
ROD.PELLEY,20112012,ANA,360.01666666666665,2,1,0,1,3,3,122,244,122,41,64,69,11,5,3,277,371,270,336,6,10,0.5,30168061.73
ROD.PELLEY,20112012,N.J,43.4,0,0,0,0,0,0,3,10,7,3,6,11,2,1,2,27,44,27,41,0,0,0.3,30168023.28
ROMAN.HAMRLIK,20112012,WSH,1618.8666666666668,3,4,10,14,17,7,0,0,0,76,168,89,64,4,23,1424,1620,1306,1335,64,45,0,30168146.090000004
ROMAN.HORAK,20112012,CGY,622.0333333333333,3,5,3,8,11,8,183,441,258,53,88,28,18,6,7,467,538,419,506,18,14,0.41496598639455784,30168087.455
ROMAN.JOSI,20112012,NSH,1144.2333333333333,5,5,6,11,16,10,0,0,0,76,162,36,53,5,12,895,1114,724,959,36,39,0,30168124.65
ROMAN.POLAK,20112012,STL,1638.85,0,3,7,10,10,3,0,0,0,94,203,197,59,11,24,1258,1579,1131,1176,43,43,0,30168133.135
RON.HAINSEY,20112012,WPG,1181.4833333333333,0,8,2,10,10,8,0,0,0,57,135,33,47,2,11,986,1210,860,912,40,34,0,30168107.82
ROSTISLAV.KLESLA,20112012,ARI,1537.1000000000001,5,7,7,14,19,12,1,2,1,111,224,149,66,16,22,1227,1877,1133,1371,51,45,0.5,30168166.375
ROSTISLAV.OLESZ,20112012,CHI,54.633333333333326,0,0,0,0,0,0,0,2,2,6,8,7,2,0,3,34,55,34,55,0,1,0,30168025.1
RUSLAN.FEDOTENKO,20112012,NYR,1298.3000000000002,11,9,7,16,27,20,24,43,19,119,202,115,41,19,12,943,1346,844,1097,36,35,0.5581395348837209,30168150.625
RYAN.CALLAHAN,20112012,NYR,2069.6,35,17,11,28,63,52,13,26,13,289,494,353,110,48,30,1935,1861,1204,1336,44,55,0.5,30168189.725
RYAN.CARTER,20112012,FLA,65.2,0,0,0,0,0,0,18,39,21,3,8,12,4,3,3,41,68,40,56,1,2,0.46153846153846156,30168025.15
RYAN.CARTER,20112012,N.J,880.5999999999999,9,4,2,6,15,13,214,421,207,68,113,134,21,20,33,594,741,568,664,19,27,0.5083135391923991,30168108.61
RYAN.ELLIS,20112012,NSH,495.1666666666667,3,5,3,8,11,8,0,0,0,36,83,33,31,7,2,476,392,374,367,20,13,0,30168053.945
RYAN.GARBUTT,20112012,DAL,165.55,2,1,0,1,3,3,12,27,15,28,53,48,11,5,8,190,129,187,125,4,6,0.4444444444444444,30168030.38
RYAN.GETZLAF,20112012,ANA,1771.15,11,27,19,46,57,38,639,1354,715,185,396,182,107,19,29,1931,1373,1206,1081,41,51,0.47193500738552435,30168164.775
RYAN.HAMILTON,20112012,TOR,26.266666666666666,0,0,1,1,1,0,0,0,0,1,1,5,0,0,1,23,27,23,27,1,2,0,30168021.025
RYAN.JOHANSEN,20112012,CBJ,853.2666666666667,9,9,3,12,21,18,97,215,118,99,170,68,40,7,11,838,651,626,627,26,26,0.4511627906976744,30168093.924999997
RYAN.JONES,20112012,EDM,1218.6166666666668,17,6,9,15,32,23,3,15,12,137,228,119,44,21,18,911,1260,794,922,32,41,0.2,30168131.405
RYAN.KESLER,20112012,VAN,1657.3833333333332,22,15,15,30,52,37,784,1462,678,238,446,118,108,28,28,1932,1344,1192,928,40,31,0.5362517099863201,30168142.615000002
RYAN.MALONE,20112012,T.B,1202.6,20,16,12,28,48,36,29,79,50,144,212,142,19,23,23,1168,1084,794,904,42,45,0.3670886075949367,30168141.54
RYAN.MCDONAGH,20112012,NYR,2564.9833333333336,7,17,10,27,34,24,1,2,1,159,312,157,84,24,27,2141,2591,1860,1917,73,60,0.5,30168216.28
RYAN.NUGENT-HOPKINS,20112012,EDM,1091.5500000000002,18,19,15,34,52,37,227,605,378,134,249,38,63,8,7,1071,913,781,831,43,36,0.37520661157024793,30168136.335
RYAN.O'BYRNE,20112012,COL,1395.2333333333333,1,3,2,5,6,4,0,0,0,42,110,179,40,8,27,997,1426,924,1081,34,38,0,30168131.58
RYAN.O'MARRA,20112012,ANA,16.316666666666666,0,0,0,0,0,0,4,8,4,4,4,5,0,1,0,12,23,12,23,0,1,0.5,15084012.22
RYAN.O'MARRA,20112012,EDM,67.18333333333334,0,0,1,1,1,0,32,57,25,3,4,14,0,0,2,41,55,40,44,1,1,0.5614035087719298,30168023.905
RYAN.O'REILLY,20112012,COL,1581.9666666666667,18,21,16,37,55,39,762,1443,681,188,301,62,64,15,5,1685,1246,1234,1005,44,36,0.5280665280665281,30168152.93
RYAN.REAVES,20112012,STL,407.26666666666665,3,1,0,1,4,4,1,2,1,33,59,179,12,21,29,329,277,320,274,7,7,0.5,30168049.15
RYAN.RUSSELL,20112012,CBJ,478.75,2,0,0,0,2,2,0,5,5,39,64,37,13,2,1,290,484,273,371,6,13,0,30168060.92
RYAN.SHANNON,20112012,T.B,541.4666666666667,4,6,2,8,12,10,21,39,18,46,75,21,12,5,5,461,448,397,380,15,20,0.5384615384615384,30168061.14
RYAN.SMYTH,20112012,EDM,1564.75,19,12,15,27,46,31,66,150,84,193,313,53,41,18,26,1309,1440,938,1082,44,44,0.44,30168158.945
RYAN.SUTER,20112012,NSH,2382.2,8,21,19,40,48,29,0,1,1,164,287,58,70,4,17,2081,2073,1450,1509,59,56,0,30168181.915
RYAN.THANG,20112012,NSH,8.533333333333333,0,0,0,0,0,0,0,0,0,0,0,0,0,0,0,3,3,3,3,0,0,0,15084009.3
RYAN.WHITE,20112012,MTL,290.33333333333337,0,2,0,2,2,2,29,59,30,12,24,61,6,12,15,206,326,186,266,4,11,0.4915254237288136,30168052.380000003
RYAN.WHITNEY,20112012,EDM,1069.1166666666666,3,8,8,16,19,11,0,0,0,41,110,18,44,3,8,904,1035,689,886,25,34,0,30168116.48
RYAN.WILSON,20112012,COL,1105.3166666666666,1,12,8,20,21,13,0,1,1,63,151,97,56,13,12,1068,956,946,803,37,29,0,30168090.23
RYANE.CLOWE,20112012,S.J,1454.8666666666668,17,16,15,31,48,33,6,21,15,190,317,125,73,22,31,1650,1216,1191,1106,39,48,0.2857142857142857,30168144.435000002
SAKU.KOIVU,20112012,ANA,1341.3,11,12,15,27,38,23,644,1231,587,107,193,56,48,16,20,1244,1194,845,871,50,39,0.5231519090170593,30168138.545
SAM.GAGNER,20112012,EDM,1288.7,18,19,10,29,47,37,334,701,367,149,292,21,62,6,14,1222,1044,914,956,47,39,0.4764621968616263,30168147.77
SAMI.LEPISTO,20112012,CHI,294.7,1,0,2,2,3,1,0,0,0,20,42,25,14,4,2,274,263,263,247,12,11,0,30168040.189999998
SAMI.SALO,20112012,VAN,1505,9,8,8,16,25,17,0,0,0,141,300,32,102,8,6,1496,1277,977,928,37,37,0,30168106.83
SAMUEL.PAHLSSON,20112012,CBJ,917.0333333333333,2,5,4,9,11,7,429,839,410,63,126,98,32,10,11,579,881,526,629,17,24,0.5113230035756854,30168104.259999998
SAMUEL.PAHLSSON,20112012,VAN,334.8666666666667,3,3,1,4,7,6,130,227,97,37,56,36,9,3,8,290,349,269,264,10,9,0.5726872246696035,30168051.755
SCOTT.GLENNIE,20112012,DAL,9.583333333333332,0,0,0,0,0,0,0,0,0,0,1,2,1,0,1,11,4,9,3,0,0,0,15084009
SCOTT.GOMEZ,20112012,MTL,537.0833333333334,2,8,1,9,11,10,165,333,168,59,116,11,31,6,6,580,439,429,387,14,17,0.4954954954954955,30168064.384999998
SCOTT.HANNAN,20112012,CGY,1587.7333333333333,2,2,8,10,12,4,1,1,0,49,103,60,28,5,15,1122,1711,1014,1260,49,62,1,30168152.59
SCOTT.HARTNELL,20112012,PHI,1649.4166666666667,40,19,15,34,74,59,24,75,51,258,416,227,66,38,51,2006,1304,1334,1175,66,48,0.32,30168170.564999998
SCOTT.NICHOL,20112012,STL,847.7333333333333,3,6,0,6,9,9,305,524,219,75,115,117,19,15,28,588,748,547,524,10,18,0.5820610687022901,30168086.299999997
SCOTT.PARSE,20112012,L.A,101.51666666666667,2,0,0,0,2,2,1,3,2,9,13,7,1,3,7,81,89,73,85,2,1,0.3333333333333333,30168029.67
SCOTTIE.UPSHALL,20112012,FLA,424.1666666666667,3,2,3,5,8,5,4,8,4,62,112,59,21,10,11,386,347,304,298,8,10,0.5,30168051.585
SEAN.AVERY,20112012,NYR,105.21666666666667,3,0,0,0,3,3,0,3,3,15,31,10,9,8,6,86,85,85,85,4,2,0,30168028.53
SEAN.BERGENHEIM,20112012,FLA,1131.1333333333332,20,5,4,9,29,25,5,13,8,209,329,127,49,23,26,1115,943,867,765,28,38,0.38461538461538464,30168109.83
SEAN.COLLINS,20112012,WSH,21.866666666666667,0,0,0,0,0,0,0,0,0,3,5,0,2,0,0,29,17,28,17,1,2,0,15084009.85
SEAN.COUTURIER,20112012,PHI,1248.2333333333333,16,9,5,14,30,25,444,929,485,134,217,104,49,20,8,880,1206,755,813,36,25,0.47793326157158234,30168133.884999998
SEAN.O'DONNELL,20112012,CHI,709.7166666666667,0,3,3,6,6,3,0,0,0,30,77,47,26,4,10,623,660,604,541,21,32,0,30168066.814999998
SERGEI.GONCHAR,20112012,OTT,1818.8333333333333,6,18,15,33,39,24,0,0,0,137,322,59,123,6,30,1866,1593,1299,1232,45,50,0,30168139.285
SERGEI.KOSTITSYN,20112012,NSH,1392.3833333333332,18,20,7,27,45,38,0,8,8,104,207,51,59,15,18,1072,1296,894,1063,44,39,0,30168149.875
SHANE.DOAN,20112012,ARI,1881,27,18,14,32,59,45,37,70,33,273,513,284,110,28,31,1910,1557,1310,1294,56,51,0.5285714285714286,30168171.41
SHANE.O'BRIEN,20112012,COL,1460.6999999999998,3,12,5,17,20,15,0,0,0,114,228,138,80,19,39,1396,1352,1238,1088,48,51,0,30168120.915
SHAWN.HORCOFF,20112012,EDM,1586.4333333333334,13,13,8,21,34,26,728,1475,747,123,223,62,39,13,13,1339,1493,921,1037,30,45,0.4935593220338983,30168172.299999997
SHAWN.MATTHIAS,20112012,FLA,1168.8833333333332,10,11,4,15,25,21,306,620,314,141,214,69,36,8,18,968,1077,857,881,27,34,0.4935483870967742,30168133.67
SHAWN.THORNTON,20112012,BOS,781.3333333333334,5,7,1,8,13,12,17,42,25,123,201,107,39,29,38,625,708,617,691,17,25,0.40476190476190477,30168103.045
SHEA.WEBER,20112012,NSH,2325.033333333333,21,19,11,30,51,40,0,0,0,263,501,200,115,13,26,2079,2021,1475,1475,65,52,0,30168181.655
SHELDON.BROOKBANK,20112012,ANA,1248.4333333333334,3,4,6,10,13,7,0,0,0,49,132,120,43,15,23,922,1300,869,1064,36,29,0,30168133.1
SHELDON.SOURAY,20112012,DAL,1308.5833333333333,6,8,7,15,21,14,0,0,0,179,354,55,104,11,35,1217,1316,930,941,40,37,0,30168114.485
SIDNEY.CROSBY,20112012,PIT,530.0666666666666,11,19,14,33,44,30,301,588,287,88,158,16,37,9,9,751,388,448,327,36,17,0.5119047619047619,30168070.08
SIMON.DESPRES,20112012,PIT,283.83333333333337,1,1,2,3,4,2,0,0,0,23,48,19,13,1,6,302,206,258,183,12,5,0,30168032.26
SIMON.GAGNE,20112012,L.A,643.85,7,7,3,10,17,14,2,7,5,79,135,18,35,4,10,737,555,514,428,18,21,0.2857142857142857,30168063.244999997
SLAVA.VOYNOV,20112012,L.A,1391.5,9,9,5,14,23,18,1,1,0,114,285,114,97,8,8,1509,1074,1173,986,43,32,1,30168104.845
SPENCER.MACHACEK,20112012,WPG,97.58333333333334,2,4,3,7,9,6,1,1,0,12,24,24,8,2,2,79,84,75,83,10,2,1,30168028.735
STEFAN.ELLIOTT,20112012,COL,668.5333333333333,4,4,5,9,13,8,0,0,0,83,171,3,68,3,3,701,512,527,447,22,17,0,30168055.205
STEPHANE.DA COSTA,20112012,OTT,267.51666666666665,3,2,0,2,5,5,65,177,112,31,63,14,15,3,4,257,191,197,178,8,18,0.3672316384180791,30168041.73
STEPHANE.ROBIDAS,20112012,DAL,1706.1166666666668,5,8,8,16,21,13,0,0,0,75,197,191,79,7,24,1549,1592,1150,1071,42,50,0,30168118.92
STEPHANE.VEILLEUX,20112012,MIN,211.35000000000002,0,0,2,2,2,0,3,10,7,16,32,26,9,3,6,151,196,148,173,4,6,0.3,30168036.8
STEPHANE.VEILLEUX,20112012,N.J,4.566666666666666,0,0,0,0,0,0,0,0,0,0,0,1,0,0,0,0,7,0,7,0,0,0,15084010.05
STEPHEN.GIONTA,20112012,N.J,232.13333333333333,4,4,0,4,8,8,39,97,58,27,37,47,4,0,2,159,211,153,196,11,6,0.4020618556701031,30168046.66
STEPHEN.WEISS,20112012,FLA,1788.5333333333333,23,22,17,39,62,45,846,1594,748,159,284,97,51,19,25,1674,1534,1083,1186,51,50,0.5307402760351317,30168196.755000003
STEVE.BERNIER,20112012,N.J,631.2666666666667,3,4,6,10,13,7,5,20,15,45,73,125,16,10,12,430,499,405,469,21,12,0.25,30168072.15
STEVE.DOWNIE,20112012,COL,342.1166666666667,2,4,7,11,13,6,5,10,5,41,81,32,25,6,9,375,262,316,246,14,5,0.5,30168041.035
STEVE.DOWNIE,20112012,T.B,852.75,12,9,7,16,28,21,35,77,42,99,184,73,49,24,35,880,709,667,656,39,47,0.45454545454545453,30168095.915
STEVE.EMINGER,20112012,NYR,585.0666666666666,2,2,1,3,5,4,0,0,0,21,48,66,17,5,14,420,586,385,471,18,18,0,30168069.925
STEVE.MACINTYRE,20112012,PIT,38.11666666666666,0,0,0,0,0,0,0,0,0,0,3,5,1,1,3,28,31,28,31,0,0,0,30168021.560000002
STEVE.MONTADOR,20112012,CHI,767.5166666666667,5,3,6,9,14,8,0,0,0,57,113,49,33,5,13,779,565,644,514,27,24,0,30168064.35
STEVE.OTT,20112012,DAL,1357.3166666666666,11,15,13,28,39,26,561,1011,450,107,217,278,48,38,48,1323,1243,1029,927,40,39,0.5548961424332344,30168139.145000003
STEVE.STAIOS,20112012,NYI,1110.05,0,5,2,7,7,5,1,1,0,67,135,55,47,11,25,829,1186,782,957,28,45,1,30168121.3
STEVE.SULLIVAN,20112012,PIT,1303.1666666666667,19,16,19,35,54,35,5,10,5,153,248,43,49,11,12,1736,922,998,810,50,42,0.5,30168108.035
STEVEN.KAMPFER,20112012,BOS,104.98333333333333,0,1,1,2,2,1,0,0,0,8,18,7,5,1,2,104,100,99,99,10,4,0,30168026.985
STEVEN.KAMPFER,20112012,MIN,237.26666666666668,2,1,0,1,3,3,0,0,0,11,40,12,20,0,1,207,252,165,213,5,12,0,30168040.6
STEVEN.STAMKOS,20112012,T.B,1805.5666666666666,60,25,12,37,97,85,558,1227,669,303,540,109,128,40,31,1840,1527,1225,1263,80,61,0.4547677261613692,30168219.72
STEVEN.ZALEWSKI,20112012,N.J,73.91666666666666,0,0,0,0,0,0,22,44,22,6,6,11,0,1,0,45,47,44,46,0,2,0.5,30168023.89
STU.BICKEL,20112012,NYR,625.3333333333333,0,6,3,9,9,6,1,1,0,26,71,83,23,23,35,499,547,487,521,21,23,1,30168075.494999997
SVEN.BAERTSCHI,20112012,CGY,55.68333333333333,3,0,0,0,3,3,0,0,0,10,14,5,3,0,3,35,47,29,42,3,1,0,30168025
T.J..OSHIE,20112012,STL,1731.75,19,26,12,38,57,45,28,62,34,201,327,144,56,45,26,1673,1385,1140,1012,48,33,0.45161290322580644,30168141.52
TANNER.GLASS,20112012,WPG,1046.0333333333333,5,6,4,10,15,11,29,73,44,86,138,246,28,16,22,701,1208,659,890,24,36,0.3972602739726027,30168127.52
TAYLOR.CHORNEY,20112012,EDM,47.38333333333334,0,0,0,0,0,0,0,0,0,1,4,0,1,0,0,37,59,32,54,0,1,0,30168024.4
TAYLOR.CHORNEY,20112012,STL,23.333333333333336,0,0,0,0,0,0,0,0,0,1,2,0,1,0,0,8,17,8,16,1,1,0,30168019.75
TAYLOR.HALL,20112012,EDM,1111.3333333333335,27,15,11,26,53,42,23,57,34,207,358,44,82,27,18,1174,883,853,782,41,38,0.40350877192982454,30168116.965
TAYLOR.PYATT,20112012,ARI,1149.4499999999998,13,7,5,12,25,20,6,12,6,138,222,185,44,12,12,1015,1157,938,1123,33,38,0.5,30168150.384999998
TEDDY.PURCELL,20112012,T.B,1306.7,24,28,13,41,65,52,3,17,14,152,272,17,64,12,8,1324,1118,990,1006,62,46,0.17647058823529413,30168143.265
TEEMU.HARTIKAINEN,20112012,EDM,221.2,2,2,1,3,5,4,4,12,8,24,36,36,7,2,4,174,233,173,228,8,8,0.3333333333333333,30168046.055
TEEMU.LAAKSO,20112012,NSH,104.3,0,0,0,0,0,0,0,0,0,4,11,7,6,1,4,74,125,68,112,2,3,0,30168031.009999998
TEEMU.SELANNE,20112012,ANA,1466.3333333333335,26,24,15,39,65,50,145,300,155,210,368,23,64,28,15,1592,1083,917,969,51,47,0.48333333333333334,30168152.105
THEO.PECKHAM,20112012,EDM,911.3,1,1,0,1,2,2,0,0,0,25,63,94,24,17,29,631,1000,592,711,31,32,0,30168093.82
THOMAS.VANEK,20112012,BUF,1320.9333333333334,26,22,13,35,61,48,3,6,3,204,329,34,69,12,26,1384,1111,856,960,48,45,0.5,30168147.265
TIM.BRENT,20112012,CAR,860.0666666666666,12,6,6,12,24,18,278,570,292,71,120,64,24,7,12,695,815,503,681,24,30,0.48771929824561405,30168117.189999998
TIM.CONNOLLY,20112012,TOR,1190.3,13,13,9,22,35,26,383,786,403,104,202,29,47,16,18,1089,1174,802,875,33,43,0.4872773536895674,30168138.455
TIM.ERIXON,20112012,NYR,233.91666666666666,0,1,1,2,2,1,0,0,0,9,18,15,4,2,4,181,211,156,196,8,10,0,30168039.495
TIM.GLEASON,20112012,CAR,1698.2166666666667,1,10,5,15,16,11,0,0,0,65,146,129,49,21,22,1408,1895,1260,1369,49,49,0,30168158.985
TIM.JACKMAN,20112012,CGY,683.9166666666667,1,3,3,6,7,4,15,34,19,103,195,160,48,23,27,591,586,554,571,9,27,0.4411764705882353,30168080.205
TIM.KENNEDY,20112012,FLA,300.6,1,1,0,1,2,2,64,140,76,22,27,48,2,6,2,227,251,206,242,2,12,0.45714285714285713,30168049.270000003
TIM.SESTITO,20112012,N.J,155.38333333333333,0,0,0,0,0,0,32,77,45,6,16,32,6,4,2,83,102,81,102,2,7,0.4155844155844156,30168030.619999997
TIM.STAPLETON,20112012,WPG,639.2166666666667,11,9,6,15,26,20,97,216,119,74,115,27,19,4,6,628,534,436,492,21,15,0.44907407407407407,30168086.72
TIM.WALLACE,20112012,NYI,268.8,0,1,0,1,1,1,4,9,5,16,26,77,7,6,3,212,255,210,247,2,9,0.4444444444444444,30168045.27
TIM.WALLACE,20112012,T.B,152.38333333333333,3,3,2,5,8,6,4,11,7,10,22,27,9,1,5,109,136,105,122,9,5,0.36363636363636365,30168033.82
TJ.BRENNAN,20112012,BUF,155.33333333333334,1,0,0,0,1,1,0,0,0,14,36,20,11,4,3,126,128,115,116,5,5,0,30168029.14
TJ.BRODIE,20112012,CGY,889.8666666666667,2,3,9,12,14,5,0,0,0,44,95,43,34,4,8,810,664,665,624,32,22,0,30168075.615000002
TJ.GALIARDI,20112012,COL,745.4833333333333,8,2,4,6,14,10,72,161,89,101,173,88,41,7,19,656,674,567,555,18,23,0.4472049689440994,30168082.75
TJ.GALIARDI,20112012,S.J,192.71666666666667,1,0,0,0,1,1,5,9,4,13,32,25,8,1,6,158,168,157,168,1,4,0.5555555555555556,30168036.41
TOBIAS.ENSTROM,20112012,WPG,1476.4833333333333,6,11,15,26,32,17,0,0,0,92,180,23,55,9,19,1614,1204,1168,967,53,49,0,30168107.365000002
TOBY.PETERSEN,20112012,DAL,298.5833333333333,2,1,2,3,5,3,3,7,4,44,75,34,8,2,3,283,235,247,208,4,11,0.42857142857142855,30168039.990000002
TODD.BERTUZZI,20112012,DET,1165.8000000000002,14,9,15,24,38,23,6,14,8,125,200,103,32,16,36,1139,830,914,771,50,30,0.42857142857142855,30168103.675
TOM.GILBERT,20112012,EDM,1072.1666666666665,3,5,6,11,14,8,0,0,0,50,124,54,45,10,6,849,973,642,674,27,29,0,30168085
TOM.GILBERT,20112012,MIN,540.1666666666667,0,3,2,5,5,3,0,0,0,22,52,11,16,5,3,443,490,290,341,7,15,0,30168054.6
TOM.KOSTOPOULOS,20112012,CGY,998.2,4,4,4,8,12,8,25,84,59,91,146,124,35,16,19,776,1002,739,802,21,36,0.2976190476190476,30168108.509999998
TOM.PYATT,20112012,T.B,1094.7833333333333,12,4,3,7,19,16,128,281,153,95,142,40,21,16,4,693,1171,618,817,24,39,0.4555160142348754,30168125.604999997
TOM.SESTITO,20112012,PHI,96.51666666666667,0,1,0,1,1,1,2,4,2,4,6,37,1,12,13,70,73,70,73,1,4,0.5,30168028.05
TOM.WANDELL,20112012,DAL,701.0999999999999,6,6,3,9,15,12,141,324,183,103,182,52,42,8,8,684,552,619,522,14,22,0.4351851851851852,30168078.845
TOMAS.FLEISCHMANN,20112012,FLA,1697.2666666666669,28,21,15,36,64,49,14,27,13,230,437,34,117,22,15,1693,1358,1139,1194,50,54,0.5185185185185185,30168161.855
TOMAS.HOLMSTROM,20112012,DET,927.5166666666667,12,7,7,14,26,19,1,1,0,106,166,58,21,20,21,1043,566,556,518,14,16,1,30168084.064999998
TOMAS.KABERLE,20112012,CAR,558.1666666666666,0,3,5,8,8,3,0,0,0,38,82,9,25,0,1,606,459,356,403,12,15,0,30168059.174999997
TOMAS.KABERLE,20112012,MTL,717.6666666666667,3,7,11,18,21,10,0,0,0,49,106,12,33,0,6,800,621,476,537,24,26,0,30168076.325000003
TOMAS.KOPECKY,20112012,FLA,1489.25,11,13,9,22,33,24,142,270,128,154,324,53,93,25,14,1312,1334,918,945,32,41,0.5259259259259259,30168125.655
TOMAS.KUBALIK,20112012,CBJ,106.36666666666666,1,0,1,1,2,1,0,0,0,8,15,6,3,2,3,91,93,75,92,3,5,0,30168028.795
TOMAS.KUNDRATEK,20112012,WSH,48.74999999999999,0,0,0,0,0,0,0,0,0,2,5,3,3,0,1,31,52,31,51,0,0,0,30168023.9
TOMAS.PLEKANEC,20112012,MTL,1680.8,17,21,14,35,52,38,824,1678,854,220,398,67,104,14,26,1516,1646,913,1054,34,46,0.49106078665077474,30168183.75
TOMAS.VINCOUR,20112012,DAL,485.48333333333335,4,4,1,5,9,8,1,9,8,65,123,52,29,3,1,477,391,454,384,11,14,0.1111111111111111,30168055.795
TOMMY.WINGELS,20112012,S.J,506.1666666666667,3,4,3,7,10,7,8,19,11,74,136,119,27,18,8,556,421,493,405,12,12,0.42105263157894735,30168058.325000003
TONI.LYDMAN,20112012,ANA,1398.6833333333334,0,3,8,11,11,3,0,0,0,46,125,134,52,4,23,987,1546,910,1087,43,46,0,30168129.34
TOREY.KRUG,20112012,BOS,34.25,0,0,0,0,0,0,0,0,0,3,7,0,1,0,0,33,35,28,27,2,2,0,30168020.35
TORREY.MITCHELL,20112012,S.J,1010.2666666666667,9,5,6,11,20,14,38,92,54,102,182,98,47,20,16,888,966,842,847,30,37,0.41304347826086957,30168110.92
TRAVIS.HAMONIC,20112012,NYI,1637.1833333333334,2,6,15,21,23,8,0,0,0,124,294,170,105,17,22,1387,1645,1163,1244,50,49,0,30168138.695
TRAVIS.MOEN,20112012,MTL,754.3666666666666,9,5,2,7,16,14,5,12,7,45,82,75,13,13,12,542,803,487,600,22,24,0.4166666666666667,30168092.08
TRAVIS.TURNBULL,20112012,BUF,14.766666666666666,1,0,0,0,1,1,5,10,5,3,3,7,0,1,1,9,13,9,13,1,1,0.5,30168020.560000002
TRAVIS.ZAJAC,20112012,N.J,752.1333333333333,9,8,2,10,19,17,361,652,291,74,125,46,26,5,4,679,595,484,464,16,25,0.553680981595092,30168083.240000002
TRENT.HUNTER,20112012,L.A,383.75,2,3,2,5,7,5,4,24,20,51,90,72,19,6,4,378,281,321,275,8,12,0.16666666666666666,30168046.52
TRENT.WHITFIELD,20112012,BOS,13.983333333333334,0,0,0,0,0,0,0,0,0,1,2,2,0,0,0,16,13,16,7,0,0,0,15084009.3
TREVOR.DALEY,20112012,DAL,1710.1666666666665,4,10,9,19,23,14,0,0,0,134,283,45,87,8,18,1497,1757,1136,1260,47,51,0,30168148.555
TREVOR.GILLIES,20112012,NYI,8.616666666666667,0,0,0,0,0,0,0,0,0,1,1,2,0,0,0,1,9,1,9,0,1,0,30168019.35
TREVOR.LEWIS,20112012,L.A,1251.1166666666668,6,4,6,10,16,10,97,219,122,140,249,182,40,21,10,967,1055,869,800,23,21,0.4429223744292237,30168105.79
TREVOR.SMITH,20112012,T.B,199.45,2,2,1,3,5,4,34,83,49,17,25,19,5,1,2,126,189,119,160,9,8,0.40963855421686746,30168039.795
TROY.BROUWER,20112012,WSH,1674.4166666666667,20,9,7,16,36,29,48,99,51,155,291,286,64,32,23,1474,1599,1071,1215,41,51,0.48484848484848486,30168164.015
TUOMO.RUUTU,20112012,CAR,1185.1666666666665,18,9,7,16,34,27,44,124,80,156,271,151,60,29,23,1287,1066,926,966,46,40,0.3548387096774194,30168133.875
TY.WISHART,20112012,NYI,17.266666666666666,0,0,0,0,0,0,0,0,0,0,0,1,0,0,0,8,15,8,14,0,0,0,15084010.7
TYLER.BOZAK,20112012,TOR,1375.4666666666667,18,17,10,27,45,35,631,1198,567,109,200,117,37,10,11,1443,1298,1010,1115,49,57,0.5267111853088481,30168173.79
TYLER.CUMA,20112012,MIN,11.15,0,0,0,0,0,0,0,0,0,0,2,2,2,0,1,10,8,9,7,0,0,0,15084009.45
TYLER.ENNIS,20112012,BUF,775.85,15,11,8,19,34,26,145,316,171,82,155,25,44,10,8,744,697,585,621,35,18,0.4588607594936709,30168099.700000003
TYLER.KENNEDY,20112012,PIT,948.1166666666667,14,19,6,25,39,33,43,92,49,210,351,83,74,12,11,1066,704,882,656,37,27,0.4673913043478261,30168090.64
TYLER.MYERS,20112012,BUF,1236.95,8,10,5,15,23,18,0,0,0,84,190,78,59,5,15,1097,1232,800,919,37,28,0,30168119.424999997
TYLER.SEGUIN,20112012,BOS,1499.7333333333333,31,22,17,39,70,53,45,111,66,273,479,30,105,21,15,1808,1047,1403,963,75,43,0.40540540540540543,30168119.335
TYSON.BARRIE,20112012,COL,176.46666666666667,0,0,0,0,0,0,0,0,0,15,32,9,11,0,0,201,147,157,134,5,5,0,30168028.6
TYSON.STRACHAN,20112012,FLA,242.2,1,2,1,3,4,3,0,0,0,14,35,34,9,1,1,179,204,177,193,8,5,0,30168038.285
VALTTERI.FILPPULA,20112012,DET,1575.6166666666668,23,30,15,45,68,53,205,395,190,155,276,42,58,17,8,1575,1246,1132,1030,67,49,0.5189873417721519,30168147.445
VERNON.FIDDLER,20112012,DAL,1145.9166666666665,8,7,6,13,21,15,533,1047,514,123,214,82,41,28,21,853,1283,765,924,24,38,0.5090735434574976,30168148.450000003
VICTOR.HEDMAN,20112012,T.B,1409.0666666666666,5,9,9,18,23,14,0,0,0,82,192,96,68,16,26,1130,1442,942,1027,47,50,0,30168124.985
VICTOR.ORESKOVICH,20112012,VAN,6.283333333333333,0,0,0,0,0,0,0,0,0,0,0,1,0,1,2,2,11,1,10,0,0,0,15084010.76
VIKTOR.STALBERG,20112012,CHI,1200.9333333333334,22,14,9,23,45,36,5,12,7,235,397,102,71,20,22,1313,986,1229,937,53,49,0.4166666666666667,30168117.825
VILLE.LEINO,20112012,BUF,1130.5666666666666,8,8,9,17,25,16,95,230,135,78,165,41,45,17,7,1093,959,956,897,37,38,0.41304347826086957,30168114.045
VINCENT.LECAVALIER,20112012,T.B,1211.6,22,14,13,27,49,36,556,1162,606,182,308,103,64,16,20,1304,1071,864,905,47,43,0.4784853700516351,30168154.975
VINNY.PROSPAL,20112012,CBJ,1466.7166666666667,16,25,13,38,54,41,9,22,13,165,259,59,52,9,15,1653,1143,1087,1039,54,51,0.4090909090909091,30168140.674999997
VLADIMIR.SOBOTKA,20112012,STL,1274.8666666666666,6,10,5,15,21,16,329,581,252,122,219,179,42,12,23,1099,1175,929,870,31,22,0.5662650602409639,30168120.155
VLADIMIR.ZHARKOV,20112012,N.J,19.516666666666666,0,0,0,0,0,0,0,0,0,0,2,1,1,1,0,23,12,22,12,0,2,0,30168018.560000002
WARREN.PETERS,20112012,MIN,613.8499999999999,1,2,2,4,5,3,255,465,210,54,108,70,26,11,17,405,672,387,548,6,21,0.5483870967741935,30168091.31
WAYNE.SIMMONDS,20112012,PHI,1467.7833333333333,29,15,10,25,54,44,7,18,11,212,344,165,69,38,38,1645,1187,1025,1084,47,49,0.3888888888888889,30168158.41
WILLIE.MITCHELL,20112012,L.A,2195.866666666667,6,6,14,20,26,12,0,1,1,134,319,103,120,15,27,1934,2129,1599,1425,52,41,0,30168145.5
WOJTEK.WOLSKI,20112012,FLA,345.4666666666667,4,3,2,5,9,7,4,10,6,43,77,31,16,4,2,340,280,271,264,10,12,0.4,30168047.5
WOJTEK.WOLSKI,20112012,NYR,102,0,0,3,3,3,0,1,1,0,11,19,8,5,0,1,86,91,72,87,3,5,1,30168027.165
YANNICK.WEBER,20112012,MTL,937.1333333333334,4,7,7,14,18,11,0,0,0,88,197,49,76,7,14,875,837,560,680,22,24,0,30168091.045
ZAC.DALPE,20112012,CAR,153.31666666666666,1,2,0,2,3,3,5,11,6,20,36,16,6,0,2,137,156,116,151,5,8,0.45454545454545453,30168036.55
ZAC.RINALDO,20112012,PHI,522.1333333333333,2,5,2,7,9,7,6,9,3,56,98,190,24,36,64,407,478,404,473,18,21,0.6666666666666666,30168079.6
ZACH.BOGOSIAN,20112012,WPG,1515.55,5,11,14,25,30,16,0,0,0,150,349,117,110,10,23,1447,1546,1061,1079,40,45,0,30168125.95
ZACH.BOYCHUK,20112012,CAR,142.71666666666667,0,1,1,2,2,1,2,4,2,10,20,16,7,3,0,136,111,117,103,3,6,0.5,30168027.335
ZACH.HAMILL,20112012,BOS,175.81666666666666,0,2,0,2,2,2,15,31,16,13,27,13,8,5,1,145,138,129,132,7,3,0.4838709677419355,30168031.7
ZACH.PARISE,20112012,N.J,2262.8,38,32,13,45,83,70,30,65,35,378,543,121,64,45,18,2124,1731,1347,1247,60,65,0.46153846153846156,30168187.775
ZACK.KASSIAN,20112012,BUF,322.1166666666667,3,4,0,4,7,7,7,14,7,36,68,39,18,6,7,284,247,250,234,10,10,0.5,30168043.89
ZACK.KASSIAN,20112012,VAN,194.25,1,1,1,2,3,2,4,9,5,19,34,45,8,4,7,181,183,181,182,6,6,0.4444444444444444,30168037.725
ZACK.SMITH,20112012,OTT,1233.4666666666667,14,5,8,13,27,19,520,1056,536,147,302,183,76,37,37,1109,1279,988,937,36,39,0.49242424242424243,30168140.369999997
ZACK.STORTINI,20112012,NSH,4.883333333333334,0,0,0,0,0,0,0,0,0,1,1,1,0,1,2,2,4,2,4,0,0,0,15084009.86
ZBYNEK.MICHALEK,20112012,PIT,1469.1166666666668,2,4,7,11,13,6,0,0,0,81,191,53,67,14,12,1204,1390,1072,980,47,52,0,30168104.415
ZDENO.CHARA,20112012,BOS,2166.883333333333,13,20,19,39,52,33,0,1,1,244,526,192,187,22,37,2365,1784,1775,1272,80,55,0,30168119.545
ZENON.KONOPKA,20112012,OTT,499.2166666666667,3,3,1,4,7,6,285,469,184,36,58,59,10,30,43,384,517,346,382,8,12,0.6076759061833689,30168074.025
AARON.GAGNON,20122013,WPG,81.53333333333333,3,0,0,0,3,3,30,57,27,11,17,7,3,1,1,65,74,64,63,5,4,0.5263157894736842,30183028.41
AARON.JOHNSON,20122013,BOS,148.7,0,0,0,0,0,0,0,0,0,8,23,18,12,1,5,161,111,145,96,4,4,0,30183025.41
AARON.PALUSHAJ,20122013,COL,282.8833333333333,1,3,4,7,8,4,2,8,6,28,48,31,12,8,4,265,260,248,244,12,14,0.25,30183045.11
AARON.ROME,20122013,DAL,414.01666666666665,0,3,2,5,5,3,0,0,0,15,40,43,19,4,8,312,445,292,362,13,16,0,30183058.189999998
AARON.VOLPATTI,20122013,VAN,117,1,0,0,0,1,1,0,2,2,11,21,42,6,5,8,84,84,80,82,2,2,0,30183029.200000003
AARON.VOLPATTI,20122013,WSH,158.13333333333333,0,1,0,1,1,1,1,2,1,10,21,38,4,2,2,111,154,111,154,3,5,0.5,30183037.41
ADAM.BURISH,20122013,S.J,547.6666666666667,1,1,1,2,3,2,142,254,112,48,85,72,18,20,11,384,609,367,483,4,10,0.5590551181102362,30183080.055
ADAM.CRACKNELL,20122013,STL,212.21666666666667,2,2,2,4,6,4,7,28,21,26,49,38,12,2,2,198,159,198,157,6,4,0.25,30183035.700000003
ADAM.HALL,20122013,CAR,63.08333333333333,0,0,0,0,0,0,2,8,6,3,9,19,3,0,0,49,55,49,48,0,2,0.25,30183024.23
ADAM.HALL,20122013,PHI,120.76666666666667,0,0,0,0,0,0,46,78,32,15,22,12,1,1,0,74,140,62,94,2,4,0.5897435897435898,30183031.95
ADAM.HALL,20122013,T.B,205.83333333333331,0,3,1,4,4,3,92,164,72,16,21,28,1,6,6,90,222,82,150,4,2,0.5609756097560976,30183043.315
ADAM.HENRIQUE,20122013,N.J,769.3666666666667,11,5,0,5,16,16,333,680,347,78,140,27,24,12,8,734,535,501,378,16,18,0.48970588235294116,30183074.84
ADAM.LARSSON,20122013,N.J,669.75,0,3,3,6,6,3,0,0,0,30,68,37,28,7,NA,481,484,429,399,21,21,0,NA
ADAM.MCQUAID,20122013,BOS,782.4,3,2,3,5,8,5,0,0,0,37,104,121,43,13,26,708,691,700,626,27,19,0,30183077.205
ADAM.PARDY,20122013,BUF,280.6166666666667,0,1,3,4,4,1,0,0,0,6,17,24,6,2,6,188,260,178,224,11,7,0,30183043.645
ADRIAN.AUCOIN,20122013,CBJ,588,0,2,2,4,4,2,0,0,0,26,65,43,27,3,8,411,512,387,434,13,19,0,30183063.03
AKIM.ALIU,20122013,CGY,54.31666666666666,0,0,0,0,0,0,0,0,0,2,5,5,2,3,2,37,58,32,57,0,2,0,30183026.58
ALEC.MARTINEZ,20122013,L.A,525.25,1,1,2,3,4,2,0,0,0,34,80,33,23,1,9,520,374,437,319,10,17,0,30183045.01
ALES.HEMSKY,20122013,EDM,596.7333333333333,9,5,6,11,20,14,12,24,12,82,130,11,31,4,9,539,527,367,466,16,18,0.5,30183079.47
ALEX.BOLDUC,20122013,ARI,106.76666666666667,0,0,0,0,0,0,6,20,14,17,24,21,4,2,1,93,102,90,101,2,6,0.3,30183030.91
ALEX.BURMISTROV,20122013,WPG,688.15,4,3,3,6,10,7,142,301,159,55,113,106,32,13,7,599,583,508,477,17,17,0.4717607973421927,30183073.435000002
ALEX.BURROWS,20122013,VAN,971,15,8,4,12,27,23,48,109,61,150,235,57,37,22,27,1002,739,692,492,37,16,0.44036697247706424,30183077.14
ALEX.CHIASSON,20122013,DAL,98.56666666666666,6,1,0,1,7,7,5,18,13,13,20,10,4,0,0,87,99,69,96,6,3,0.2777777777777778,30183034.95
ALEX.EDLER,20122013,VAN,1180.9833333333336,9,4,9,13,22,13,1,1,0,124,276,85,102,13,18,1154,953,785,726,30,33,1,30183087.545
ALEX.GALCHENYUK,20122013,MTL,656.4166666666667,10,15,5,20,30,25,67,160,93,94,165,28,31,7,11,690,577,586,553,34,21,0.41875,30183089.425
ALEX.GOLIGOSKI,20122013,DAL,1052.1166666666668,3,11,13,24,27,14,0,0,0,80,202,56,67,10,9,1002,924,760,739,41,33,0,30183090.725
ALEX.KILLORN,20122013,T.B,639.1166666666667,7,7,5,12,19,14,11,28,17,82,134,40,30,8,7,545,554,425,454,21,26,0.39285714285714285,30183073.795
ALEX.KOVALEV,20122013,FLA,218.58333333333331,2,2,1,3,5,4,1,3,2,21,44,7,13,2,3,220,158,147,147,3,5,0.3333333333333333,30183035.985
ALEX.OVECHKIN,20122013,WSH,1147.6166666666668,33,13,12,25,58,46,0,1,1,249,510,154,149,27,20,1353,986,861,850,38,35,0,30183122.82
ALEX.PETROVIC,20122013,FLA,112.68333333333332,0,0,0,0,0,0,0,0,0,5,16,10,7,2,6,99,101,94,94,1,9,0,30183028.869999997
ALEX.PIETRANGELO,20122013,STL,1339.6833333333334,6,11,9,20,26,17,0,0,0,107,255,32,81,10,6,1222,1112,861,797,38,34,0,30183095.424999997
ALEX.SEMIN,20122013,CAR,921.4833333333333,13,20,11,31,44,33,5,21,16,150,323,14,96,9,19,1094,860,736,720,45,27,0.23809523809523808,30183101.665
ALEX.STEEN,20122013,STL,884.9499999999999,11,10,8,18,29,21,99,212,113,146,273,32,63,9,10,903,700,618,507,27,19,0.4669811320754717,30183078.5
ALEX.SULZER,20122013,BUF,280.9166666666667,3,0,1,1,4,3,0,0,0,15,31,5,10,3,5,265,280,245,234,11,9,0,30183042.905
ALEX.TANGUAY,20122013,CGY,774.3666666666667,11,10,6,16,27,21,68,173,105,44,84,24,20,3,11,694,667,475,536,19,33,0.3930635838150289,30183092.4
ALEX.URBOM,20122013,N.J,14.183333333333334,0,0,0,0,0,0,0,0,0,0,1,1,0,0,0,7,9,7,8,0,1,0,15091510.6
ALEXEI.EMELIN,20122013,MTL,747.3333333333334,3,4,3,7,10,7,0,0,0,33,103,109,45,9,12,646,714,579,547,26,25,0,30183070.015
ALEXEI.PONIKAROVSKY,20122013,N.J,410.2166666666667,2,1,3,4,6,3,2,5,3,41,75,67,12,1,NA,368,261,341,234,13,10,0.4,NA
ALEXEI.PONIKAROVSKY,20122013,WPG,142.45,2,0,0,0,2,2,0,2,2,10,25,14,7,2,3,120,114,115,103,3,5,0,30183030.17
ANDERS.LEE,20122013,NYI,16.4,1,0,0,0,1,1,0,2,2,2,4,0,1,0,0,13,13,13,13,1,4,0,15091511.65
ANDRE.BENOIT,20122013,OTT,619.0833333333333,3,3,7,10,13,6,0,0,0,58,138,37,50,3,4,707,533,562,458,17,16,0,30183057.854999997
ANDREAS.LILJA,20122013,PHI,67.11666666666667,0,0,0,0,0,0,0,0,0,2,7,12,2,0,0,54,77,52,66,1,2,0,30183026.45
ANDREAS.NODL,20122013,CAR,67.75,0,0,1,1,1,0,1,3,2,6,11,13,2,0,1,56,56,52,47,1,2,0.3333333333333333,30183024.115000002
ANDREI.LOKTIONOV,20122013,N.J,399.1333333333333,8,3,1,4,12,11,80,206,126,46,75,6,15,4,3,389,245,319,220,13,13,0.3883495145631068,30183047.965
ANDREI.MARKOV,20122013,MTL,1277.6833333333334,10,13,7,20,30,23,0,0,0,86,196,27,69,9,7,1354,1073,838,749,30,35,0,30183095.215
ANDREJ.MESZAROS,20122013,PHI,202.21666666666667,0,1,0,1,1,1,0,0,0,18,42,18,18,2,1,149,216,110,175,2,7,0,30183038.87
ANDREJ.SEKERA,20122013,BUF,784.7,2,4,6,10,12,6,0,0,0,33,85,30,37,2,2,607,835,498,650,23,27,0,30183089.119999997
ANDREJ.SUSTR,20122013,T.B,21.43333333333333,0,0,0,0,0,0,0,0,0,2,3,0,0,0,0,16,17,16,17,1,0,0,15091511.45
ANDREW.ALBERTS,20122013,VAN,416.6166666666667,0,1,0,1,1,1,0,0,0,16,47,49,20,5,9,307,377,295,320,6,15,0,30183051.6
ANDREW.COGLIANO,20122013,ANA,848.1166666666667,13,7,4,11,24,20,33,96,63,89,161,60,43,16,5,723,760,648,596,28,20,0.34375,30183087.28
ANDREW.DESJARDINS,20122013,S.J,545.7666666666667,2,1,0,1,3,3,55,107,52,60,103,79,20,18,17,434,561,426,476,9,13,0.514018691588785,30183074.98
ANDREW.EBBETT,20122013,VAN,354.05,1,4,1,5,6,5,106,270,164,25,NA,18,NA,2,2,259,373,233,316,9,10,0.3925925925925926,NA
ANDREW.FERENCE,20122013,BOS,1278.7666666666667,4,6,4,10,14,10,0,0,0,85,216,140,82,11,17,1146,1244,1036,1004,39,35,0,30183113.46
ANDREW.GORDON,20122013,VAN,50.53333333333333,0,0,0,0,0,0,2,5,3,2,5,4,2,1,0,38,40,38,40,0,1,0.4,30183023.54
ANDREW.LADD,20122013,WPG,944.6666666666666,18,14,14,28,46,32,29,54,25,121,227,98,46,7,8,1031,870,746,697,40,30,0.5370370370370371,30183103.48
ANDREW.MACDONALD,20122013,NYI,1222.9,3,3,5,8,11,6,0,0,0,52,127,29,51,6,NA,1041,1293,839,947,33,41,0,NA
ANDREW.MURRAY,20122013,STL,7.816666666666666,0,0,0,0,0,0,0,0,0,2,2,1,0,0,0,8,4,8,4,0,0,0,15091510.05
ANDREW.SHAW,20122013,CHI,1063.4333333333334,14,6,3,9,23,20,286,636,350,99,166,136,39,33,28,1051,742,794,671,29,22,0.449685534591195,30183107.695
ANDY.GREENE,20122013,N.J,1105.9666666666667,4,4,8,12,16,8,0,0,0,63,162,47,63,10,9,897,739,665,527,28,20,0,30183061.85
ANDY.MCDONALD,20122013,STL,743.55,7,9,5,14,21,16,116,228,112,96,156,12,31,13,8,741,569,500,476,21,17,0.5087719298245614,30183078.895
ANDY.MIELE,20122013,ARI,9.033333333333333,0,0,0,0,0,0,2,3,1,0,1,2,0,1,0,12,5,12,5,1,0,0.6666666666666666,15091509.79
ANTHONY.PELUSO,20122013,WPG,24.983333333333334,0,2,0,2,2,2,0,0,0,4,4,7,0,2,4,28,15,27,15,2,1,0,30183022.020000003
ANTOINE.ROUSSEL,20122013,DAL,366.58333333333337,7,4,3,7,14,11,30,55,25,46,69,75,8,18,19,287,381,274,345,17,15,0.5454545454545454,30183067.405
ANTOINE.VERMETTE,20122013,ARI,875.8,13,3,5,8,21,16,481,838,357,91,157,63,28,16,17,848,829,584,611,25,26,0.5739856801909308,30183105.425
ANTON.BABCHUK,20122013,CGY,82.94999999999999,0,0,0,0,0,0,0,0,0,5,13,1,5,0,0,62,86,59,86,3,4,0,30183028.5
ANTON.LANDER,20122013,EDM,121.30000000000001,0,1,0,1,1,1,27,55,28,11,16,7,4,1,1,88,126,81,89,0,5,0.4909090909090909,30183030.590000004
ANTON.STRALMAN,20122013,NYR,1077.3333333333333,4,2,1,3,7,6,0,1,1,76,174,91,69,10,8,1050,904,922,783,46,33,0,30183082.725
ANTON.VOLCHENKOV,20122013,N.J,593.95,1,1,3,4,5,2,0,0,0,38,77,51,20,5,13,446,487,398,326,12,19,0,30183049.075
ANTTI.MIETTINEN,20122013,WPG,278.28333333333336,3,0,2,2,5,3,0,4,4,26,46,29,10,0,1,235,290,229,271,12,16,0,30183049.3
ANZE.KOPITAR,20122013,L.A,1345,13,22,16,38,51,35,646,1222,576,130,242,116,49,13,14,1509,1005,1057,778,39,30,0.5286415711947627,30183123.619999997
ARRON.ASHAM,20122013,NYR,245.75,4,0,0,0,4,4,5,10,5,21,33,54,7,12,NA,171,248,165,246,6,4,0.5,NA
ARTEM.ANISIMOV,20122013,CBJ,574.3,11,4,3,7,18,15,249,509,260,68,126,13,35,4,6,477,487,332,383,16,18,0.48919449901768175,30183077.675
AUSTIN.WATSON,20122013,NSH,76.23333333333333,1,0,0,0,1,1,19,44,25,4,12,2,4,0,0,64,63,53,55,2,4,0.4318181818181818,30183026.16
B.J..CROMBEEN,20122013,T.B,487.6333333333333,1,5,2,7,8,6,4,20,16,50,84,44,12,17,27,318,489,304,358,10,7,0.2,30183065.78
BARRET.JACKMAN,20122013,STL,1009.9999999999999,4,7,2,9,13,11,0,0,0,46,100,81,41,8,20,707,949,645,716,34,28,0,30183095.58
BEAU.BENNETT,20122013,PIT,386.3,4,4,7,11,15,8,1,4,3,41,68,37,11,5,3,374,332,283,322,18,9,0.25,30183057.515
BEN.EAGER,20122013,EDM,135.23333333333335,1,0,1,1,2,1,0,0,0,14,NA,40,NA,2,6,94,173,93,170,2,5,0,NA
BEN.HANOWSKI,20122013,CGY,66.46666666666667,1,0,0,0,1,1,0,2,2,4,9,8,2,0,0,38,76,34,74,2,2,0,30183029.3
BEN.LOVEJOY,20122013,ANA,730.7166666666667,0,5,7,12,12,5,0,0,0,64,119,90,34,5,12,681,639,566,557,25,19,0,30183074.225
BEN.LOVEJOY,20122013,PIT,40.81666666666666,0,0,0,0,0,0,0,0,0,7,10,2,1,0,0,49,45,46,43,1,3,0,30183023.7
BEN.SMITH,20122013,CHI,28.733333333333334,1,0,0,0,1,1,0,3,3,2,4,1,2,0,0,22,25,20,20,1,1,0,15091512.25
BEN.STREET,20122013,CGY,81.65,0,0,1,1,1,0,24,51,27,13,23,8,5,0,0,64,70,59,59,0,3,0.47058823529411764,30183026.485
BENN.FERRIERO,20122013,NYR,38.43333333333334,0,1,0,1,1,1,2,9,7,4,9,4,1,0,1,46,26,45,24,1,1,0.2222222222222222,30183021.78
BENOIT.POULIOT,20122013,T.B,450.0333333333333,8,6,5,11,19,14,10,31,21,60,100,35,16,11,6,443,370,361,350,25,15,0.3225806451612903,30183062.035
BILL.SWEATT,20122013,VAN,12.399999999999999,0,0,0,0,0,0,0,0,0,0,1,0,0,0,0,7,12,7,12,0,1,0,15091511.2
BLAIR.JONES,20122013,CGY,161.13333333333333,0,0,1,1,1,0,58,109,51,22,33,22,7,4,5,124,160,120,141,1,7,0.5321100917431193,30183037.384999998
BLAKE.COMEAU,20122013,CBJ,105.15,2,3,0,3,5,5,3,5,2,4,11,23,4,0,3,113,95,110,85,6,2,0.6,30183029.020000003
BLAKE.COMEAU,20122013,CGY,405.3833333333333,4,1,2,3,7,5,37,80,43,44,84,72,22,3,7,309,405,294,329,9,18,0.4625,30183058.060000002
BLAKE.WHEELER,20122013,WPG,902.4166666666666,19,16,6,22,41,35,4,18,14,129,228,90,42,14,8,1009,817,736,734,35,39,0.2222222222222222,30183112.25
BOBBY.BUTLER,20122013,N.J,139.66666666666669,1,1,0,1,2,2,2,4,2,13,28,8,9,2,0,121,88,88,82,0,3,0.5,30183028.049999997
BOBBY.BUTLER,20122013,NSH,227.65,3,3,3,6,9,6,0,1,1,28,43,7,8,5,2,209,146,151,138,8,10,0,30183036.025
BOBBY.RYAN,20122013,ANA,876.9333333333333,13,11,10,21,34,24,27,85,58,115,214,94,49,14,9,885,743,647,672,28,25,0.3176470588235294,30183102.17
BOBBY.SANGUINETTI,20122013,CAR,545.85,2,3,1,4,6,5,0,1,1,48,93,50,29,8,2,608,507,543,405,17,23,0,30183052.155
BOYD.GORDON,20122013,ARI,720.5333333333333,4,8,2,10,14,12,452,789,337,59,101,22,16,5,4,547,733,508,469,18,18,0.5728770595690748,30183082.630000003
BRACKEN.KEARNS,20122013,S.J,65.33333333333333,0,0,0,0,0,0,0,0,0,4,7,17,2,0,1,43,51,43,51,0,1,0,30183025.049999997
BRAD.BOYES,20122013,NYI,988.6833333333334,10,18,10,28,38,28,5,17,12,109,216,54,55,8,8,1124,774,772,715,31,35,0.29411764705882354,30183100.18
BRAD.MALONE,20122013,COL,114.25,1,0,1,1,2,1,22,46,24,10,23,39,9,3,5,92,97,90,93,3,10,0.4782608695652174,30183030.185
BRAD.MARCHAND,20122013,BOS,1194.2,22,16,10,26,48,38,10,27,17,148,248,62,49,28,22,1345,928,1083,785,44,22,0.37037037037037035,30183105.83
BRAD.RICHARDS,20122013,NYR,1012.8333333333333,12,13,9,22,34,25,435,867,432,128,260,32,81,6,8,1138,866,795,757,32,27,0.5017301038062284,30183117.485
BRAD.RICHARDSON,20122013,L.A,292.81666666666666,1,3,3,6,7,4,36,80,44,37,70,39,16,7,5,259,236,237,196,8,9,0.45,30183040.534999996
BRAD.STAUBITZ,20122013,ANA,93.21666666666667,1,1,0,1,2,2,0,0,0,5,10,31,3,3,8,60,104,60,104,2,2,0,30183034.08
BRAD.STUART,20122013,S.J,1192.6666666666667,1,3,5,8,9,4,0,0,0,49,154,117,70,8,12,957,1317,884,972,36,29,0,30183112.255000003
BRANDON.BOLLIG,20122013,CHI,244.58333333333331,0,0,0,0,0,0,0,3,3,40,62,61,11,11,15,231,168,227,159,6,7,0,30183033.96
BRANDON.DUBINSKY,20122013,CBJ,533.7666666666667,2,10,8,18,20,12,256,439,183,50,90,64,18,12,15,494,424,317,269,14,11,0.5831435079726651,30183058.16
BRANDON.MANNING,20122013,PHI,88.81666666666666,0,2,0,2,2,2,0,0,0,5,9,15,2,0,0,77,100,73,100,8,4,0,30183030.700000003
BRANDON.MASHINTER,20122013,NYR,23.666666666666664,0,0,0,0,0,0,1,1,0,2,4,7,2,0,0,21,18,21,18,0,2,1,30183020.939999998
BRANDON.MCMILLAN,20122013,ANA,52.449999999999996,0,0,1,1,1,0,12,26,14,2,6,4,1,1,1,39,56,36,47,1,2,0.46153846153846156,30183025.365
BRANDON.PIRRI,20122013,CHI,17.916666666666668,0,0,0,0,0,0,6,14,8,2,3,1,0,0,0,16,12,14,12,0,0,0.42857142857142855,15091511.29
BRANDON.PRUST,20122013,MTL,579.9000000000001,5,8,2,10,15,13,27,60,33,46,72,106,16,21,38,499,534,444,425,24,15,0.45,30183072.689999998
BRANDON.SAAD,20122013,CHI,1134.3666666666668,11,13,9,22,33,24,24,63,39,148,249,71,50,20,8,1141,801,919,655,40,21,0.38095238095238093,30183084.335
BRANDON.SEGAL,20122013,NYR,5.35,0,0,0,0,0,0,0,0,0,0,0,0,0,0,1,2,6,2,4,0,0,0,15091510.4
BRANDON.SUTTER,20122013,PIT,1031.9833333333333,13,5,4,9,22,18,508,1010,502,107,175,47,30,9,1,745,1086,627,852,24,25,0.502970297029703,30183145.61
BRANDON.YIP,20122013,NSH,408.55,3,3,2,5,8,6,8,21,13,35,54,46,7,8,10,269,404,252,358,10,11,0.38095238095238093,30183065.85
BRAYDEN.SCHENN,20122013,PHI,729.8666666666666,8,11,7,18,26,19,206,452,246,78,145,109,36,14,9,733,630,534,584,22,28,0.4557522123893805,30183099.505
BRAYDON.COBURN,20122013,PHI,746.3333333333333,1,3,1,4,5,4,0,0,0,38,102,76,35,4,19,582,785,516,571,18,28,0,30183078.615000002
BRENDAN.GALLAGHER,20122013,MTL,682.1666666666667,17,8,5,13,30,25,11,34,23,139,246,50,63,23,15,865,515,667,475,36,30,0.3235294117647059,30183069.695
BRENDAN.MIKKELSON,20122013,T.B,39.03333333333333,0,1,0,1,1,1,0,0,0,0,2,3,2,1,2,27,42,23,42,2,1,0,15091515.16
BRENDAN.SMITH,20122013,DET,893.4,2,0,9,9,11,2,0,0,0,50,128,32,50,18,21,807,714,683,573,18,22,0,30183069.005000003
BRENDEN.DILLON,20122013,DAL,1026.2333333333333,3,1,4,5,8,4,0,0,0,75,161,133,50,11,24,876,1045,785,763,33,34,0,30183092.66
BRENDEN.MORROW,20122013,DAL,432.8166666666667,6,2,2,4,10,8,13,23,10,31,55,48,12,12,9,401,343,281,311,13,21,0.5652173913043478,30183057.189999998
BRENDEN.MORROW,20122013,PIT,414.1666666666667,7,7,3,10,17,14,1,4,3,32,58,77,13,14,12,323,401,249,376,18,14,0.25,30183071.455
BRENT.BURNS,20122013,S.J,684.5833333333334,11,8,5,13,24,19,6,19,13,112,218,90,61,3,13,811,551,620,501,25,22,0.3157894736842105,30183071.395
BRENT.SEABROOK,20122013,CHI,1564.8000000000002,11,5,8,13,24,16,0,0,0,104,222,186,75,4,12,1478,1362,1121,997,44,35,0,30183113.240000002
BRETT.BELLEMORE,20122013,CAR,110.11666666666667,0,1,1,2,2,1,0,0,0,3,18,14,8,4,2,104,110,97,86,2,4,0,30183027.165
BRETT.CARSON,20122013,CGY,109.28333333333333,0,0,1,1,1,0,0,0,0,8,13,4,2,0,0,93,104,88,103,3,4,0,30183030.275
BRETT.CLARK,20122013,MIN,112.53333333333333,0,1,0,1,1,1,0,0,0,6,18,5,10,0,0,92,104,82,95,2,10,0,30183028.700000003
BRETT.CONNOLLY,20122013,T.B,51.36666666666667,1,0,0,0,1,1,4,5,1,10,19,2,7,0,0,52,55,41,51,0,3,0.8,30183025.259999998
BRETT.SUTTER,20122013,CAR,25.03333333333333,0,0,0,0,0,0,8,14,6,2,3,7,1,1,2,20,30,20,28,0,1,0.5714285714285714,30183023.18
BRIAN.BOYLE,20122013,NYR,747.3499999999999,5,2,3,5,10,7,306,570,264,72,152,182,34,10,14,646,779,524,606,8,21,0.5368421052631579,30183098.665
BRIAN.CAMPBELL,20122013,FLA,1268,8,6,12,18,26,14,0,0,0,70,144,14,40,7,7,1200,1003,841,795,23,44,0,30183101.67
BRIAN.FLYNN,20122013,BUF,381.68333333333334,6,2,3,5,11,8,24,60,36,49,73,10,13,4,0,275,325,246,270,14,8,0.4,30183053.225
BRIAN.GIONTA,20122013,MTL,904.2333333333333,14,8,5,13,27,22,13,42,29,117,204,41,46,14,3,911,734,617,583,24,23,0.30952380952380953,30183087.935000002
BRIAN.LASHOFF,20122013,DET,605.2833333333333,1,2,1,3,4,3,0,0,0,28,53,50,14,2,6,430,605,406,444,13,22,0,30183065.945
BRIAN.LEE,20122013,T.B,306.26666666666665,0,0,0,0,0,0,0,0,0,13,34,49,12,2,8,249,305,243,288,8,19,0,30183049.42
BRIAN.MCGRATTAN,20122013,CGY,136.61666666666667,3,0,0,0,3,3,0,1,1,18,30,31,7,6,7,104,156,104,156,3,7,0,30183040.36
BRIAN.MCGRATTAN,20122013,NSH,12.566666666666666,0,0,0,0,0,0,0,0,0,0,1,1,1,0,0,9,6,9,6,0,0,0,15091510.05
BRIAN.STRAIT,20122013,NYI,449.4,1,1,3,4,5,2,0,0,0,18,42,46,14,2,11,377,422,348,339,24,17,0,30183051.295
BROCK.NELSON,20122013,NYI,7.733333333333333,0,0,0,0,0,0,0,0,0,0,0,1,0,0,0,5,7,5,7,0,1,0,15091510.55
BROOKS.LAICH,20122013,WSH,148.83333333333334,1,2,1,3,4,3,41,81,40,10,29,14,14,1,3,116,153,97,95,5,3,0.5061728395061729,30183030.475
BROOKS.ORPIK,20122013,PIT,1326.9333333333334,1,3,6,9,10,4,0,0,0,39,90,156,32,12,20,974,1449,894,1076,49,37,0,30183131.92
BRUNO.GERVAIS,20122013,PHI,633.2666666666667,1,1,4,5,6,2,0,0,0,48,114,25,45,2,5,539,606,506,547,17,32,0,30183071.67
BRYAN.ALLEN,20122013,ANA,889.9,0,1,6,7,7,1,0,0,0,30,99,77,38,10,15,666,914,603,729,24,24,0,30183094.25
BRYAN.BICKELL,20122013,CHI,968.1333333333334,18,14,7,21,39,32,3,9,6,131,234,193,59,11,14,915,737,853,710,45,22,0.3333333333333333,30183097.605
BRYAN.LITTLE,20122013,WPG,950.3500000000001,7,17,8,25,32,24,431,841,410,84,142,32,34,14,2,982,918,717,737,36,30,0.5124851367419738,30183119.38
BRYCE.SALVADOR,20122013,N.J,831.8166666666666,0,2,0,2,2,2,0,0,0,29,81,35,39,5,11,577,769,513,527,14,24,0,30183069.2
CAL.CLUTTERBUCK,20122013,MIN,656.1166666666667,5,5,2,7,12,10,1,3,2,98,166,180,37,17,14,468,595,412,458,12,19,0.3333333333333333,30183073.91
CAM.ATKINSON,20122013,CBJ,545.5166666666667,9,7,2,9,18,16,0,0,0,91,142,24,18,3,2,496,417,415,362,21,12,0,30183062.380000003
CAM.BARKER,20122013,VAN,198.78333333333336,0,1,1,2,2,1,0,0,0,19,36,16,10,1,2,178,190,164,176,6,9,0,30183037.185
CAM.FOWLER,20122013,ANA,915.4666666666667,1,3,10,13,14,4,0,0,0,59,139,20,61,8,2,874,787,620,686,25,22,0,30183084.93
CAM.JANSSEN,20122013,N.J,15.883333333333335,0,0,0,0,0,0,0,0,0,0,0,5,0,1,1,4,16,4,16,0,1,0,30183021.86
CAMERON.SCHILLING,20122013,WSH,11.966666666666667,0,0,0,0,0,0,0,0,0,0,0,0,0,0,0,9,13,8,13,0,1,0,15091511.3
CARL.GUNNARSSON,20122013,TOR,942.0333333333333,1,2,10,12,13,3,0,0,0,35,72,97,21,2,7,696,1050,599,784,31,29,0,30183104.72
CARL.HAGELIN,20122013,NYR,1047.95,13,12,5,17,30,25,7,19,12,167,270,64,62,26,9,1111,970,1001,845,42,21,0.3684210526315789,30183107.165
CARL.SODERBERG,20122013,BOS,112.85,0,0,2,2,2,0,12,23,11,9,15,9,3,1,3,99,81,68,78,2,5,0.5217391304347826,30183028.54
CARLO.COLAIACOVO,20122013,DET,250.61666666666667,0,2,0,2,2,2,0,0,0,16,39,24,17,4,3,244,226,194,204,6,5,0,30183039.34
CARTER.BANCKS,20122013,CGY,29.366666666666667,0,0,0,0,0,0,0,0,0,0,0,6,0,0,0,11,36,10,30,0,0,0,15091513.75
CASEY.CIZIKAS,20122013,NYI,550.0166666666667,8,6,5,11,19,14,169,327,158,53,95,89,25,10,9,434,520,416,451,23,25,0.5168195718654435,30183078.735
CHAD.LAROSE,20122013,CAR,449.6166666666667,2,0,2,2,4,2,9,22,13,65,119,59,22,8,10,472,401,393,366,7,15,0.4090909090909091,30183057.34
CHAD.RUHWEDEL,20122013,BUF,99.38333333333333,0,0,0,0,0,0,0,0,0,8,14,7,4,0,0,72,99,68,98,3,3,0,30183030.15
CHARLIE.COYLE,20122013,MIN,648.0666666666666,8,7,1,8,16,15,12,35,23,61,102,63,21,14,8,582,477,490,421,18,20,0.34285714285714286,30183067.245
CHRIS.BOURQUE,20122013,BOS,217.36666666666667,1,1,2,3,4,2,0,1,1,24,44,25,9,3,3,215,156,155,143,2,8,0,30183034.68
CHRIS.BROWN,20122013,ARI,38.18333333333334,0,0,0,0,0,0,0,0,0,6,10,6,1,0,1,35,31,27,30,0,0,0,30183022.95
CHRIS.BUTLER,20122013,CGY,749.1500000000001,1,3,4,7,8,4,0,0,0,40,77,53,24,5,8,553,817,521,666,19,34,0,30183092.799999997
CHRIS.CONNER,20122013,ARI,136.5,1,1,0,1,2,2,0,2,2,15,25,15,4,3,1,132,146,126,142,6,3,0,30183035.28
CHRIS.HIGGINS,20122013,VAN,739.75,10,2,2,4,14,12,33,93,60,82,144,58,29,4,5,605,668,506,534,18,27,0.3548387096774194,30183083.06
CHRIS.KELLY,20122013,BOS,853.7833333333333,5,4,2,6,11,9,354,621,267,66,117,89,26,19,15,681,843,607,614,15,27,0.5700483091787439,30183096.5
CHRIS.KREIDER,20122013,NYR,310.20000000000005,3,2,0,2,5,5,0,1,1,27,51,58,9,5,NA,241,298,206,286,8,9,0,NA
CHRIS.KUNITZ,20122013,PIT,1139.7333333333333,27,21,14,35,62,48,5,11,6,145,254,146,54,15,17,1423,841,916,755,59,28,0.45454545454545453,30183111.700000003
CHRIS.MUELLER,20122013,NSH,192.71666666666667,2,1,2,3,5,3,91,184,93,22,31,14,2,1,3,144,181,137,163,6,9,0.4945652173913043,30183043.299999997
CHRIS.NEIL,20122013,OTT,792.3666666666666,4,6,6,12,16,10,3,6,3,97,162,267,32,27,48,832,639,667,599,21,20,0.5,30183087.04
CHRIS.PHILLIPS,20122013,OTT,1221.5,5,4,6,10,15,9,0,1,1,101,194,115,62,9,21,1168,1260,904,833,30,30,0,30183099.939999998
CHRIS.PORTER,20122013,STL,392.8666666666667,3,3,1,4,7,6,35,81,46,53,75,90,12,2,0,297,328,289,283,12,6,0.43209876543209874,30183052.345
CHRIS.STEWART,20122013,STL,858.5,18,11,8,19,37,29,8,27,19,114,183,50,26,16,14,828,661,588,609,35,30,0.2962962962962963,30183100.38
CHRIS.SUMMERS,20122013,ARI,75.91666666666666,0,0,0,0,0,0,0,0,0,5,9,12,3,3,3,55,97,48,77,2,5,0,30183028.630000003
CHRIS.TANEV,20122013,VAN,656.9833333333333,2,1,4,5,7,3,0,0,0,20,NA,14,NA,8,5,509,543,470,438,17,14,0,NA
CHRIS.TERRY,20122013,CAR,28.816666666666666,1,0,0,0,1,1,1,1,0,1,4,1,2,0,0,20,17,17,17,1,1,1,30183021.490000002
CHRIS.THORBURN,20122013,WPG,265.59999999999997,2,2,0,2,4,4,20,46,26,13,30,65,12,9,15,223,253,221,232,5,11,0.43478260869565216,30183047.29
CHRIS.VANDEVELDE,20122013,EDM,77.53333333333333,0,0,0,0,0,0,21,44,23,7,9,12,1,1,2,44,87,43,74,1,4,0.4772727272727273,30183029.75
CHRISTIAN.EHRHOFF,20122013,BUF,1184,5,12,5,17,22,17,0,0,0,102,223,38,68,5,17,1143,1049,793,786,33,30,0,30183100.775
CHRISTIAN.THOMAS,20122013,NYR,12.766666666666667,0,0,0,0,0,0,0,0,0,2,2,3,0,0,0,7,13,7,13,0,0,0,15091511.45
CHUCK.KOBASEW,20122013,COL,416.98333333333335,5,3,1,4,9,8,18,49,31,43,73,34,17,7,10,296,455,283,333,15,9,0.3673469387755102,30183060.814999998
CLARKE.MACARTHUR,20122013,TOR,658.1333333333333,10,7,6,13,23,17,5,8,3,69,139,53,36,9,11,652,601,539,557,25,21,0.625,30183083.54
CLAUDE.GIROUX,20122013,PHI,1014.5999999999999,13,22,13,35,48,35,643,1181,538,137,265,57,72,25,9,1143,910,700,682,31,35,0.5444538526672311,30183122.445
CLAYTON.STONER,20122013,MIN,882.6,0,3,7,10,10,3,0,0,0,40,93,89,34,6,15,637,795,585,656,29,27,0,30183085.685000002
CODY.EAKIN,20122013,DAL,724.0666666666666,7,9,8,17,24,16,304,626,322,67,120,71,34,7,12,610,714,502,509,25,19,0.48562300319488816,30183090.630000003
CODY.FRANSON,20122013,TOR,1005.25,7,9,19,28,35,16,0,0,0,85,161,156,48,9,4,978,964,689,813,45,34,0,30183109.265
CODY.GOLOUBEF,20122013,CBJ,162.95,1,0,0,0,1,1,0,0,0,14,18,10,2,0,0,127,118,108,112,2,5,0,30183031.7
CODY.HODGSON,20122013,BUF,883.1166666666666,15,13,6,19,34,28,380,812,432,114,193,21,49,12,10,861,900,587,676,30,37,0.46798029556650245,30183122.92
CODY.MCCORMICK,20122013,BUF,51.65,0,0,0,0,0,0,12,25,13,6,12,17,4,2,2,39,49,38,49,0,2,0.48,30183025.5
CODY.MCLEOD,20122013,COL,628.25,8,2,2,4,12,10,7,17,10,79,128,105,16,16,23,522,623,459,485,15,12,0.4117647058823529,30183079.490000002
COLBY.ARMSTRONG,20122013,MTL,460.55,2,2,1,3,5,4,9,21,12,35,60,46,10,13,8,312,450,282,329,9,8,0.42857142857142855,30183058.064999998
COLBY.ROBAK,20122013,FLA,242.81666666666666,0,1,0,1,1,1,0,0,0,15,40,4,16,2,3,245,219,209,203,8,10,0,30183037.67
COLIN.FRASER,20122013,L.A,453.9,2,5,2,7,9,7,109,236,127,25,50,117,16,12,14,335,355,318,318,12,17,0.461864406779661,30183060.130000003
COLIN.GREENING,20122013,OTT,851.7333333333333,11,6,6,12,23,17,30,60,30,101,186,146,39,6,5,907,794,740,654,26,23,0.5,30183089.36
COLIN.MCDONALD,20122013,NYI,583.55,9,5,6,11,20,14,6,17,11,95,150,134,31,14,9,556,554,537,529,24,25,0.35294117647058826,30183079.98
COLIN.WILSON,20122013,NSH,414.16666666666663,7,8,4,12,19,15,8,21,13,26,60,10,11,4,4,370,310,272,274,13,13,0.38095238095238093,30183055.509999998
COLTON.GILLIES,20122013,CBJ,224.05,1,1,0,1,2,2,0,2,2,17,26,61,8,6,7,134,191,130,191,4,3,0,30183043.16
COLTON.ORR,20122013,TOR,326.76666666666665,1,2,1,3,4,3,0,1,1,17,32,96,9,15,37,210,334,210,331,9,6,0,30183064.425
COLTON.SCEVIOUR,20122013,DAL,4.85,0,0,1,1,1,0,1,3,2,0,0,1,0,0,0,3,8,3,8,1,2,0.3333333333333333,15091510.815
COREY.PERRY,20122013,ANA,981.4166666666667,15,15,8,23,38,30,6,32,26,152,242,62,43,15,24,978,809,679,655,34,27,0.1875,30183104.189999998
COREY.POTTER,20122013,EDM,575.9833333333333,3,1,0,1,4,4,0,0,0,36,84,50,29,3,3,446,557,371,444,18,9,0,30183065.43
CORY.CONACHER,20122013,OTT,249.78333333333336,5,2,1,3,8,7,6,19,13,23,45,25,13,12,12,267,189,208,180,10,6,0.3157894736842105,30183040.985
CORY.CONACHER,20122013,T.B,502.59999999999997,9,7,8,15,24,16,0,3,3,53,88,25,23,16,8,481,462,377,429,22,26,0,30183073.16
CORY.EMMERTON,20122013,DET,654.5333333333333,5,1,3,4,9,6,227,498,271,66,104,51,18,4,4,423,662,399,488,13,14,0.45582329317269077,30183087.595
CORY.SARICH,20122013,CGY,416.1166666666667,0,1,1,2,2,1,0,0,0,14,38,43,18,4,5,337,394,323,342,9,18,0,30183052.715
CRAIG.ADAMS,20122013,PIT,716.2166666666667,3,4,3,7,10,7,67,140,73,59,94,135,16,16,12,385,784,357,483,11,14,0.4785714285714286,30183082.465
CRAIG.SMITH,20122013,NSH,609.7,4,5,3,8,12,9,79,199,120,83,136,38,30,7,11,504,496,381,461,12,18,0.3969849246231156,30183080.155
CURTIS.GLENCROSS,20122013,CGY,729.4166666666667,15,7,3,10,25,22,20,46,26,91,167,49,38,10,9,679,636,503,514,20,30,0.43478260869565216,30183084.424999997
DAINIUS.ZUBRUS,20122013,N.J,369.26666666666665,2,5,2,7,9,7,11,28,17,22,39,31,7,3,5,305,263,247,198,7,14,0.39285714285714285,30183041.67
DALE.WEISE,20122013,VAN,404.73333333333335,3,2,1,3,6,5,1,9,8,37,59,95,10,12,13,274,361,259,314,5,15,0.1111111111111111,30183058.985
DALTON.PROUT,20122013,CBJ,518.8,1,0,6,6,7,1,0,0,0,16,49,51,19,5,8,381,505,344,433,17,6,0,30183065.05
DAMIEN.BRUNNER,20122013,DET,869.45,17,14,4,18,35,31,4,11,7,154,302,29,75,8,8,1026,658,683,599,29,28,0.36363636363636365,30183088.79
DAN.BOYLE,20122013,S.J,1292.8166666666666,10,9,9,18,28,19,0,0,0,123,291,41,104,10,13,1538,1090,1002,878,33,28,0,30183101.375
DAN.CARCILLO,20122013,CHI,233.63333333333333,2,2,0,2,4,4,0,1,1,26,48,45,16,5,5,206,167,202,166,11,8,0,30183034.9
DAN.CLEARY,20122013,DET,1023.0666666666666,13,3,9,12,25,16,12,27,15,113,161,81,21,13,20,995,795,687,639,20,29,0.4444444444444444,30183095.685
DAN.GIRARDI,20122013,NYR,1480.9666666666667,4,2,11,13,17,6,0,0,0,98,226,138,76,8,NA,1370,1556,1102,1125,34,34,0,NA
DAN.HAMHUIS,20122013,VAN,1200.2333333333331,5,9,10,19,24,14,0,0,0,69,186,56,72,7,9,1068,999,803,687,38,30,0,30183079.97
DANA.TYRELL,20122013,T.B,217.4,1,2,1,3,4,3,5,15,10,19,36,24,4,4,3,164,209,153,168,6,8,0.3333333333333333,30183039.315
DANIEL.ALFREDSSON,20122013,OTT,1101.0333333333333,14,14,7,21,35,28,19,50,31,128,247,45,70,11,14,1280,913,824,701,26,27,0.38,30183097.045
DANIEL.BANG,20122013,NSH,103.20000000000002,0,1,1,2,2,1,0,0,0,13,24,12,5,2,0,74,86,73,78,3,5,0,30183027.645
DANIEL.PAILLE,20122013,BOS,858.9666666666667,14,8,4,12,26,22,3,12,9,97,148,86,19,7,3,698,842,650,647,29,24,0.25,30183097.14
DANIEL.SEDIN,20122013,VAN,976.8333333333333,12,17,13,30,42,29,3,8,5,149,245,19,53,14,11,1157,572,793,501,33,19,0.375,30183070.285
DANIEL.WINNIK,20122013,ANA,913.1833333333334,6,5,9,14,20,11,20,60,40,116,176,67,29,7,10,690,910,624,632,23,21,0.3333333333333333,30183092.095
DANNY.BRIERE,20122013,PHI,546.0333333333333,6,4,6,10,16,10,61,134,73,87,143,15,37,9,6,549,477,379,425,14,21,0.4552238805970149,30183071.880000003
DANNY.DEKEYSER,20122013,DET,234.3,0,1,0,1,1,1,0,0,0,15,30,14,8,1,1,207,197,179,147,5,1,0,30183032.11
DANY.HEATLEY,20122013,MIN,667.1833333333334,11,7,3,10,21,18,12,31,19,82,134,26,31,8,4,654,552,425,477,18,29,0.3870967741935484,30183079.835
DARCY.HORDICHUK,20122013,EDM,8.133333333333333,0,0,0,0,0,0,0,0,0,0,0,6,0,0,1,3,10,3,10,0,1,0,30183021
DARREN.HELM,20122013,DET,12.45,0,0,0,0,0,0,6,14,8,1,4,4,1,1,1,6,15,5,4,0,0,0.42857142857142855,15091510.5
DARROLL.POWE,20122013,MIN,81.76666666666667,0,0,0,0,0,0,3,4,1,5,10,8,4,3,2,41,68,39,58,2,1,0.75,30183025.950000003
DARROLL.POWE,20122013,NYR,315.4,0,0,0,0,0,0,53,101,48,20,42,82,7,7,NA,182,323,167,245,4,6,0.5247524752475248,NA
DAVE.BOLLAND,20122013,CHI,815.0833333333333,10,8,2,10,20,18,324,718,394,75,117,74,24,15,23,655,712,500,603,22,32,0.45125348189415043,30183113.41
DAVE.DZIURZYNSKI,20122013,OTT,150.58333333333331,2,0,0,0,2,2,3,4,1,20,28,29,3,3,5,119,151,117,146,3,4,0.75,30183037.85
DAVID.BACKES,20122013,STL,1064.5333333333333,7,13,9,22,29,20,549,1032,483,118,198,181,30,16,27,991,850,720,646,27,23,0.5319767441860465,30183113.345
DAVID.BOOTH,20122013,VAN,153.05,1,0,2,2,3,1,1,1,0,27,43,24,5,5,2,144,91,135,88,3,7,1,30183027.29
DAVID.CLARKSON,20122013,N.J,844.45,15,5,4,9,24,20,6,25,19,180,269,84,39,27,26,1002,461,625,398,19,18,0.24,30183066.86
DAVID.DESHARNAIS,20122013,MTL,876.5166666666667,10,9,10,19,29,19,416,831,415,69,115,36,23,14,14,1003,637,735,548,34,31,0.5006016847172082,30183091.380000003
DAVID.JONES,20122013,COL,555.0999999999999,3,4,1,5,8,7,6,21,15,62,102,45,22,5,3,477,568,387,440,9,21,0.2857142857142857,30183070.165
DAVID.KREJCI,20122013,BOS,1359.2833333333333,19,25,15,40,59,44,510,983,473,149,258,80,55,8,17,1482,1190,1170,1057,59,41,0.5188199389623601,30183159.255000003
DAVID.LEGWAND,20122013,NSH,884.4333333333333,12,5,8,13,25,17,362,721,359,78,127,20,20,8,10,749,775,550,638,28,29,0.5020804438280166,30183112.060000002
DAVID.MOSS,20122013,ARI,699.7666666666667,5,11,4,15,20,16,9,31,22,82,154,73,38,13,9,592,657,530,481,22,18,0.2903225806451613,30183072.59
DAVID.PERRON,20122013,STL,966.8833333333333,10,5,11,16,26,15,9,23,14,96,190,60,56,17,25,914,688,647,599,23,26,0.391304347826087,30183085.055
DAVID.RUNDBLAD,20122013,ARI,109.86666666666667,0,1,0,1,1,1,0,0,0,9,21,7,7,2,0,118,103,67,95,2,7,0,30183030.07
DAVID.SAVARD,20122013,CBJ,52.8,0,0,0,0,0,0,0,0,0,1,4,4,1,0,0,28,47,24,42,0,3,0,30183024.5
DAVID.SCHLEMKO,20122013,ARI,516.5166666666667,1,0,5,5,6,1,0,0,0,35,82,38,24,3,6,482,500,376,390,19,10,0,30183056.505
DAVID.STECKEL,20122013,ANA,291.5,2,4,2,6,8,6,175,310,135,26,39,43,5,3,2,231,298,207,237,10,8,0.5645161290322581,30183052.83
DAVID.STECKEL,20122013,TOR,91.9,0,1,0,1,1,1,38,81,43,4,9,11,1,1,0,61,90,58,72,1,3,0.4691358024691358,30183029.63
DAVID.ULLSTROM,20122013,NYI,211.13333333333333,2,2,2,4,6,4,10,19,9,30,55,32,10,4,4,188,195,180,183,9,9,0.5263157894736842,30183040.240000002
DAVID.VAN DER GULIK,20122013,COL,84.96666666666667,0,2,0,2,2,2,4,8,4,10,17,10,5,2,3,69,70,66,44,4,2,0.5,30183023.68
DAVIS.DREWISKE,20122013,L.A,289.25,1,1,2,3,4,2,1,1,0,20,52,13,19,2,7,244,253,220,135,7,4,1,30183028.310000002
DAVIS.DREWISKE,20122013,MTL,151.48333333333335,1,1,1,2,3,2,0,0,0,8,22,8,11,0,0,133,145,125,113,6,6,0,30183029.375
DENNIS.SEIDENBERG,20122013,BOS,1562.4166666666665,4,4,9,13,17,8,0,0,0,113,246,166,85,4,7,1462,1503,1195,1116,50,36,0,30183119.314999998
DENNIS.WIDEMAN,20122013,CGY,1150.9666666666667,6,6,10,16,22,12,0,1,1,94,217,40,72,8,7,1058,1048,759,821,37,51,0,30183102.48
DEREK.DORSETT,20122013,CBJ,383.75,3,1,5,6,9,4,13,23,10,38,58,55,13,21,19,289,379,252,290,14,22,0.5652173913043478,30183054.705
DEREK.DORSETT,20122013,NYR,118.41666666666666,0,1,0,1,1,1,1,3,2,13,27,28,7,8,11,90,149,90,148,1,6,0.3333333333333333,30183039.02
DEREK.GRANT,20122013,OTT,43.31666666666666,0,0,0,0,0,0,17,31,14,5,10,8,2,0,0,25,45,23,31,0,1,0.5483870967741935,30183023.48
DEREK.JOSLIN,20122013,VAN,33.983333333333334,0,0,0,0,0,0,0,0,0,2,4,4,2,0,0,31,48,31,41,1,3,0,30183023.75
DEREK.MACKENZIE,20122013,CBJ,444.5666666666666,3,2,2,4,7,5,192,323,131,33,60,122,15,17,12,243,435,232,333,12,10,0.5944272445820433,30183065.4
DEREK.MEECH,20122013,WPG,235.15,0,1,0,1,1,1,0,0,0,5,23,24,14,0,1,191,220,180,210,6,5,0,30183039.950000003
DEREK.MORRIS,20122013,ARI,834.4333333333333,0,4,5,9,9,4,0,0,0,68,153,92,42,6,18,802,816,678,610,18,25,0,30183076.835
DEREK.ROY,20122013,DAL,569.1,4,11,7,18,22,15,242,519,277,64,112,15,33,6,2,579,514,400,381,18,16,0.4662813102119461,30183073.365000002
DEREK.ROY,20122013,VAN,280.8666666666667,3,3,1,4,7,6,69,176,107,27,54,4,15,4,2,286,240,219,189,7,7,0.39204545454545453,30183043.775
DEREK.SMITH,20122013,CGY,269.4,0,0,0,0,0,0,0,0,0,17,31,7,8,2,5,236,260,220,244,1,7,0,30183045.369999997
DEREK.STEPAN,20122013,NYR,1274.3333333333333,22,19,8,27,49,41,566,1221,655,139,273,64,75,8,NA,1378,1200,1007,832,50,18,0.46355446355446356,NA
DERICK.BRASSARD,20122013,CBJ,561.8666666666667,7,10,1,11,18,17,129,283,154,63,114,53,34,10,8,523,415,365,370,15,14,0.4558303886925795,30183070.735
DERICK.BRASSARD,20122013,NYR,443.1833333333333,7,12,4,16,23,19,168,327,159,47,84,58,23,8,1,455,355,299,323,18,14,0.5137614678899083,30183067.5
DERYK.ENGELLAND,20122013,PIT,692.8666666666667,0,2,4,6,6,2,0,0,0,34,67,80,22,13,22,578,692,562,616,24,24,0,30183083.43
DEVANTE.SMITH-PELLY,20122013,ANA,62.96666666666667,0,0,0,0,0,0,0,0,0,5,5,13,0,0,0,43,71,41,68,2,6,0,30183027.6
DEVIN.SETOGUCHI,20122013,MIN,773,14,9,5,14,28,23,8,20,12,109,184,107,41,9,8,726,654,546,595,30,24,0.4,30183093.185
DION.PHANEUF,20122013,TOR,1386.1333333333332,10,10,11,21,31,20,0,0,0,104,240,166,91,13,25,1218,1541,803,1127,38,43,0,30183151.455
DMITRIJ.JASKIN,20122013,STL,14.983333333333333,0,0,0,0,0,0,0,0,0,2,2,2,0,0,0,16,6,16,6,0,1,0,30183019.7
DMITRY.KULIKOV,20122013,FLA,713.2,3,3,4,7,10,6,0,0,0,51,111,84,36,7,10,634,601,507,509,19,24,0,30183070.42
DMITRY.ORLOV,20122013,WSH,74.71666666666667,0,1,0,1,1,1,0,0,0,1,8,2,5,0,0,67,68,66,64,6,1,0,30183024.75
DOUGIE.HAMILTON,20122013,BOS,829.9,5,10,4,14,19,15,0,0,0,94,193,71,63,2,7,949,656,778,594,29,23,0,30183070.97
DOUGLAS.MURRAY,20122013,PIT,488.8,3,2,1,3,6,5,0,1,1,26,48,62,11,6,11,369,563,346,426,13,18,0,30183068.835
DOUGLAS.MURRAY,20122013,S.J,497.23333333333335,0,0,3,3,3,0,0,0,0,13,54,56,25,5,9,374,605,345,434,8,14,0,30183064.674999997
DRAYSON.BOWMAN,20122013,CAR,432.98333333333335,3,1,1,2,5,4,4,10,6,68,116,55,24,8,6,425,430,396,376,10,18,0.4,30183058.365000002
DREW.DOUGHTY,20122013,L.A,1770.1,8,9,9,18,26,17,0,0,0,146,340,169,125,21,21,1724,1331,1214,990,39,47,0,30183104.585
DREW.LEBLANC,20122013,CHI,26.666666666666668,0,0,0,0,0,0,9,18,9,3,4,0,1,0,0,30,25,27,23,0,2,0.5,15091512.21
DREW.MILLER,20122013,DET,687.2,5,3,2,5,10,8,1,5,4,58,94,94,15,4,2,444,709,422,503,12,19,0.2,30183078.53
DREW.SHORE,20122013,FLA,679.7,3,7,3,10,13,10,212,443,231,96,163,37,41,3,7,702,563,631,506,20,29,0.4785553047404063,30183076.185000002
DREW.STAFFORD,20122013,BUF,782.8666666666667,6,6,6,12,18,12,37,84,47,120,185,46,33,7,9,656,734,480,558,17,29,0.44047619047619047,30183089.05
DUNCAN.KEITH,20122013,CHI,1740.8,5,14,19,33,38,19,0,0,0,142,292,39,107,3,18,1660,1436,1225,1020,60,35,0,30183108.655
DUSTIN.BROWN,20122013,L.A,1235.1333333333332,21,10,2,12,33,31,22,67,45,173,331,234,81,34,15,1331,919,956,734,33,26,0.3283582089552239,30183098.32
DUSTIN.BYFUGLIEN,20122013,WPG,1049.3333333333335,8,10,10,20,28,18,0,0,0,142,275,80,77,5,18,1121,898,791,786,35,40,0,30183102.75
DUSTIN.JEFFREY,20122013,PIT,276.31666666666666,3,2,1,3,6,5,94,200,106,26,48,6,10,3,1,233,248,213,230,8,6,0.47,30183049.765
DUSTIN.PENNER,20122013,L.A,680.6333333333333,5,7,7,14,19,12,3,11,8,96,162,118,30,5,14,661,489,579,470,23,18,0.2727272727272727,30183068.295
DWIGHT.KING,20122013,L.A,865.5666666666666,6,3,4,7,13,9,3,7,4,79,139,105,23,7,5,737,655,697,626,18,27,0.42857142857142855,30183083.490000002
DYLAN.REESE,20122013,PIT,45.78333333333333,0,0,0,0,0,0,0,0,0,1,3,0,1,0,0,26,41,23,39,0,0,0,30183024.1
ED.JOVANOVSKI,20122013,FLA,93.98333333333333,0,1,0,1,1,1,0,0,0,6,16,3,6,1,0,74,104,67,64,1,6,0,30183025.56
EMERSON.ETEM,20122013,ANA,525.3833333333333,6,7,2,9,15,13,2,5,3,59,110,57,19,5,4,411,531,366,450,19,10,0.4,30183074.93
ERIC.BELANGER,20122013,EDM,367.23333333333335,0,2,1,3,3,2,203,378,175,31,NA,19,NA,2,5,227,462,187,306,5,8,0.5370370370370371,NA
ERIC.BOULTON,20122013,NYI,85.1,0,0,0,0,0,0,0,0,0,5,13,23,4,3,7,62,76,62,73,0,4,0,30183028.08
ERIC.BREWER,20122013,T.B,984.6333333333333,4,5,3,8,12,9,0,0,0,56,136,88,56,2,15,760,1004,699,813,40,37,0,30183102.945
ERIC.FEHR,20122013,WSH,659.3166666666666,9,3,5,8,17,12,0,4,4,85,171,58,47,12,8,631,570,555,493,29,18,0,30183068.395
ERIC.GELINAS,20122013,N.J,15.983333333333333,0,0,0,0,0,0,0,0,0,1,3,1,0,0,0,11,7,10,7,0,1,0,15091510.35
ERIC.GRYBA,20122013,OTT,717.9166666666667,2,2,2,4,6,4,0,0,0,53,102,100,30,6,16,585,689,523,549,16,23,0,30183076.56
ERIC.NYSTROM,20122013,DAL,688.8,7,3,1,4,11,10,14,25,11,49,107,122,25,13,20,508,782,449,535,21,21,0.56,30183083.015
ERIC.SELLECK,20122013,FLA,15.833333333333334,0,1,0,1,1,1,0,0,0,2,4,5,1,1,3,11,14,11,14,2,0,0,15091511.96
ERIC.STAAL,20122013,CAR,1007.8,18,23,12,35,53,41,527,1013,486,152,270,35,65,15,21,1167,957,768,769,46,36,0.5202369200394866,30183135.880000003
ERIC.TANGRADI,20122013,PIT,42.68333333333334,0,0,0,0,0,0,0,0,0,4,5,6,0,0,0,40,31,40,31,3,1,0,30183021.9
ERIC.TANGRADI,20122013,WPG,370.7833333333333,1,1,1,2,3,2,0,2,2,44,81,81,17,7,5,338,329,320,328,6,10,0,30183053.695
ERIC.WELLWOOD,20122013,PHI,37.66666666666667,0,0,0,0,0,0,0,6,6,2,6,2,3,0,0,25,29,23,27,0,0,0,30183022.35
ERIK.COLE,20122013,DAL,472.9666666666667,6,1,0,1,7,7,15,43,28,45,91,58,23,9,5,390,493,242,378,11,17,0.3488372093023256,30183068.09
ERIK.COLE,20122013,MTL,297.4666666666667,3,0,3,3,6,3,7,24,17,41,79,43,18,12,5,326,189,222,167,10,9,0.2916666666666667,30183035.275
ERIK.CONDRA,20122013,OTT,768.4,4,8,6,14,18,12,9,25,16,86,153,18,35,16,18,721,785,647,530,19,22,0.36,30183074.07
ERIK.GUDBRANSON,20122013,FLA,599.95,0,0,4,4,4,0,0,0,0,49,94,80,24,5,13,489,595,445,482,11,32,0,30183069.05
ERIK.GUSTAFSSON,20122013,PHI,543.9833333333333,3,4,1,5,8,7,0,1,1,36,75,15,29,3,1,475,535,395,449,15,17,0,30183066.905
ERIK.JOHNSON,20122013,COL,643.3666666666667,0,2,2,4,4,2,0,0,0,64,119,44,34,4,9,598,607,461,452,19,23,0,30183062.14
ERIK.KARLSSON,20122013,OTT,729.0166666666667,7,7,8,15,22,14,0,0,0,107,268,18,110,12,7,907,592,591,458,20,15,0,30183055.02
EVANDER.KANE,20122013,WPG,981.7166666666667,17,12,4,16,33,29,13,33,20,191,351,147,79,23,27,990,875,724,757,34,36,0.3939393939393939,30183113.4
EVGENI.MALKIN,20122013,PIT,917.1166666666667,13,21,15,36,49,34,273,581,308,166,309,19,72,27,21,1164,666,726,589,34,26,0.46987951807228917,30183101.815
FEDOR.TYUTIN,20122013,CBJ,1156.5833333333335,4,13,5,18,22,17,1,1,0,56,136,58,49,7,15,941,997,682,736,37,28,1,30183098.335
FILIP.FORSBERG,20122013,NSH,77.38333333333333,0,0,1,1,1,0,0,1,1,14,23,3,5,0,0,72,74,59,70,1,4,0,30183026.975
FILIP.KUBA,20122013,FLA,933.8333333333334,1,4,5,9,10,5,0,0,0,50,82,37,16,5,12,739,952,604,708,22,35,0,30183097.424999997
FRANCIS.BOUILLON,20122013,MTL,947.8166666666666,1,4,3,7,8,5,0,0,0,51,110,87,45,6,12,925,796,760,665,37,35,0,30183076.485
FRANCIS.WATHIER,20122013,DAL,5.666666666666667,0,0,0,0,0,0,0,2,2,0,0,5,0,1,0,3,4,3,4,0,0,0,15091510.31
FRANCOIS.BEAUCHEMIN,20122013,ANA,1303.5666666666666,8,6,15,21,29,14,0,0,0,87,175,87,55,4,13,1189,1274,850,886,40,26,0,30183112.015
FRANK.CORRADO,20122013,VAN,107.46666666666667,0,0,0,0,0,0,0,0,0,6,19,9,7,1,0,106,99,95,91,1,3,0,30183027.51
FRANS.NIELSEN,20122013,NYI,972.7666666666667,6,11,13,24,30,17,301,633,332,108,182,27,39,5,6,866,923,594,634,23,29,0.4755134281200632,30183106.765
FRAZER.MCLAREN,20122013,S.J,6.9,0,0,0,0,0,0,0,0,0,0,0,0,0,0,0,4,8,4,7,0,0,0,15091510.6
FRAZER.MCLAREN,20122013,TOR,188.10000000000002,3,1,1,2,5,4,4,11,7,21,28,55,5,14,22,110,194,110,192,6,6,0.36363636363636365,30183048.674999997
GABRIEL.BOURQUE,20122013,NSH,538.15,11,3,2,5,16,14,4,6,2,50,90,39,14,9,2,459,478,382,424,20,13,0.6666666666666666,30183071.35
GABRIEL.DUMONT,20122013,MTL,115.81666666666666,1,1,0,1,2,2,38,61,23,23,33,31,5,4,7,121,83,117,79,2,1,0.6229508196721312,30183028.71
GABRIEL.LANDESKOG,20122013,COL,695.7333333333333,9,4,3,7,16,13,6,18,12,109,179,86,35,13,11,687,630,493,467,15,16,0.3333333333333333,30183073.895
GEORGE.PARROS,20122013,FLA,257.8,1,0,1,1,2,1,0,0,0,16,30,53,4,10,14,195,236,195,232,5,20,0,30183046.975
GRANT.CLITSOME,20122013,WPG,828.7666666666667,4,7,5,12,16,11,0,0,0,56,117,82,38,4,9,766,754,643,634,36,30,0,30183082.565
GREG.PATERYN,20122013,MTL,28.8,0,0,0,0,0,0,0,0,0,0,2,2,2,0,0,22,22,19,20,1,1,0,30183021.1
GREG.RALLO,20122013,FLA,95.53333333333333,1,0,0,0,1,1,1,3,2,10,17,20,2,0,1,84,94,82,91,0,5,0.3333333333333333,30183030.189999998
GREG.ZANON,20122013,COL,850.5333333333333,0,3,3,6,6,3,0,0,0,40,86,65,26,2,14,643,974,605,721,15,31,0,30183097.244999997
GREGORY.CAMPBELL,20122013,BOS,832.2166666666667,7,7,6,13,20,14,241,503,262,72,142,106,32,10,13,704,901,606,645,23,20,0.47912524850894633,30183103.240000002
GUILLAUME.LATENDRESSE,20122013,OTT,441.3833333333333,7,4,1,5,12,11,0,4,4,58,106,48,26,5,7,471,366,344,330,16,18,0,30183056.875
GUSTAV.NYQUIST,20122013,DET,463.2166666666667,5,5,1,6,11,10,1,7,6,72,131,11,29,6,4,501,351,375,327,13,8,0.14285714285714285,30183054.375
HAL.GILL,20122013,NSH,428.31666666666666,0,0,0,0,0,0,0,0,0,8,25,27,14,2,6,238,410,227,277,8,11,0,30183047.72
HARRI.PESONEN,20122013,N.J,36.733333333333334,0,0,0,0,0,0,0,0,0,3,6,4,2,1,1,30,17,30,17,0,1,0,30183020.560000002
HARRY.ZOLNIERCZYK,20122013,PHI,51.58333333333333,0,1,0,1,1,1,0,0,0,4,9,7,3,2,7,38,63,38,63,1,1,0,30183028.27
HENRIK.SEDIN,20122013,VAN,1011.6666666666666,11,20,16,36,47,31,481,979,498,75,121,29,24,14,13,1178,614,811,528,38,17,0.491317671092952,30183094.68
HENRIK.TALLINDER,20122013,N.J,439.26666666666665,1,1,1,2,3,2,0,0,0,22,76,15,40,3,NA,404,247,354,202,9,11,0,NA
HENRIK.ZETTERBERG,20122013,DET,1223.7666666666667,15,26,19,45,60,41,325,672,347,231,371,33,67,13,13,1340,984,837,748,33,29,0.4836309523809524,30183128.805
IAN.COLE,20122013,STL,266.18333333333334,0,1,0,1,1,1,0,0,0,10,30,6,11,3,5,208,191,185,170,6,10,0,30183035.03
IAN.WHITE,20122013,DET,489.5833333333333,2,1,1,2,4,3,1,1,0,27,86,14,32,2,2,478,370,359,345,13,9,1,30183050.235
ILYA.KOVALCHUK,20122013,N.J,915.2833333333333,11,11,9,20,31,22,7,22,15,123,238,13,57,10,NA,884,622,473,449,18,22,0.3181818181818182,NA
J.T..MILLER,20122013,NYR,351.6166666666667,2,2,0,2,4,4,63,118,55,43,83,47,20,7,4,339,297,281,280,7,14,0.5338983050847458,30183050.84
JACK.HILLEN,20122013,WSH,521.4166666666667,3,5,2,7,10,8,0,0,0,35,83,15,25,3,10,502,501,455,430,20,15,0,30183062.78
JACK.JOHNSON,20122013,CBJ,1142.8500000000001,5,5,9,14,19,10,0,0,0,96,196,66,58,5,5,955,1040,625,759,24,29,0,30183102.325
JACK.SKILLE,20122013,FLA,532.95,3,6,3,9,12,9,8,16,8,69,119,95,20,11,4,409,494,388,425,15,23,0.5,30183068.705
JACOB.JOSEFSON,20122013,N.J,285.6,1,2,0,2,3,3,114,236,122,20,41,11,7,3,1,180,222,150,148,4,13,0.4830508474576271,30183040.490000002
JADEN.SCHWARTZ,20122013,STL,657.6833333333334,7,5,2,7,14,12,16,30,14,63,107,43,26,6,3,546,498,519,474,21,24,0.5333333333333333,30183069.6
JAKE.DOWELL,20122013,MIN,17.083333333333332,0,0,0,0,0,0,2,3,1,3,4,2,1,0,0,13,7,13,7,0,0,0.6666666666666666,15091510.18
JAKE.GARDINER,20122013,TOR,383.8666666666667,1,3,2,5,6,4,0,0,0,21,54,26,16,1,0,387,376,310,347,10,11,0,30183055.71
JAKE.MUZZIN,20122013,L.A,1074.4833333333333,7,7,4,11,18,14,0,0,0,91,222,100,87,10,15,1227,610,941,577,37,20,0,30183056.35
JAKOB.SILFVERBERG,20122013,OTT,945.5,12,10,1,11,23,22,8,18,10,156,271,50,65,11,7,1020,843,777,679,25,18,0.4444444444444444,30183092.355
JAKUB.KINDL,20122013,DET,1007.8166666666666,5,6,7,13,18,11,0,0,0,100,212,67,74,10,19,1060,759,778,667,39,20,0,30183078.975
JAKUB.VORACEK,20122013,PHI,825.7666666666667,22,13,10,23,45,35,2,5,3,129,216,20,51,11,11,991,630,623,543,33,33,0.4,30183088.84
JAMAL.MAYERS,20122013,CHI,132.43333333333334,0,1,1,2,2,1,42,77,35,10,17,26,2,2,5,105,105,98,95,4,3,0.5454545454545454,30183031.175
JAMES.NEAL,20122013,PIT,928.3333333333333,27,11,8,19,46,38,1,9,8,187,354,73,102,11,17,1165,670,734,603,35,31,0.1111111111111111,30183090.65
JAMES.SHEPPARD,20122013,S.J,491.18333333333334,1,1,2,3,4,2,3,7,4,51,82,98,17,8,8,461,480,431,473,8,18,0.42857142857142855,30183070.549999997
JAMES.VAN RIEMSDYK,20122013,TOR,1059.7833333333333,20,9,10,19,39,29,26,51,25,173,269,70,47,10,15,1075,1108,768,943,40,39,0.5098039215686274,30183141.189999998
JAMES.WISNIEWSKI,20122013,CBJ,684.9166666666667,5,5,4,9,14,10,0,0,0,62,136,53,50,5,6,689,558,448,449,20,21,0,30183064.549999997
JAMES.WRIGHT,20122013,WPG,440.76666666666665,2,1,2,3,5,3,22,46,24,32,56,43,14,14,7,295,432,280,345,12,18,0.4782608695652174,30183059.22
JAMIE.BENN,20122013,DAL,816.3166666666666,12,14,7,21,33,26,326,708,382,109,210,71,52,13,12,839,673,574,584,26,34,0.4604519774011299,30183106.545
JAMIE.LANGENBRUNNER,20122013,STL,39.11666666666666,0,0,1,1,1,0,0,4,4,5,5,4,0,0,0,24,25,23,19,1,0,0,30183021.575
JAMIE.MCBAIN,20122013,CAR,736.9666666666667,1,3,3,6,7,4,0,0,0,46,101,22,39,7,5,774,703,672,600,29,28,0,30183071.395
JAMIE.MCGINN,20122013,COL,812.3833333333333,11,8,3,11,22,19,3,6,3,128,213,82,38,13,9,783,738,585,634,27,37,0.5,30183095.924999997
JAMIE.OLEKSIAK,20122013,DAL,237.33333333333331,0,1,1,2,2,1,0,0,0,11,34,32,13,3,3,202,216,192,190,7,12,0,30183037.055
JAMIE.TARDIF,20122013,BOS,9.85,0,0,0,0,0,0,0,0,0,1,1,4,0,1,0,6,9,6,9,0,0,0,15091510.86
JAN.HEJDA,20122013,COL,906.1666666666667,1,3,4,7,8,4,0,1,1,50,118,96,48,5,10,710,991,645,706,25,32,0,30183088.95
JAN.MURSAK,20122013,DET,11.283333333333333,0,0,0,0,0,0,1,2,1,0,0,0,0,0,2,5,4,5,4,0,0,0.5,30183020.189999998
JANNIK.HANSEN,20122013,VAN,897.8499999999999,10,10,7,17,27,20,7,37,30,108,192,70,45,8,5,843,780,626,595,33,23,0.1891891891891892,30183086.435000002
JARED.BOLL,20122013,CBJ,347.55,2,3,1,4,6,5,4,9,5,19,39,79,11,22,23,223,316,214,314,10,8,0.4444444444444444,30183060.705
JARED.COWEN,20122013,OTT,327.6666666666667,1,1,2,3,4,2,0,0,0,16,38,45,14,7,7,308,314,265,243,9,14,0,30183042.57
JARED.SPURGEON,20122013,MIN,946.4666666666667,5,6,4,10,15,11,0,0,0,75,155,46,52,9,3,906,750,600,598,24,27,0,30183079.189999998
JARED.STAAL,20122013,CAR,26.766666666666666,0,0,0,0,0,0,0,0,0,3,7,12,4,1,1,30,15,25,15,0,2,0,30183020.21
JAROME.IGINLA,20122013,CGY,597.9666666666667,9,9,4,13,22,18,118,236,118,100,164,56,41,10,7,576,488,405,433,21,27,0.5,30183077.32
JAROME.IGINLA,20122013,PIT,465.05,9,10,4,14,23,19,10,24,14,68,121,32,24,3,7,515,394,334,362,17,15,0.4166666666666667,30183068.130000003
JAROMIR.JAGR,20122013,BOS,597.1833333333334,2,8,9,17,19,10,0,0,0,86,147,16,30,3,5,674,468,497,430,17,15,0,30183063.655
JAROMIR.JAGR,20122013,DAL,621.95,14,7,5,12,26,21,0,1,1,87,159,6,39,9,10,693,450,480,400,22,24,0,30183066.365000002
JARRED.TINORDI,20122013,MTL,159.15,0,1,2,3,3,1,0,0,0,9,23,26,10,2,3,176,141,165,113,9,6,0,30183026.97
JARRET.STOLL,20122013,L.A,985.1,7,7,5,12,19,14,515,936,421,84,143,141,30,12,15,787,800,589,527,18,18,0.5502136752136753,30183093.495
JASON.AKESON,20122013,PHI,12.383333333333333,1,0,0,0,1,1,0,0,0,2,3,0,1,0,0,13,14,13,14,2,0,0,15091511.55
JASON.CHIMERA,20122013,WSH,691.35,4,6,7,13,17,10,25,41,16,107,166,94,32,9,18,671,663,650,648,23,28,0.6097560975609756,30183091.265
JASON.DEMERS,20122013,S.J,413.59999999999997,1,1,0,1,2,2,0,0,0,27,70,32,23,2,6,382,388,313,330,6,10,0,30183052.52
JASON.GARRISON,20122013,VAN,1114.3333333333335,8,4,3,7,15,12,0,0,0,108,248,39,75,1,15,1029,907,756,648,38,24,0,30183077.634999998
JASON.POMINVILLE,20122013,BUF,773.2166666666667,10,8,7,15,25,18,40,86,46,94,183,17,47,9,3,782,808,464,547,27,26,0.46511627906976744,30183086.314999998
JASON.POMINVILLE,20122013,MIN,202.3,4,4,1,5,9,8,11,19,8,28,53,6,12,3,0,220,149,146,129,7,7,0.5789473684210527,30183035.494999997
JASON.SPEZZA,20122013,OTT,151.21666666666667,2,3,1,4,6,5,101,183,82,18,34,2,8,1,1,185,128,121,103,4,2,0.5519125683060109,30183034.375
JASON.ZUCKER,20122013,MIN,291.8666666666667,5,0,2,2,7,5,0,2,2,44,77,14,14,7,4,237,279,225,271,13,8,0,30183051.47
JAY.BEAGLE,20122013,WSH,648.55,3,3,3,6,9,6,264,472,208,64,111,66,20,2,7,471,686,437,484,12,19,0.559322033898305,30183081.455
JAY.BOUWMEESTER,20122013,CGY,830.2666666666667,6,7,1,8,14,13,0,0,0,55,109,33,25,4,8,604,809,503,589,26,37,0,30183087.165
JAY.BOUWMEESTER,20122013,STL,478.29999999999995,1,5,2,7,8,6,0,0,0,31,70,17,22,1,3,407,388,322,300,10,7,0,30183049.21
JAY.HARRISON,20122013,CAR,935.6666666666667,3,4,3,7,10,7,0,0,0,54,122,83,45,7,21,888,1014,791,776,26,39,0,30183096.145
JAY.MCCLEMENT,20122013,TOR,835.0333333333333,8,2,7,9,17,10,249,495,246,52,88,88,23,7,4,420,1045,386,693,18,23,0.503030303030303,30183118.305
JAY.PANDOLFO,20122013,BOS,163.31666666666666,0,0,0,0,0,0,2,5,3,11,19,25,4,3,1,110,169,105,146,0,2,0.4,30183036.41
JAY.ROSEHILL,20122013,PHI,74.71666666666667,1,0,0,0,1,1,0,0,0,6,10,18,1,9,13,49,88,47,87,1,5,0,30183032.939999998
JEAN-GABRIEL.PAGEAU,20122013,OTT,232.18333333333334,6,3,1,4,10,9,104,213,109,35,58,21,14,5,4,242,204,212,164,11,5,0.48826291079812206,30183042.485
JEFF.CARTER,20122013,L.A,1196.95,32,11,3,14,46,43,279,552,273,189,368,43,86,9,15,1308,953,862,758,35,36,0.5054347826086957,30183123.275
JEFF.HALPERN,20122013,MTL,236.93333333333334,1,2,0,2,3,3,136,250,114,21,39,21,10,4,1,195,242,174,156,5,7,0.544,30183039.33
JEFF.HALPERN,20122013,NYR,274.7833333333333,0,0,1,1,1,0,93,164,71,13,25,36,6,5,4,184,265,166,184,2,6,0.5670731707317073,30183041.595
JEFF.PETRY,20122013,EDM,1051.6333333333332,3,4,5,9,12,7,0,1,1,66,141,112,45,12,13,756,1170,658,826,33,29,0,30183108.895000003
JEFF.SCHULTZ,20122013,WSH,370.66666666666663,0,2,1,3,3,2,0,0,0,12,35,17,19,1,5,277,378,267,302,8,15,0,30183049.935000002
JEFF.SKINNER,20122013,CAR,775.4666666666667,13,7,4,11,24,20,21,44,23,159,284,21,66,26,13,943,688,671,612,18,32,0.4772727272727273,30183089.5
JEREMY.MORIN,20122013,CHI,39.06666666666666,1,1,0,1,2,2,0,4,4,7,10,3,2,2,0,32,31,30,29,3,1,0,30183023.42
JEREMY.WELSH,20122013,CAR,29.21666666666667,0,1,0,1,1,1,15,20,5,4,6,6,1,0,0,20,18,20,18,1,0,0.75,30183021.75
JERRED.SMITHSON,20122013,EDM,117.16666666666666,1,0,0,0,1,1,66,115,49,7,11,15,1,0,1,71,138,70,89,2,2,0.5739130434782609,30183031.89
JERRED.SMITHSON,20122013,FLA,362.5666666666667,2,3,0,3,5,5,199,363,164,22,37,81,9,6,5,214,371,195,254,6,10,0.5482093663911846,30183056.770000003
JESSE.JOENSUU,20122013,NYI,79.4,0,2,0,2,2,2,0,0,0,16,19,15,2,0,3,77,78,77,78,2,0,0,30183029.1
JIM.O'BRIEN,20122013,OTT,331.3166666666666,5,1,0,1,6,6,100,219,119,38,63,30,12,3,4,267,350,245,235,6,6,0.45662100456621,30183051.33
JIM.SLATER,20122013,WPG,271.75,1,0,1,1,2,1,145,267,122,22,38,41,8,6,8,189,292,178,200,4,8,0.5430711610486891,30183046.585
JIMMY.HAYES,20122013,CHI,143.31666666666666,1,2,1,3,4,3,4,7,3,13,21,11,3,2,0,99,129,90,123,7,7,0.5714285714285714,30183034.605
JIRI.HUDLER,20122013,CGY,720.6833333333334,10,9,7,16,26,19,10,31,21,56,101,16,24,10,10,666,573,463,513,24,32,0.3225806451612903,30183083.925
JIRI.TLUSTY,20122013,CAR,875.7,23,9,6,15,38,32,3,18,15,117,194,53,34,7,9,964,867,710,719,40,25,0.16666666666666666,30183110.240000002
JOAKIM.ANDERSSON,20122013,DET,645.8,4,4,5,9,13,8,243,487,244,62,99,25,16,3,9,568,543,526,418,22,15,0.4989733059548255,30183069.825
JOCHEN.HECHT,20122013,BUF,643.8,5,6,3,9,14,11,147,353,206,69,107,24,16,4,9,456,663,423,511,21,14,0.4164305949008499,30183090.145
JODY.SHELLEY,20122013,PHI,7.966666666666667,0,0,0,0,0,0,0,0,0,0,1,3,0,0,0,4,5,4,5,0,0,0,15091510.3
JOE.COLBORNE,20122013,TOR,72.53333333333333,0,0,0,0,0,0,19,51,32,7,8,19,0,0,1,50,80,50,79,1,2,0.37254901960784315,30183030.61
JOE.CORVO,20122013,CAR,750.3833333333333,6,4,6,10,16,10,0,0,0,71,148,27,47,2,7,838,697,635,601,29,25,0,30183077.97
JOE.FINLEY,20122013,NYI,191.31666666666666,0,0,1,1,1,0,0,1,1,2,13,24,9,4,7,135,175,135,167,2,6,0,30183037.465
JOE.PAVELSKI,20122013,S.J,1140.9666666666667,20,13,10,23,43,33,431,826,395,166,307,56,74,16,5,1312,1022,814,739,29,26,0.5217917675544794,30183120.75
JOE.THORNTON,20122013,S.J,1105.25,9,24,17,41,50,33,531,913,382,110,186,32,34,9,11,1403,853,855,696,35,22,0.5815991237677984,30183112.605
JOE.VITALE,20122013,PIT,373.3666666666667,2,3,0,3,5,5,187,308,121,31,51,57,7,9,11,259,359,254,351,6,15,0.6071428571428571,30183068.02
JOEL.WARD,20122013,WSH,682.3,9,8,7,15,24,17,40,70,30,60,109,47,24,8,9,638,604,489,456,25,19,0.5714285714285714,30183072.855
JOEY.CRABB,20122013,WSH,244.88333333333333,2,0,0,0,2,2,7,34,27,20,32,24,7,2,4,159,241,156,195,4,5,0.20588235294117646,30183043.6
JOFFREY.LUPUL,20122013,TOR,390.85,14,5,3,8,22,19,4,14,10,69,111,46,21,9,8,395,405,289,376,22,13,0.2857142857142857,30183072.975
JOHAN.FRANZEN,20122013,DET,1013.4000000000001,18,12,7,19,37,30,33,69,36,156,267,66,46,11,15,1078,720,679,582,25,16,0.4782608695652174,30183093.555
JOHAN.LARSSON,20122013,MIN,14.033333333333333,0,0,0,0,0,0,0,0,0,2,2,2,0,0,0,11,18,11,18,0,0,0,15091512
JOHN-MICHAEL.LILES,20122013,TOR,662.25,2,5,4,9,11,7,0,1,1,50,103,54,36,8,3,587,626,455,565,21,19,0,30183080.48
JOHN.CARLSON,20122013,WSH,1262.3666666666666,6,7,9,16,22,13,1,1,0,118,232,63,64,12,11,1146,1313,870,873,40,34,1,30183107.735
JOHN.ERSKINE,20122013,WSH,690.0333333333333,3,1,3,4,7,4,0,0,0,38,91,111,39,7,12,565,797,542,608,25,21,0,30183080.645000003
JOHN.MITCHELL,20122013,COL,787.2333333333333,10,7,3,10,20,17,170,343,173,72,147,98,47,11,9,696,699,546,544,21,17,0.4956268221574344,30183086.685000002
JOHN.MOORE,20122013,CBJ,246.76666666666665,0,1,0,1,1,1,0,0,0,14,38,18,17,1,1,201,201,187,183,6,11,0,30183035.560000002
JOHN.MOORE,20122013,NYR,358.6,1,4,2,6,7,5,0,0,0,31,62,27,19,2,2,330,367,279,337,16,7,0,30183055.77
JOHN.SCOTT,20122013,BUF,185.10000000000002,0,0,0,0,0,0,0,0,0,15,24,38,4,10,13,123,149,122,146,2,3,0,30183037.2
JOHN.TAVARES,20122013,NYI,1120.6166666666668,31,11,9,20,51,42,520,1047,527,183,329,39,74,22,9,1317,889,896,797,39,41,0.49665711556829034,30183137.595
JOHNNY.BOYCHUK,20122013,BOS,1424.4666666666667,7,3,3,6,13,10,0,0,0,138,282,153,90,12,11,1370,1428,1241,1137,43,38,0,30183123.495
JOHNNY.ODUYA,20122013,CHI,1508.1166666666668,6,5,8,13,19,11,0,0,0,82,178,53,59,5,13,1245,1290,1104,938,56,36,0,30183101.4
JONAS.BRODIN,20122013,MIN,1175.0833333333335,2,3,6,9,11,5,0,0,0,54,115,24,44,4,4,940,994,766,751,28,29,0,30183089.89
JONATHAN.ERICSSON,20122013,DET,1275.2333333333333,3,6,6,12,15,9,0,0,0,41,120,98,52,11,15,1009,1184,917,850,35,30,0,30183098.36
JONATHAN.HUBERDEAU,20122013,FLA,812.5166666666667,14,9,8,17,31,23,11,33,22,112,182,33,36,15,9,850,680,650,624,24,36,0.3333333333333333,30183095.04
JONATHAN.MARCHESSAULT,20122013,CBJ,21.883333333333333,0,0,0,0,0,0,0,0,0,0,2,1,1,2,0,15,21,13,20,0,1,0,15091511.97
JONATHAN.RHEAULT,20122013,FLA,52.849999999999994,0,0,0,0,0,0,0,1,1,4,6,12,2,0,0,48,42,47,41,2,2,0,30183022.950000003
JONATHAN.TOEWS,20122013,CHI,1404.75,26,21,15,36,62,47,827,1437,610,213,322,48,64,29,21,1484,965,1060,732,60,21,0.5755045233124565,30183124.895
JONATHON.BLUM,20122013,NSH,500.4833333333333,1,3,3,6,7,4,0,0,0,26,55,32,20,2,3,388,399,319,360,14,13,0,30183056.795
JONI.PITKANEN,20122013,CAR,501.98333333333335,1,5,2,7,8,6,0,0,0,34,73,16,25,3,6,516,435,366,334,12,14,0,30183051.979999997
JOONAS.RASK,20122013,NSH,16.016666666666666,0,0,1,1,1,0,0,0,0,0,0,0,0,0,0,6,11,6,11,1,2,0,15091511.025
JORDAN.CARON,20122013,BOS,159.89999999999998,1,1,1,2,3,2,0,0,0,20,32,18,7,0,2,140,166,132,166,4,3,0,30183038.775
JORDAN.EBERLE,20122013,EDM,911.7666666666667,16,15,5,20,36,31,8,19,11,133,203,31,29,17,8,957,756,688,669,33,34,0.42105263157894735,30183104.465
JORDAN.HENDRY,20122013,ANA,35.15,0,0,0,0,0,0,0,0,0,0,2,1,1,0,0,25,36,24,36,0,0,0,15091513.8
JORDAN.LEOPOLD,20122013,BUF,507.23333333333335,2,3,3,6,8,5,0,0,0,38,72,27,26,2,7,406,527,292,370,14,19,0,30183060.645
JORDAN.LEOPOLD,20122013,STL,373.95,0,1,1,2,2,1,0,0,0,21,58,14,20,1,0,348,249,278,223,5,9,0,30183036.985
JORDAN.NOLAN,20122013,L.A,434.95,2,3,1,4,6,5,0,9,9,24,48,88,13,12,15,313,346,305,343,11,15,0,30183059.245
JORDAN.SCHROEDER,20122013,VAN,425.09999999999997,3,5,1,6,9,8,140,321,181,28,65,10,25,1,2,418,296,287,267,11,11,0.43613707165109034,30183054.085
JORDAN.STAAL,20122013,CAR,963.7166666666667,10,14,7,21,31,24,456,912,456,114,187,105,32,11,13,1032,936,779,664,28,40,0.5,30183112.375
JORDIE.BENN,20122013,DAL,450.2166666666667,1,3,2,5,6,4,0,0,0,31,79,25,30,3,6,395,428,325,315,13,15,0,30183049.03
JORDIN.TOOTOO,20122013,DET,387.8833333333333,3,4,0,4,7,7,0,0,0,45,80,73,20,21,20,302,341,298,334,9,9,0,30183060.11
JOSH.BAILEY,20122013,NYI,743.8,11,8,2,10,21,19,40,85,45,92,150,32,31,3,3,707,670,582,573,27,21,0.47058823529411764,30183086.83
JOSH.GORGES,20122013,MTL,1133.1166666666668,2,3,3,6,8,5,0,0,0,45,104,73,33,5,8,909,1132,806,804,32,29,0,30183096.825
JT.WYMAN,20122013,T.B,13.516666666666667,0,0,0,0,0,0,7,11,4,0,0,0,0,0,0,11,7,10,5,0,1,0.6363636363636364,15091510.13
JUSSI.JOKINEN,20122013,CAR,514.3833333333333,6,1,4,5,11,7,167,282,115,61,121,14,29,2,8,553,471,393,330,9,16,0.5921985815602837,30183057.05
JUSSI.JOKINEN,20122013,PIT,237.28333333333333,7,6,1,7,14,13,128,224,96,21,33,7,9,5,5,209,212,137,171,10,3,0.5714285714285714,30183049.095
JUSTIN.ABDELKADER,20122013,DET,914.3833333333334,12,3,1,4,16,15,67,128,61,129,196,181,26,26,25,894,682,758,593,26,16,0.5234375,30183085.715
JUSTIN.BRAUN,20122013,S.J,986.7833333333333,0,3,5,8,8,3,0,0,0,62,169,62,64,7,3,884,930,741,725,20,24,0,30183084.244999997
JUSTIN.FALK,20122013,MIN,521.9333333333334,0,1,2,3,3,1,0,0,0,27,71,60,30,13,15,416,486,389,420,15,27,0,30183060.73
JUSTIN.FAULK,20122013,CAR,910.6166666666667,5,2,8,10,15,7,0,0,0,76,137,63,38,6,6,859,922,625,640,27,29,0,30183084.46
JUSTIN.SCHULTZ,20122013,EDM,1029.5833333333335,8,4,14,18,26,12,0,1,1,85,190,15,64,3,4,935,959,660,839,27,44,0,30183112.48
JUSTIN.WILLIAMS,20122013,L.A,1150.2833333333333,17,12,13,25,42,29,3,8,5,199,340,50,68,12,12,1300,807,1039,715,41,28,0.375,30183090.015
KARL.ALZNER,20122013,WSH,1162,2,1,4,5,7,3,0,0,0,58,128,53,38,5,8,969,1198,890,855,32,37,0,30183099.15
KASPARS.DAUGAVINS,20122013,BOS,110.98333333333333,0,0,1,1,1,0,0,0,0,22,28,13,3,1,1,100,106,99,101,1,3,0,30183030.435000002
KASPARS.DAUGAVINS,20122013,OTT,217.08333333333334,1,0,2,2,3,1,9,18,9,23,39,18,10,4,3,185,212,170,155,4,10,0.5,30183035
KEATON.ELLERBY,20122013,FLA,136.7,0,0,0,0,0,0,0,0,0,8,17,15,3,3,11,101,140,91,122,2,5,0,30183034.58
KEATON.ELLERBY,20122013,L.A,553.8166666666666,0,1,2,3,3,1,0,0,0,18,55,67,22,8,8,440,448,413,337,14,11,0,30183046.880000003
KEITH.AUCOIN,20122013,NYI,586.0666666666667,6,7,2,9,15,13,192,387,195,59,107,39,28,10,4,604,534,538,499,23,20,0.49612403100775193,30183079.48
KEITH.AULIE,20122013,T.B,576.8499999999999,2,3,2,5,7,5,0,0,0,37,76,91,27,8,19,471,596,467,531,23,19,0,30183076.28
KEITH.BALLARD,20122013,VAN,556.9166666666667,0,1,1,2,2,1,0,0,0,35,NA,45,NA,12,13,460,479,420,404,10,13,0,NA
KEITH.YANDLE,20122013,ARI,1067.8666666666668,10,11,8,19,29,21,0,0,0,130,272,18,87,13,16,1181,866,864,782,32,26,0,30183098.43
KENT.HUSKINS,20122013,DET,168.81666666666666,0,0,0,0,0,0,0,0,0,2,5,15,0,2,2,114,158,107,110,1,4,0,30183030.92
KENT.HUSKINS,20122013,PHI,128.81666666666666,0,1,0,1,1,1,0,0,0,2,12,3,6,1,0,85,151,80,136,4,5,0,30183035.060000002
KEVIN.BIEKSA,20122013,VAN,893.25,7,1,5,6,13,8,0,0,0,84,181,65,58,15,24,793,799,611,617,32,30,0,30183081.775
KEVIN.HENDERSON,20122013,NSH,58.766666666666666,1,0,0,0,1,1,0,0,0,3,7,3,2,2,0,39,57,36,55,3,3,0,30183026.07
KEVIN.KLEIN,20122013,NSH,959.6666666666667,3,7,4,11,14,10,0,0,0,54,126,66,48,4,3,650,965,606,701,28,30,0,30183092.39
KEVIN.PORTER,20122013,BUF,472.08333333333337,4,4,1,5,9,8,108,270,162,37,63,56,16,7,5,316,446,281,355,10,10,0.4,30183069.564999998
KEVIN.SHATTENKIRK,20122013,STL,1133.2666666666667,5,9,11,20,25,14,0,0,0,95,210,61,70,3,12,1096,813,777,619,29,24,0,30183074.505
KEVIN.WESTGARTH,20122013,CAR,177.36666666666667,2,1,1,2,4,3,0,3,3,16,31,28,6,7,13,140,148,140,147,5,4,0,30183037.895
KIMMO.TIMONEN,20122013,PHI,979.4833333333333,5,14,10,24,29,19,0,0,0,78,169,31,56,4,20,1026,837,604,558,26,23,0,30183079.59
KORBINIAN.HOLZER,20122013,TOR,407.15,2,1,0,1,3,3,0,0,0,16,31,61,7,6,7,298,522,283,427,10,23,0,30183070.71
KRIS.LETANG,20122013,PIT,1311.6833333333334,7,20,26,46,53,27,0,0,0,143,274,73,76,14,8,1431,1087,920,798,54,37,0,30183100.04
KRIS.NEWBURY,20122013,NYR,65.8,0,1,0,1,1,1,20,42,22,6,12,15,3,2,4,50,68,46,68,1,1,0.47619047619047616,30183029.17
KRIS.RUSSELL,20122013,STL,529.6,1,3,2,5,6,4,0,0,0,41,78,25,22,4,3,445,454,407,389,17,14,0,30183056.69
KRIS.VERSTEEG,20122013,FLA,168.83333333333331,2,0,2,2,4,2,0,5,5,20,33,5,6,2,4,124,125,84,108,4,12,0,30183033.42
KRYS.BARCH,20122013,N.J,128.78333333333333,0,0,0,0,0,0,1,2,1,4,9,25,2,6,9,75,77,75,77,4,3,0.5,30183028.049999997
KURTIS.FOSTER,20122013,PHI,301.1,1,2,2,4,5,3,0,0,0,21,52,16,18,1,7,276,311,219,292,11,12,0,30183052.060000002
KYLE.BRODZIAK,20122013,MIN,936.4333333333334,8,2,4,6,14,10,423,859,436,97,165,65,32,7,8,787,808,569,600,21,34,0.49243306169965073,30183103.79
KYLE.CHIPCHURA,20122013,ARI,445.98333333333335,5,9,0,9,14,14,126,261,135,37,60,61,11,14,9,407,401,381,384,16,16,0.4827586206896552,30183071.28
KYLE.CLIFFORD,20122013,L.A,654.0666666666666,7,4,5,9,16,11,2,11,9,72,136,204,31,15,20,571,510,540,476,22,23,0.18181818181818182,30183070.605
KYLE.OKPOSO,20122013,NYI,929.1666666666666,7,15,6,21,28,22,123,222,99,115,211,52,52,18,15,934,787,760,722,36,37,0.5540540540540541,30183102.1
KYLE.PALMIERI,20122013,ANA,591.7166666666667,13,8,5,13,26,21,3,15,12,103,181,54,38,8,5,539,495,432,472,24,17,0.2,30183079.825000003
KYLE.QUINCEY,20122013,DET,958.5333333333333,1,3,0,3,4,4,0,0,0,51,142,43,54,8,15,889,806,745,608,28,26,0,30183068.38
KYLE.TURRIS,20122013,OTT,1142.3000000000002,18,13,6,19,37,31,570,1136,566,147,275,45,70,22,16,1303,1064,897,809,28,30,0.5017605633802817,30183134.07
KYLE.WELLWOOD,20122013,WPG,506.0833333333333,6,5,4,9,15,11,43,78,35,37,61,10,14,3,1,486,427,431,416,18,16,0.5512820512820513,30183066.15
LADISLAV.SMID,20122013,EDM,975.3,1,0,3,3,4,1,0,0,0,30,NA,151,NA,6,22,678,1087,626,792,30,30,0,NA
LANE.MACDERMID,20122013,BOS,10.716666666666667,0,0,0,0,0,0,0,0,0,1,1,3,0,2,2,10,8,10,8,0,0,0,30183020.57
LANE.MACDERMID,20122013,DAL,30.583333333333336,2,0,0,0,2,2,0,0,0,3,5,10,0,1,3,25,33,25,33,2,1,0,30183024.91
LARS.ELLER,20122013,MTL,690.8833333333333,8,11,11,22,30,19,270,549,279,84,160,88,39,17,17,637,666,534,521,29,19,0.4918032786885246,30183091.395
LAURI.KORPIKOSKI,20122013,ARI,616.4333333333334,6,3,2,5,11,9,6,16,10,83,153,71,39,7,6,566,632,440,450,13,18,0.375,30183068.759999998
LEE.STEMPNIAK,20122013,CGY,841.5833333333333,9,14,9,23,32,23,3,23,20,112,190,47,53,11,6,756,796,602,605,31,32,0.13043478260869565,30183089.805
LENNART.PETRELL,20122013,EDM,403.5833333333333,3,2,4,6,9,5,3,13,10,23,NA,63,NA,1,2,219,502,196,335,8,14,0.23076923076923078,NA
LEO.KOMAROV,20122013,TOR,649.8,4,1,3,4,8,5,31,64,33,56,108,198,23,16,12,480,659,446,524,15,17,0.484375,30183079.775
LOGAN.COUTURE,20122013,S.J,1094.35,26,16,6,22,48,42,328,614,286,184,321,43,57,20,2,1301,934,781,713,31,26,0.5342019543973942,30183122.369999997
LOUI.ERIKSSON,20122013,DAL,965.75,12,10,7,17,29,22,9,34,25,104,189,6,37,11,3,982,844,656,638,25,28,0.2647058823529412,30183094.445
LUBOMIR.VISNOVSKY,20122013,NYI,935.25,3,4,8,12,15,7,0,0,0,80,169,23,68,4,11,1046,686,747,573,39,24,0,30183062.64
LUCA.SBISA,20122013,ANA,920.3499999999999,1,3,4,7,8,4,0,0,0,42,109,121,46,5,12,697,905,582,729,23,31,0,30183096
LUKE.ADAM,20122013,BUF,39.166666666666664,1,0,0,0,1,1,1,1,0,2,5,3,2,0,1,25,46,22,46,2,1,1,30183025.64
LUKE.SCHENN,20122013,PHI,1027.55,3,2,6,8,11,5,0,0,0,81,161,187,57,8,14,868,1004,751,755,33,36,0,30183091.58
MAGNUS.PAAJARVI,20122013,EDM,593.4666666666667,9,4,3,7,16,13,4,12,8,75,110,24,18,5,6,464,532,375,478,20,19,0.3333333333333333,30183080.535
MANNY.MALHOTRA,20122013,VAN,100.16666666666666,0,0,0,0,0,0,64,98,34,2,6,8,2,2,0,52,101,49,62,1,4,0.6530612244897959,30183027.08
MARC-ANDRE.BERGERON,20122013,CAR,195.78333333333336,0,3,1,4,4,3,0,0,0,21,56,11,24,1,1,264,128,175,114,3,8,0,30183026.735
MARC-ANDRE.BERGERON,20122013,T.B,148.29999999999998,1,0,4,4,5,1,0,0,0,22,40,5,10,2,2,158,112,111,106,5,3,0,30183030.020000003
MARC-ANDRE.GRAGNANI,20122013,CAR,7.883333333333334,0,0,0,0,0,0,0,0,0,0,0,0,0,0,0,5,12,5,12,0,0,0,15091511.3
MARC-EDOUARD.VLASIC,20122013,S.J,1226.9,4,2,3,5,9,6,0,0,0,70,163,35,58,18,12,1116,1153,984,886,37,32,0,30183098.555
MARC.METHOT,20122013,OTT,1272.0833333333335,3,6,6,12,15,9,0,0,0,71,125,163,37,10,17,1148,1279,1014,927,36,39,0,30183108.95
MARC.STAAL,20122013,NYR,531,2,4,5,9,11,6,0,0,0,20,73,47,32,2,7,454,508,384,376,19,14,0,30183055.095
MARCEL.GOC,20122013,FLA,767.3166666666666,9,7,3,10,19,16,410,786,376,92,149,73,32,5,4,645,699,505,516,20,28,0.5216284987277354,30183094.175
MARCO.SCANDELLA,20122013,MIN,176.25,2,0,1,1,3,2,0,0,0,13,25,13,9,2,2,139,174,126,145,7,8,0,30183034.995
MARCUS.FOLIGNO,20122013,BUF,640.4833333333333,5,8,5,13,18,13,45,75,30,55,94,108,19,17,16,610,506,498,471,22,26,0.6,30183073.744999997
MARCUS.JOHANSSON,20122013,WSH,682.8333333333334,7,10,7,17,24,17,42,95,53,53,89,20,22,13,2,687,658,572,538,26,26,0.4421052631578947,30183080.634999998
MARCUS.KRUGER,20122013,CHI,983.2166666666667,7,6,4,10,17,13,299,682,383,76,117,24,25,9,13,771,991,691,575,24,24,0.43841642228739003,30183094.35
MAREK.ZIDLICKY,20122013,N.J,1007.7333333333333,4,6,9,15,19,10,0,0,0,101,232,52,86,3,21,1097,622,719,532,22,27,0,30183062.155
MARIAN.GABORIK,20122013,CBJ,216.91666666666666,3,3,2,5,8,6,1,1,0,38,67,2,21,1,2,225,180,160,163,10,5,1,30183037.4
MARIAN.GABORIK,20122013,NYR,653.5,9,6,4,10,19,15,0,2,2,113,169,19,32,7,NA,739,542,553,479,16,21,0,NA
MARIAN.HOSSA,20122013,CHI,1160.3833333333332,24,12,11,23,47,36,1,4,3,186,328,30,85,10,9,1185,791,830,575,41,14,0.25,30183080.465
MARK.ARCOBELLO,20122013,EDM,18.25,0,0,0,0,0,0,3,10,7,0,0,0,0,0,0,11,18,9,16,0,0,0.3,15091512.02
MARK.BARBERIO,20122013,T.B,30.983333333333334,0,0,0,0,0,0,0,0,0,1,6,0,3,0,0,29,27,22,23,0,2,0,15091511.7
MARK.BOROWIECKI,20122013,OTT,77.98333333333333,0,0,0,0,0,0,0,0,0,1,4,26,3,4,5,73,72,70,56,2,2,0,30183024.490000002
MARK.CUNDARI,20122013,CGY,79.08333333333333,1,1,1,2,3,2,0,0,0,8,17,15,5,1,1,66,61,52,57,1,4,0,15091516.685
MARK.EATON,20122013,PIT,551.6833333333333,0,2,1,3,3,2,0,0,0,14,44,12,19,4,2,394,592,370,499,26,16,0,30183071.314999998
MARK.FAYNE,20122013,N.J,561.0333333333333,1,2,3,5,6,3,0,0,0,34,84,25,34,2,8,441,393,408,293,18,12,0,30183040.195
MARK.FISTRIC,20122013,EDM,383.33333333333337,0,4,2,6,6,4,0,0,0,9,32,88,9,11,12,293,409,278,313,11,8,0,30183054.259999998
MARK.FRASER,20122013,TOR,836.8166666666666,0,8,1,9,9,8,0,0,0,37,102,162,45,15,27,660,952,633,778,47,29,0,30183101.275
MARK.GIORDANO,20122013,CGY,1088.5166666666667,4,6,5,11,15,10,0,0,0,58,148,65,56,13,19,876,989,668,739,41,50,0,30183094.755000003
MARK.LETESTU,20122013,CBJ,759.7166666666667,13,8,6,14,27,21,243,486,243,92,143,36,34,3,5,570,678,443,516,22,18,0.5,30183095.4
MARK.OLVER,20122013,COL,289.35,4,2,0,2,6,6,59,142,83,33,49,28,9,3,4,273,276,256,272,8,12,0.4154929577464789,30183054.689999998
MARK.PYSYK,20122013,BUF,309.2833333333333,1,2,1,3,4,3,0,0,0,21,41,6,12,3,0,240,287,208,257,5,12,0,30183048.055
MARK.SCHEIFELE,20122013,WPG,46.099999999999994,0,0,0,0,0,0,10,14,4,6,12,4,3,1,0,44,38,37,37,2,2,0.7142857142857143,30183022.86
MARK.STONE,20122013,OTT,51.4,0,0,0,0,0,0,1,1,0,5,10,14,3,2,1,55,41,50,39,1,3,1,30183022.66
MARK.STREIT,20122013,NYI,1242.4499999999998,8,8,14,22,30,16,0,0,0,91,226,37,90,6,13,1339,1032,895,860,36,44,0,30183102.46
MARK.STUART,20122013,WPG,701.55,2,1,1,2,4,3,0,0,0,40,115,111,49,9,18,538,703,517,547,21,17,0,30183072.015
MARTIN.ERAT,20122013,NSH,681.2333333333333,4,7,10,17,21,11,31,60,29,60,109,34,32,7,11,588,527,403,422,13,19,0.5166666666666667,30183069.16
MARTIN.ERAT,20122013,WSH,183.35,1,1,1,2,3,2,1,4,3,12,19,18,3,1,4,148,185,117,144,5,3,0.25,30183036.725
MARTIN.HANZAL,20122013,ARI,723.0833333333333,11,6,5,11,22,17,298,637,339,93,170,100,33,13,12,781,627,566,531,21,18,0.46781789638932497,30183094.674999997
MARTIN.HAVLAT,20122013,S.J,641.8666666666667,8,7,3,10,18,15,1,6,5,90,145,6,28,7,10,690,548,509,471,21,11,0.16666666666666666,30183073.335
MARTIN.ST. LOUIS,20122013,T.B,1055.1999999999998,17,17,26,43,60,34,12,28,16,112,192,23,40,18,6,984,881,683,742,42,38,0.42857142857142855,30183114.91
MARTY.REASONER,20122013,NYI,360.85,0,2,3,5,5,2,162,310,148,37,58,22,13,6,NA,267,374,254,269,8,13,0.5225806451612903,NA
MASON.RAYMOND,20122013,VAN,795.2,11,9,4,13,24,20,18,53,35,88,NA,26,NA,7,8,756,672,540,553,27,26,0.33962264150943394,NA
MATHIEU.PERREAULT,20122013,WSH,550.4166666666667,7,12,2,14,21,19,214,411,197,57,107,39,31,10,12,612,448,511,434,25,14,0.5206812652068127,30183074.759999998
MATHIEU.ROY,20122013,T.B,14.116666666666667,0,0,0,0,0,0,0,0,0,0,2,0,1,0,0,11,16,11,16,0,1,0,15091511.45
MATS.ZUCCARELLO,20122013,NYR,442.66666666666663,4,7,4,11,15,11,0,6,6,49,88,49,19,5,7,510,369,378,350,20,13,0,30183058.05
MATT.ANDERSON,20122013,N.J,11.55,0,1,0,1,1,1,0,0,0,0,2,0,1,0,0,12,11,12,11,1,0,0,30183020.8
MATT.BARTKOWSKI,20122013,BOS,286.75,1,1,2,3,4,2,0,0,0,21,55,32,20,1,5,304,245,293,226,8,10,0,30183037.759999998
MATT.BELESKEY,20122013,ANA,581.8499999999999,10,4,2,6,16,14,6,20,14,74,130,129,28,13,20,496,574,402,534,19,15,0.3,30183089.27
MATT.CALVERT,20122013,CBJ,595.5333333333333,9,5,2,7,16,14,2,6,4,63,122,57,40,9,9,486,492,427,405,20,30,0.3333333333333333,30183063.869999997
MATT.CARKNER,20122013,NYI,327.70000000000005,0,2,1,3,3,2,0,0,0,21,44,28,11,6,17,326,327,322,309,12,15,0,30183051.134999998
MATT.CARLE,20122013,T.B,1139.9,5,8,8,16,21,13,0,0,0,66,132,32,45,7,2,937,1083,708,822,35,36,0,30183107.57
MATT.COOKE,20122013,PIT,933.3333333333333,8,11,6,17,25,19,5,17,12,78,135,160,24,18,25,667,1033,638,793,28,31,0.29411764705882354,30183119.23
MATT.CULLEN,20122013,MIN,762.1666666666666,7,17,6,23,30,24,299,540,241,87,155,21,33,7,6,665,679,487,516,34,21,0.5537037037037037,30183091.58
MATT.D'AGOSTINI,20122013,N.J,167.14999999999998,2,2,0,2,4,4,1,4,3,14,25,10,5,3,3,140,88,116,82,2,4,0.25,30183028.77
MATT.D'AGOSTINI,20122013,STL,189.98333333333335,1,0,1,1,2,1,4,14,10,19,39,11,13,7,2,158,140,136,136,5,8,0.2857142857142857,30183032.955
MATT.DUCHENE,20122013,COL,983.2666666666667,17,19,7,26,43,36,488,893,405,132,214,48,36,15,6,954,974,679,719,32,38,0.5464725643896976,30183129.095
MATT.ELLIS,20122013,BUF,37.18333333333334,0,0,0,0,0,0,14,35,21,8,9,0,0,2,0,20,34,20,28,0,0,0.4,30183024.03
MATT.FRASER,20122013,DAL,141.5,1,1,1,2,3,2,0,0,0,17,31,13,8,3,0,122,110,114,106,4,3,0,30183030.104999997
MATT.FRATTIN,20122013,TOR,413.3333333333333,7,4,4,8,15,11,5,8,3,54,103,78,29,3,2,377,441,348,435,19,15,0.625,30183070.68
MATT.GILROY,20122013,NYR,143.35000000000002,0,0,0,0,0,0,0,0,0,14,27,6,9,1,3,118,133,112,131,0,3,0,30183033.36
MATT.GREENE,20122013,L.A,215.73333333333335,0,2,1,3,3,2,0,0,0,7,17,56,3,0,7,169,227,150,163,5,6,0,30183037.825
MATT.HALISCHUK,20122013,NSH,430.2166666666667,5,6,0,6,11,11,2,6,4,51,74,33,9,2,5,298,400,288,350,14,13,0.3333333333333333,30183064.450000003
MATT.HENDRICKS,20122013,WSH,636.4,5,1,2,3,8,6,159,289,130,57,117,107,30,19,20,475,694,453,505,12,19,0.5501730103806228,30183081.45
MATT.HUNWICK,20122013,COL,925.3833333333333,0,3,3,6,6,3,0,0,0,56,111,40,43,5,8,788,927,646,677,27,27,0,30183084.175
MATT.IRWIN,20122013,S.J,845.0166666666667,5,2,2,4,9,7,0,0,0,92,195,47,75,4,6,928,747,739,661,22,25,0,30183077.439999998
MATT.KASSIAN,20122013,OTT,139.95,1,1,1,2,3,2,0,0,0,11,23,53,7,8,11,137,103,132,103,4,3,0,30183030.305
MATT.MARTIN,20122013,NYI,644.5,5,7,0,7,12,12,7,22,15,75,120,274,22,20,24,478,611,411,471,17,21,0.3181818181818182,30183079.33
MATT.MOULSON,20122013,NYI,1004.6166666666667,17,21,9,30,47,38,1,1,0,169,284,36,64,12,3,1170,785,824,726,35,37,1,30183105.485
MATT.NISKANEN,20122013,PIT,1097.95,4,5,6,11,15,9,0,0,0,84,193,65,58,3,10,1091,971,875,843,32,30,0,30183100.43
MATT.PELECH,20122013,S.J,18.099999999999998,0,0,0,0,0,0,0,0,0,0,0,6,0,2,2,2,20,2,20,0,0,0,15091512.97
MATT.READ,20122013,PHI,756.7333333333333,11,7,6,13,24,18,14,48,34,71,118,49,16,8,1,648,695,486,555,24,24,0.2916666666666667,30183089.79
MATT.STAJAN,20122013,CGY,737.9666666666667,5,11,7,18,23,16,356,770,414,44,76,47,12,16,13,559,712,501,542,31,28,0.4623376623376623,30183100.825000003
MATT.TAORMINA,20122013,T.B,33.28333333333333,0,0,0,0,0,0,0,0,0,0,2,5,1,0,0,25,26,24,26,0,1,0,15091512.3
MATT.TENNYSON,20122013,S.J,62.849999999999994,0,1,1,2,2,1,0,0,0,8,17,4,5,0,1,83,64,82,62,5,3,0,30183024.375
MATTHEW.IRWIN,20122013,S.J,76.5,1,0,1,1,2,1,0,0,0,5,15,6,7,1,1,87,63,74,56,3,0,0,30183023.885
MATTHEW.KONAN,20122013,PHI,31.85,0,0,0,0,0,0,0,0,0,4,6,5,2,0,0,26,35,25,34,0,0,0,30183023.25
MATTHEW.LOMBARDI,20122013,ANA,94,0,0,0,0,0,0,26,56,30,5,8,4,3,0,2,71,96,54,91,1,3,0.4642857142857143,30183031.64
MATTHEW.LOMBARDI,20122013,ARI,296.93333333333334,4,2,2,4,8,6,79,180,101,39,69,20,19,2,2,288,279,230,246,9,10,0.4388888888888889,30183051.28
MATTIAS.EKHOLM,20122013,NSH,16.083333333333332,0,0,0,0,0,0,0,0,0,0,1,0,1,0,0,15,6,14,6,0,1,0,15091509.8
MATTIAS.TEDENBY,20122013,N.J,35.96666666666667,0,0,1,1,1,0,0,0,0,2,6,1,3,1,1,19,28,19,28,1,1,0,30183022.485
MAX.PACIORETTY,20122013,MTL,795.4833333333333,15,13,11,24,39,28,2,8,6,176,298,73,59,11,12,988,548,698,471,36,25,0.25,30183070.465
MAX.TALBOT,20122013,PHI,540.1166666666667,5,3,2,5,10,8,92,192,100,41,69,57,15,10,10,360,596,322,391,14,15,0.4791666666666667,30183070.73
MAXIM.LAPIERRE,20122013,VAN,642.5999999999999,4,5,1,6,10,9,282,567,285,58,102,129,20,5,21,404,644,376,502,12,20,0.4973544973544973,30183094.355
MAXWELL.REINHART,20122013,CGY,158.58333333333331,1,2,0,2,3,3,34,91,57,26,35,8,5,1,2,113,153,100,133,5,7,0.37362637362637363,30183038.87
MICHAEL.CARUSO,20122013,FLA,15.833333333333334,0,0,0,0,0,0,0,0,0,0,2,0,2,0,0,7,25,7,15,0,0,0,30183021.1
MICHAEL.DEL ZOTTO,20122013,NYR,1320.2,4,10,9,19,23,14,0,0,0,98,228,111,78,9,13,1301,1275,980,1043,41,32,0,30183125.015
MICHAEL.FROLIK,20122013,CHI,865.8166666666666,6,7,6,13,19,13,18,56,38,144,245,62,54,9,6,701,865,630,510,27,24,0.32142857142857145,30183070.759999998
MICHAEL.GRABNER,20122013,NYI,740.7166666666667,17,5,3,8,25,22,10,23,13,121,186,33,39,7,6,633,748,526,537,26,20,0.43478260869565216,30183086.445
MICHAEL.KOSTKA,20122013,TOR,795.1500000000001,0,3,4,7,7,3,0,0,0,49,122,50,42,4,12,737,754,540,616,17,25,0,30183082.29
MICHAEL.RYDER,20122013,DAL,311.06666666666666,6,4,4,8,14,10,2,6,4,42,80,19,23,3,4,358,227,238,204,11,8,0.3333333333333333,30183042.71
MICHAEL.RYDER,20122013,MTL,501.3833333333333,11,4,8,12,23,15,4,8,4,67,119,20,34,4,5,530,421,374,383,16,16,0.5,30183065.55
MICHAEL.SGARBOSSA,20122013,COL,62.18333333333334,0,0,0,0,0,0,9,25,16,6,11,4,4,0,2,64,46,38,44,0,3,0.36,30183024.91
MICHAEL.STONE,20122013,ARI,667.4666666666667,5,3,1,4,9,8,0,0,0,51,105,89,32,4,8,614,641,544,527,22,20,0,30183072.265
MICHAL.HANDZUS,20122013,CHI,502.3833333333333,4,6,7,13,17,10,227,464,237,27,46,49,8,6,5,410,414,375,359,23,11,0.4892241379310345,30183068.314999998
MICHAL.HANDZUS,20122013,S.J,379.04999999999995,1,1,0,1,2,2,165,297,132,31,52,22,10,5,6,265,402,235,278,4,10,0.5555555555555556,30183056.049999997
MICHAL.JORDAN,20122013,CAR,53.43333333333334,0,0,0,0,0,0,0,0,0,2,7,0,3,0,1,48,40,48,40,0,2,0,30183022.9
MICHAL.ROZSIVAL,20122013,CHI,932.1,0,6,9,15,15,6,0,3,3,27,69,92,22,3,14,888,632,783,548,46,20,0,30183059.955
MICHEAL.HALEY,20122013,NYR,71.7,0,0,0,0,0,0,2,3,1,4,6,23,1,5,3,39,65,37,65,0,2,0.6666666666666666,30183027.98
MIKA.ZIBANEJAD,20122013,OTT,705.7166666666667,8,8,8,16,24,16,191,430,239,111,189,102,37,11,3,751,579,560,507,24,19,0.4441860465116279,30183085.15
MIKAEL.BACKLUND,20122013,CGY,483.98333333333335,8,3,5,8,16,11,194,406,212,88,145,31,29,9,7,477,412,397,381,13,20,0.47783251231527096,30183072.325
MIKAEL.GRANLUND,20122013,MIN,355.7833333333333,2,4,2,6,8,6,97,206,109,36,58,15,11,3,3,282,308,208,294,7,13,0.470873786407767,30183061.009999998
MIKAEL.SAMUELSSON,20122013,DET,116.83333333333334,1,2,0,2,3,3,0,0,0,12,24,9,3,2,1,122,91,88,85,3,6,0,30183029.52
MIKE.ANGELIDIS,20122013,T.B,7.366666666666667,0,0,0,0,0,0,3,7,4,0,1,0,0,0,0,3,9,3,7,0,0,0.42857142857142855,15091510.82
MIKE.BLUNDEN,20122013,MTL,49.93333333333333,0,0,0,0,0,0,0,0,0,6,8,2,1,1,3,26,33,26,32,1,2,0,30183023.46
MIKE.BROWN,20122013,EDM,237.43333333333334,1,0,0,0,1,1,5,6,1,16,41,65,12,11,12,141,232,140,224,2,10,0.8333333333333334,30183047.41
MIKE.BROWN,20122013,TOR,55.85,0,1,0,1,1,1,0,1,1,2,7,22,3,8,13,32,47,32,46,2,1,0,30183026.78
MIKE.CAMMALLERI,20122013,CGY,794.45,13,13,6,19,32,26,253,496,243,102,192,20,45,9,11,741,656,509,553,20,32,0.5100806451612904,30183100.41
MIKE.FISHER,20122013,NSH,737.6666666666666,10,7,4,11,21,17,272,558,286,68,138,67,37,10,11,613,612,429,483,17,15,0.4874551971326165,30183090.28
MIKE.GREEN,20122013,WSH,1048.6,14,11,5,16,30,25,0,0,0,115,257,49,95,5,11,1084,891,749,734,27,29,0,30183097.525
MIKE.HOFFMAN,20122013,OTT,36.95,0,0,0,0,0,0,2,2,0,6,12,8,3,1,1,41,36,41,36,0,1,1,30183022.84
MIKE.KNUBLE,20122013,PHI,361.75,4,3,1,4,8,7,4,7,3,31,55,25,13,2,9,307,317,254,289,10,12,0.5714285714285714,30183054.255
MIKE.KOMISAREK,20122013,TOR,61.38333333333333,0,0,0,0,0,0,0,0,0,1,7,11,4,2,1,37,72,35,57,3,1,0,30183025.47
MIKE.LUNDIN,20122013,OTT,170.58333333333331,0,1,0,1,1,1,0,0,0,13,23,2,8,0,0,151,159,136,135,3,4,0,30183032.5
MIKE.RIBEIRO,20122013,WSH,985.8,14,21,15,36,50,35,286,621,335,76,117,68,16,11,19,1046,874,674,767,27,31,0.4605475040257649,30183137.525
MIKE.RICHARDS,20122013,L.A,1072.1166666666666,15,18,11,29,44,33,318,644,326,105,219,87,51,17,17,1125,874,715,674,26,33,0.4937888198757764,30183115.615000002
MIKE.RUPP,20122013,MIN,310.8,1,2,1,3,4,3,12,20,8,29,48,52,10,8,15,198,255,190,247,6,8,0.6,30183050.585
MIKE.RUPP,20122013,NYR,49.983333333333334,0,0,0,0,0,0,4,8,4,2,5,7,1,2,3,34,36,34,36,0,3,0.5,30183023.78
MIKE.SANTORELLI,20122013,FLA,266.25,2,1,0,1,3,3,30,52,22,21,52,7,19,2,1,234,234,217,231,4,11,0.5769230769230769,30183043.82
MIKE.SANTORELLI,20122013,WPG,137.18333333333334,0,1,0,1,1,1,26,42,16,14,31,5,10,0,0,132,111,127,108,1,6,0.6190476190476191,30183029.490000002
MIKE.WEAVER,20122013,FLA,543.7333333333333,1,3,4,7,8,4,0,0,0,20,43,49,16,6,4,375,548,346,381,18,20,0,30183058.560000002
MIKE.WEBER,20122013,BUF,771.2666666666667,1,1,5,6,7,2,0,0,0,25,59,122,21,7,23,490,883,446,650,21,22,0,30183094.795
MIKHAIL.GRABOVSKI,20122013,TOR,881.0833333333334,9,4,5,9,18,13,367,736,369,96,199,52,49,12,7,849,884,668,814,25,42,0.4986413043478261,30183126.725
MIKHAIL.GRIGORENKO,20122013,BUF,255.88333333333333,1,3,1,4,5,4,57,149,92,31,56,2,14,2,0,210,237,185,226,9,10,0.3825503355704698,30183048.725
MIKKEL.BOEDKER,20122013,ARI,886.8666666666666,7,7,12,19,26,14,1,11,10,83,137,76,27,14,6,875,775,617,650,27,26,0.09090909090909091,30183093.380000003
MIKKO.KOIVU,20122013,MIN,1114.85,11,13,13,26,37,24,573,1064,491,138,269,58,68,13,17,1146,797,706,598,24,30,0.5385338345864662,30183104.325
MILAN.HEJDUK,20122013,COL,381.1166666666667,4,5,2,7,11,9,2,6,4,41,69,6,18,1,0,363,351,275,325,8,11,0.3333333333333333,30183058.54
MILAN.LUCIC,20122013,BOS,1238.7333333333333,14,19,13,32,46,33,35,69,34,121,258,241,76,15,27,1454,1041,1145,968,57,37,0.5072463768115942,30183120.325
MILAN.MICHALEK,20122013,OTT,596.8666666666667,7,6,6,12,19,13,4,9,5,87,162,20,35,6,8,729,491,489,395,17,13,0.4444444444444444,30183060.97
NAIL.YAKUPOV,20122013,EDM,698.9666666666667,17,10,4,14,31,27,0,6,6,81,162,41,49,9,14,606,637,420,569,24,23,0,30183097.14
NATE.PROSSER,20122013,MIN,191.26666666666665,0,0,0,0,0,0,0,0,0,5,14,17,5,0,2,146,171,141,155,5,1,0,30183034.75
NATE.THOMPSON,20122013,T.B,645.1833333333333,7,5,3,8,15,12,310,604,294,58,102,85,18,7,7,428,717,392,496,17,19,0.5132450331125827,30183092.545
NATHAN.BEAULIEU,20122013,MTL,92.21666666666667,0,2,0,2,2,2,0,0,0,8,19,3,9,0,0,103,75,89,69,8,3,0,30183024.35
NATHAN.GERBE,20122013,BUF,525.1666666666666,5,3,2,5,10,8,0,1,1,64,109,32,25,6,7,416,513,346,481,12,16,0,30183078.46
NATHAN.HORTON,20122013,BOS,1131.4166666666667,20,14,7,21,41,34,6,12,6,152,256,66,58,11,15,1304,956,1060,867,56,35,0.5,30183111.875
NAZEM.KADRI,20122013,TOR,865.55,19,24,5,29,48,43,267,621,354,121,228,76,48,41,15,851,810,642,729,47,24,0.42995169082125606,30183133.115000002
NICK.BJUGSTAD,20122013,FLA,167.31666666666666,1,0,0,0,1,1,53,132,79,17,23,17,4,1,2,125,140,106,136,2,9,0.4015151515151515,30183038.98
NICK.BONINO,20122013,ANA,545.35,8,8,1,9,17,16,193,394,201,53,94,19,19,6,5,467,538,326,431,12,14,0.48984771573604063,30183084.855
NICK.DRAZENOVIC,20122013,CBJ,79.41666666666666,0,0,0,0,0,0,29,54,25,5,10,8,3,1,2,45,63,45,44,1,3,0.5370370370370371,30183024.77
NICK.FOLIGNO,20122013,CBJ,743.5999999999999,6,7,6,13,19,13,3,9,6,69,112,99,25,13,11,668,589,477,538,20,16,0.3333333333333333,30183083.6
NICK.HOLDEN,20122013,CBJ,17.15,0,0,0,0,0,0,0,0,0,2,2,3,0,0,0,12,11,12,11,2,1,0,15091510.6
NICK.JOHNSON,20122013,ARI,169.25,4,2,0,2,6,6,0,3,3,23,37,13,6,4,0,166,132,164,129,7,4,0,30183033.939999998
NICK.LEDDY,20122013,CHI,1166.0166666666667,6,4,7,11,17,10,0,0,0,96,174,56,47,3,6,1157,782,887,716,35,32,0,30183082.905
NICK.PETRECKI,20122013,S.J,11.966666666666667,0,0,0,0,0,0,0,0,0,0,1,1,1,0,0,5,10,5,10,0,0,0,15091510.85
NICK.SCHULTZ,20122013,EDM,894.35,1,3,4,7,8,4,0,2,2,33,NA,52,NA,5,11,682,969,623,729,23,40,0,NA
NICK.SPALING,20122013,NSH,745.4333333333334,9,3,1,4,13,12,223,482,259,57,105,38,24,8,9,445,742,399,544,13,25,0.46265560165975106,30183098.625
NICKLAS.BACKSTROM,20122013,WSH,1093.6833333333334,9,17,25,42,51,26,498,961,463,96,187,38,48,13,10,1168,987,755,687,33,29,0.518210197710718,30183114.775
NICKLAS.GROSSMANN,20122013,PHI,549.9833333333333,1,2,0,2,3,3,0,0,0,21,56,81,21,4,9,394,570,362,407,14,16,0,30183061.44
NICKLAS.JENSEN,20122013,VAN,27.700000000000003,0,0,0,0,0,0,0,0,0,0,2,2,1,0,0,27,26,26,26,0,1,0,30183021.95
NICOLAS.BLANCHARD,20122013,CAR,78.05,0,0,0,0,0,0,1,1,0,6,9,22,2,4,4,60,69,59,66,1,3,1,30183026.93
NIK.ANTROPOV,20122013,WPG,638.2666666666667,6,8,4,12,18,14,128,304,176,56,97,76,26,8,8,570,584,477,520,22,15,0.42105263157894735,30183086.95
NIKITA.NIKITIN,20122013,CBJ,805.5,3,2,3,5,8,5,0,0,0,60,143,31,48,6,7,624,710,466,540,25,20,0,30183073.784999996
NIKLAS.HJALMARSSON,20122013,CHI,1496.35,2,5,6,11,13,7,0,0,0,55,133,48,46,5,13,1176,1321,1066,911,54,35,0,30183097.200000003
NIKLAS.KRONWALL,20122013,DET,1521.4833333333333,5,10,13,23,28,15,0,0,0,81,225,68,89,13,23,1449,1218,942,858,33,37,0,30183100.405
NIKOLAY.KULEMIN,20122013,TOR,930.6500000000001,7,11,5,16,23,18,15,30,15,81,149,150,31,8,11,680,1071,598,828,32,44,0.5,30183122.055
NOLAN.YONKMAN,20122013,FLA,68.38333333333333,0,0,0,0,0,0,0,0,0,4,8,12,0,1,4,45,59,45,59,2,3,0,30183026.61
OLIVER.EKMAN-LARSSON,20122013,ARI,1204.6166666666666,3,11,10,21,24,14,0,0,0,101,221,73,77,18,13,1126,1068,761,736,33,27,0,30183091.43
OLIVER.LAURIDSEN,20122013,PHI,227,2,1,0,1,3,3,0,0,0,15,29,36,8,3,10,178,235,170,206,12,12,0,30183043.130000003
OLLI.JOKINEN,20122013,WPG,770.7166666666667,7,3,4,7,14,10,300,630,330,85,176,91,47,9,8,818,665,596,623,17,37,0.47619047619047616,30183099.439999998
ONDREJ.PALAT,20122013,T.B,164.26666666666665,2,0,2,2,4,2,0,6,6,16,26,27,4,1,1,128,146,120,134,8,4,0,30183034.61
P.A..PARENTEAU,20122013,COL,919.0333333333333,18,15,9,24,42,33,1,13,12,105,174,50,47,9,14,959,782,698,704,30,35,0.07692307692307693,30183108.205
P.K..SUBBAN,20122013,MTL,1095.8833333333332,13,13,15,28,41,26,0,0,0,147,280,59,90,19,32,1218,784,794,602,38,21,0,30183080.615000002
PASCAL.DUPUIS,20122013,PIT,1123.3333333333335,27,7,14,21,48,34,27,61,34,177,321,123,70,9,15,1076,1112,937,863,61,32,0.4426229508196721,30183118.87
PATRIC.HORNQVIST,20122013,NSH,389.4,4,3,7,10,14,7,1,2,1,87,129,29,21,5,6,408,267,271,253,9,10,0.5,30183049.715
PATRICE.BERGERON,20122013,BOS,1266.3333333333335,19,14,13,27,46,33,853,1377,524,196,328,59,67,15,13,1435,960,1050,724,37,19,0.6194625998547567,30183111.545
PATRICE.CORMIER,20122013,WPG,38.86666666666666,0,0,0,0,0,0,1,6,5,4,10,15,5,5,2,34,31,34,31,0,3,0.16666666666666666,30183022.490000002
PATRICK.BORDELEAU,20122013,COL,286.2166666666667,2,1,2,3,5,3,0,2,2,23,39,115,7,7,22,218,265,215,258,8,14,0,30183051.92
PATRICK.DWYER,20122013,CAR,709.85,8,6,2,8,16,14,17,47,30,93,171,57,39,9,6,668,753,608,552,22,28,0.3617021276595745,30183078.77
PATRICK.EAVES,20122013,DET,489.8,3,5,3,8,11,8,10,15,5,57,108,65,22,1,4,369,427,344,340,12,14,0.6666666666666666,30183056.884999998
PATRICK.KALETA,20122013,BUF,366.93333333333334,1,0,0,0,1,1,5,11,6,34,51,86,10,30,18,207,410,193,264,4,8,0.45454545454545453,30183053
PATRICK.KANE,20122013,CHI,1424.0166666666667,32,31,11,42,74,63,3,15,12,226,377,14,79,18,8,1378,1054,1024,940,59,46,0.2,30183142.125
PATRICK.MARLEAU,20122013,S.J,1151.5333333333333,22,7,10,17,39,29,85,173,88,191,313,55,64,11,13,1318,960,788,712,29,29,0.4913294797687861,30183108.11
PATRICK.MAROON,20122013,ANA,127.21666666666667,2,1,0,1,3,3,4,14,10,21,31,22,1,3,3,104,123,94,118,4,3,0.2857142857142857,30183035.689999998
PATRICK.SHARP,20122013,CHI,947.0833333333334,16,12,8,20,36,28,72,122,50,179,319,76,80,20,10,916,690,672,590,29,23,0.5901639344262295,30183088.880000003
PATRICK.WIERCIOCH,20122013,OTT,660.9166666666666,5,10,3,13,18,15,0,0,0,82,168,29,62,6,14,823,489,584,425,19,11,0,30183057.384999998
PATRIK.BERGLUND,20122013,STL,914.3833333333333,18,5,4,9,27,23,314,690,376,85,156,69,34,8,7,806,745,544,579,25,30,0.45507246376811594,30183106.990000002
PATRIK.ELIAS,20122013,N.J,898.5333333333333,14,14,8,22,36,28,71,163,92,118,210,20,55,13,NA,958,527,553,380,18,15,0.43558282208588955,NA
PAUL.BISSONNETTE,20122013,ARI,151.88333333333333,0,3,3,6,6,3,0,0,0,13,23,35,3,9,8,141,133,141,133,9,7,0,30183034.415
PAUL.BYRON,20122013,CGY,41.81666666666667,0,1,0,1,1,1,7,17,10,1,4,3,1,0,1,25,43,24,41,0,3,0.4117647058823529,30183025.48
PAUL.GAUSTAD,20122013,NSH,350.1,2,1,1,2,4,3,268,449,181,35,53,40,10,4,8,239,359,204,247,6,7,0.5968819599109132,30183055.335
PAUL.MARTIN,20122013,PIT,1260.6499999999999,8,11,15,26,34,19,0,0,0,61,149,30,52,4,10,1153,1142,826,834,48,30,0,30183105.665
PAUL.POSTMA,20122013,WPG,510.96666666666664,4,4,1,5,9,8,0,0,0,32,93,17,33,1,3,511,408,423,381,14,18,0,30183055.585
PAUL.STASTNY,20122013,COL,774.2666666666667,9,5,10,15,24,14,409,781,372,87,139,21,18,8,7,714,751,484,538,15,23,0.5236875800256082,30183100.84
PAVEL.DATSYUK,20122013,DET,1242.1833333333334,18,20,18,38,56,38,669,1212,543,146,281,48,68,16,9,1372,864,880,645,36,19,0.551980198019802,30183110.869999997
PETER.HARROLD,20122013,N.J,405.5333333333333,2,2,1,3,5,4,0,0,0,36,68,21,19,3,3,372,215,295,183,4,13,0,30183033.605
PETER.HOLLAND,20122013,ANA,243.38333333333333,3,2,0,2,5,5,89,203,114,26,50,17,12,1,2,228,203,185,197,10,6,0.43842364532019706,30183046.119999997
PETER.MUELLER,20122013,FLA,699.2666666666667,8,7,2,9,17,15,46,104,58,131,193,29,31,4,9,768,586,602,543,20,26,0.4423076923076923,30183083.18
PETER.REGIN,20122013,OTT,310.98333333333335,0,2,1,3,3,2,91,209,118,37,64,12,17,4,3,284,270,235,199,8,10,0.4354066985645933,30183042.355
PHIL.KESSEL,20122013,TOR,1080.2166666666667,24,25,9,34,58,49,5,10,5,190,364,17,99,11,9,1205,1096,842,990,46,36,0.5,30183146.535
PHILIP.LARSEN,20122013,DAL,476.16666666666663,2,1,2,3,5,3,0,0,0,30,64,49,25,2,8,390,451,344,406,9,15,0,30183062.92
PIERRE-CEDRIC.LABRIE,20122013,T.B,162.6,2,1,0,1,3,3,2,4,2,16,35,40,7,6,9,126,137,126,137,4,2,0.5,30183036.34
PIERRE-MARC.BOUCHARD,20122013,MIN,672.5500000000001,9,5,7,12,21,14,1,8,7,81,118,14,23,6,5,642,525,470,481,25,23,0.125,30183075.725
QUINTON.HOWDEN,20122013,FLA,188.2,0,0,0,0,0,0,1,4,3,22,39,21,9,6,1,180,147,178,139,1,10,0.25,30183031.4
RADEK.DVORAK,20122013,ANA,118.19999999999999,4,0,0,0,4,4,0,2,2,17,23,2,1,0,1,79,108,76,93,3,2,0,30183032.950000003
RADEK.MARTINEK,20122013,NYI,246.10000000000002,3,0,0,0,3,3,0,0,0,15,36,16,9,2,3,198,240,194,222,6,10,0,30183044.17
RADIM.VRBATA,20122013,ARI,622.2666666666667,12,10,6,16,28,22,10,32,22,106,174,26,34,2,7,696,519,474,453,18,12,0.3125,30183077.67
RADKO.GUDAS,20122013,T.B,373.83333333333337,2,1,2,3,5,3,0,0,0,31,62,87,20,8,12,369,324,350,298,15,13,0,30183046.98
RAFFI.TORRES,20122013,ARI,363.98333333333335,5,2,5,7,12,7,4,6,2,40,67,49,7,4,5,362,326,304,311,13,14,0.6666666666666666,30183055.775
RAFFI.TORRES,20122013,S.J,242.01666666666665,3,4,0,4,7,7,7,14,7,32,51,56,8,4,3,258,213,220,196,9,10,0.5,30183042.02
RAPHAEL.DIAZ,20122013,MTL,584.65,1,4,7,11,12,5,0,0,0,44,88,22,25,4,3,518,551,341,402,11,10,0,30183063.465
RAY.WHITNEY,20122013,DAL,620.6666666666667,11,9,9,18,29,20,16,51,35,62,138,10,41,5,2,666,498,447,436,24,18,0.3137254901960784,30183071.165
REILLY.SMITH,20122013,DAL,403.9333333333333,3,4,2,6,9,7,3,4,1,34,65,18,14,8,6,391,312,334,278,10,10,0.75,30183048.05
RENE.BOURQUE,20122013,MTL,521.5833333333334,9,5,2,7,16,14,3,5,2,80,161,49,35,14,17,543,432,376,375,13,14,0.6,30183065.71
RICH.CLUNE,20122013,NSH,442.06666666666666,4,3,2,5,9,7,0,2,2,46,76,159,15,25,33,340,379,331,372,14,11,0,30183066.6
RICH.PEVERLEY,20122013,BOS,1025.8833333333332,8,5,7,12,20,13,330,550,220,130,205,44,34,12,14,932,959,719,716,11,28,0.6,30183109.495
RICHARD.PANIK,20122013,T.B,283.2166666666667,5,2,2,4,9,7,1,3,2,34,56,38,12,5,2,275,250,240,240,11,13,0.3333333333333333,30183046.939999998
RICK.NASH,20122013,NYR,1124.2166666666667,22,15,10,25,47,37,5,12,7,217,360,64,90,17,NA,1271,937,926,790,48,23,0.4166666666666667,NA
RICKARD.RAKELL,20122013,ANA,35.8,0,0,0,0,0,0,10,21,11,3,3,4,0,0,0,14,37,14,37,0,2,0.47619047619047616,30183024.950000003
RILEY.NASH,20122013,CAR,409.6166666666667,4,5,0,5,9,9,128,289,161,36,63,36,11,4,4,409,370,368,345,11,16,0.4429065743944637,30183064.310000002
RILEY.SHEAHAN,20122013,DET,6.783333333333333,0,0,0,0,0,0,0,1,1,1,1,0,0,0,0,5,3,5,3,0,0,0,15091510.05
RJ.UMBERGER,20122013,CBJ,887.4666666666667,8,5,5,10,18,13,54,108,54,96,169,51,42,14,7,758,776,507,640,20,16,0.5,30183097.725
ROB.KLINKHAMMER,20122013,ARI,269.06666666666666,5,4,1,5,10,9,2,2,0,34,58,65,11,3,5,262,230,252,213,11,4,1,30183043.785
ROB.SCUDERI,20122013,L.A,1465.4833333333333,1,4,10,14,15,5,0,1,1,45,103,51,35,1,2,1147,1452,1042,1041,46,48,0,30183117.66
ROBERT.BORTUZZO,20122013,PIT,199.36666666666667,2,1,1,2,4,3,0,0,0,10,25,18,7,6,9,169,187,163,171,10,7,0,30183038.384999998
ROBYN.REGEHR,20122013,BUF,541.0166666666667,0,0,2,2,2,0,0,0,0,15,39,65,13,3,9,326,675,297,455,13,19,0,30183071.28
ROBYN.REGEHR,20122013,L.A,637.3833333333333,0,1,2,3,3,1,0,0,0,28,77,76,19,3,4,471,616,421,469,8,17,0,30183067.48
ROMAN.CERVENKA,20122013,CGY,512.4833333333333,9,3,5,8,17,12,58,125,67,51,103,7,23,4,7,449,418,351,402,15,28,0.464,30183071.285
ROMAN.HAMRLIK,20122013,NYR,135.81666666666666,0,0,1,1,1,0,0,0,0,5,13,7,4,0,4,129,111,128,110,2,5,0,30183029.625
ROMAN.HAMRLIK,20122013,WSH,62.38333333333333,0,0,1,1,1,0,0,0,0,2,9,2,4,0,1,49,46,47,40,1,3,0,30183022.725
ROMAN.HORAK,20122013,CGY,290.55,2,3,2,5,7,5,93,205,112,28,48,18,9,2,1,227,269,196,238,8,14,0.45365853658536587,30183052.29
ROMAN.JOSI,20122013,NSH,1129.4166666666665,5,8,5,13,18,13,0,0,0,96,182,31,60,6,4,1014,950,710,813,32,33,0,30183105.884999998
ROMAN.POLAK,20122013,STL,1005.1166666666668,1,2,4,6,7,3,0,0,0,47,117,130,38,11,18,756,881,703,694,26,30,0,30183086.11
RON.HAINSEY,20122013,WPG,1074.4166666666665,0,5,7,12,12,5,0,0,0,52,121,36,48,4,5,922,1168,816,897,33,43,0,30183107.765
ROSTISLAV.KLESLA,20122013,ARI,669.8333333333334,2,3,3,6,8,5,0,0,0,44,96,40,30,3,11,551,736,512,564,21,22,0,30183078.005
RUSLAN.FEDOTENKO,20122013,PHI,590.9666666666667,4,5,4,9,13,9,67,186,119,43,83,52,19,8,6,372,661,321,427,18,14,0.3602150537634409,30183076.21
RYAN.CALLAHAN,20122013,NYR,1248.3,18,7,11,18,36,25,15,31,16,184,323,217,64,22,NA,1294,1256,905,836,34,22,0.4838709677419355,NA
RYAN.CARTER,20122013,N.J,574.3166666666667,6,7,2,9,15,13,43,83,40,63,100,50,14,10,13,447,393,423,345,16,20,0.5180722891566265,30183060.57
RYAN.ELLIS,20122013,NSH,524.1333333333333,2,3,1,4,6,5,0,0,0,48,82,22,22,8,6,452,395,346,347,12,15,0,30183055.655
RYAN.GARBUTT,20122013,DAL,357.18333333333334,3,4,3,7,10,7,7,17,10,59,103,67,29,7,13,318,355,299,314,15,13,0.4117647058823529,30183054.975
RYAN.GETZLAF,20122013,ANA,1038.7333333333333,18,27,10,37,55,45,394,856,462,114,208,103,47,10,17,1028,914,685,713,35,24,0.4602803738317757,30183135.61
RYAN.HAMILTON,20122013,TOR,124.80000000000001,0,2,1,3,3,2,4,18,14,9,13,27,2,2,0,79,148,75,123,4,3,0.2222222222222222,30183035.604999997
RYAN.JOHANSEN,20122013,CBJ,643.3666666666667,5,5,2,7,12,10,271,528,257,84,118,42,15,8,8,588,557,409,514,16,23,0.5132575757575758,30183093.520000003
RYAN.JONES,20122013,EDM,350.3833333333333,2,3,2,5,7,5,2,9,7,38,63,55,13,6,6,250,365,226,298,9,8,0.2222222222222222,30183055.990000002
RYAN.KESLER,20122013,VAN,414.56666666666666,6,5,4,9,15,11,227,405,178,49,111,46,32,11,6,389,385,249,252,12,18,0.5604938271604938,30183055.59
RYAN.MALONE,20122013,T.B,377.7166666666667,6,0,2,2,8,6,9,23,14,37,55,49,7,8,9,330,336,216,284,11,11,0.391304347826087,30183056.84
RYAN.MCDONAGH,20122013,NYR,1455.3833333333332,5,9,9,18,23,14,0,1,1,104,225,96,78,11,NA,1302,1473,1182,1113,45,34,0,NA
RYAN.MURPHY,20122013,CAR,84.25,0,0,0,0,0,0,0,0,0,7,15,2,5,0,1,79,92,66,84,1,5,0,30183028.4
RYAN.NUGENT-HOPKINS,20122013,EDM,754.55,4,10,9,19,23,14,226,551,325,78,150,27,34,12,4,781,624,557,562,24,23,0.4101633393829401,30183094.835
RYAN.O'BYRNE,20122013,COL,640.9000000000001,1,0,3,3,4,1,0,0,0,21,64,75,22,5,19,462,737,441,546,20,27,0,30183077.924999997
RYAN.O'BYRNE,20122013,TOR,228.76666666666665,1,1,0,1,2,2,0,0,0,5,9,55,2,1,5,172,297,168,257,10,4,0,30183050.11
RYAN.O'REILLY,20122013,COL,536.5666666666666,6,6,7,13,19,12,241,455,214,66,118,7,30,7,2,573,396,401,323,16,15,0.5296703296703297,30183060.985
RYAN.REAVES,20122013,STL,364.43333333333334,4,1,1,2,6,5,3,3,0,30,43,158,7,14,21,282,263,281,258,8,6,1,30183050.085
RYAN.SMYTH,20122013,EDM,722.4166666666667,2,8,2,10,12,10,87,202,115,68,112,41,17,10,15,510,767,404,531,12,17,0.4306930693069307,30183091.18
RYAN.SPOONER,20122013,BOS,36.483333333333334,0,0,0,0,0,0,11,24,13,4,8,1,3,0,0,38,31,27,31,0,0,0.4583333333333333,15091513.34
RYAN.STANTON,20122013,CHI,17.083333333333336,0,0,0,0,0,0,0,0,0,1,2,1,0,0,1,22,14,22,13,1,0,0,15091510.65
RYAN.SUTER,20122013,MIN,1465.3666666666668,4,9,19,28,32,13,0,0,0,96,214,43,80,6,14,1318,1207,844,913,33,35,0,30183113.435000002
RYAN.WHITE,20122013,MTL,272,2,0,0,0,2,2,102,184,82,20,44,61,10,10,22,189,257,175,209,4,6,0.5543478260869565,30183048.88
RYAN.WHITNEY,20122013,EDM,628.2333333333333,4,2,7,9,13,6,0,0,0,30,57,16,23,5,10,496,630,375,541,17,17,0,30183083.375
RYAN.WILSON,20122013,COL,222.03333333333336,0,0,3,3,3,0,0,0,0,23,46,17,13,0,4,199,235,178,173,9,4,0,30183035.225
RYANE.CLOWE,20122013,NYR,218.54999999999998,3,3,3,6,9,6,1,3,2,22,33,34,4,4,4,202,157,158,144,10,6,0.3333333333333333,30183036.905
RYANE.CLOWE,20122013,S.J,461,0,6,5,11,11,6,4,12,8,65,132,69,38,9,16,519,391,376,339,13,13,0.3333333333333333,30183053.674999997
SAKU.KOIVU,20122013,ANA,952.35,9,11,9,20,29,20,508,987,479,61,122,39,37,9,12,827,856,605,592,20,19,0.5146909827760892,30183106.335
SAM.GAGNER,20122013,EDM,931.75,14,11,13,24,38,25,324,740,416,113,193,35,45,10,10,766,889,519,683,28,33,0.43783783783783786,30183126.685000002
SAMI.SALO,20122013,T.B,965.3166666666667,2,4,9,13,15,6,0,0,0,48,99,40,34,2,8,724,940,538,662,33,26,0,30183089.744999997
SAMI.VATANEN,20122013,ANA,126.55000000000001,2,0,0,0,2,2,0,0,0,6,12,2,5,0,0,126,106,91,96,4,0,0,30183029.700000003
SCOTT.GOMEZ,20122013,S.J,662.9833333333333,2,6,9,15,17,8,229,424,195,70,118,6,22,7,10,711,566,501,513,12,21,0.5400943396226415,30183084.205
SCOTT.HANNAN,20122013,NSH,563.9666666666667,0,1,0,1,1,1,0,0,0,20,43,29,17,4,7,360,559,330,398,11,22,0,30183061.14
SCOTT.HANNAN,20122013,S.J,263.41666666666663,0,2,2,4,4,2,0,0,0,14,30,14,9,0,3,207,289,202,218,6,8,0,30183042.25
SCOTT.HARTNELL,20122013,PHI,506.75,8,3,0,3,11,11,3,4,1,74,128,68,19,20,27,592,402,389,365,11,12,0.75,30183065.52
SCOTT.LAUGHTON,20122013,PHI,57.58333333333333,0,0,0,0,0,0,19,43,24,10,15,10,5,1,1,37,51,36,50,0,0,0.4418604651162791,30183026.119999997
SCOTT.NICHOL,20122013,STL,293,1,0,0,0,1,1,132,218,86,13,22,27,5,5,7,173,263,168,170,5,7,0.6055045871559633,30183040.53
SCOTT.TIMMINS,20122013,FLA,52.916666666666664,0,0,0,0,0,0,15,31,16,6,10,6,2,0,2,27,78,27,62,0,2,0.4838709677419355,30183028.4
SCOTTIE.UPSHALL,20122013,FLA,364.48333333333335,4,1,0,1,5,5,9,14,5,54,84,38,11,12,9,301,345,254,284,4,12,0.6428571428571429,30183054.83
SEAN.COLLINS,20122013,CBJ,62.46666666666667,0,0,0,0,0,0,1,5,4,0,4,3,1,2,3,45,73,45,72,1,3,0.2,30183028.41
SEAN.COUTURIER,20122013,PHI,730.9,4,6,5,11,15,10,243,553,310,75,122,31,25,5,5,595,658,440,470,17,25,0.4394213381555154,30183085.795
SERGEI.GONCHAR,20122013,OTT,1318.85,3,12,17,29,32,15,0,0,0,101,230,30,87,3,20,1413,1179,920,850,31,31,0,30183101.355
SERGEI.KOSTITSYN,20122013,NSH,767.4000000000001,3,7,5,12,15,10,3,4,1,42,107,27,37,7,5,620,650,461,509,18,23,0.75,30183073.814999998
SHANE.DOAN,20122013,ARI,866.6333333333334,13,7,7,14,27,20,4,15,11,129,220,118,53,12,17,938,734,688,646,29,25,0.26666666666666666,30183092.805
SHANE.O'BRIEN,20122013,COL,434.0833333333333,0,2,2,4,4,2,0,0,0,28,66,42,26,7,18,420,355,382,330,17,16,0,30183048.869999997
SHAWN.HORCOFF,20122013,EDM,522.5,7,1,4,5,12,8,245,500,255,41,60,24,9,6,11,414,540,281,376,18,9,0.49,30183077.61
SHAWN.LALONDE,20122013,CHI,14.783333333333335,0,0,0,0,0,0,0,0,0,0,1,3,1,0,0,14,8,14,7,1,0,0,15091509.8
SHAWN.MATTHIAS,20122013,FLA,729.1166666666666,14,5,2,7,21,19,153,347,194,105,168,66,36,5,8,638,691,533,574,24,33,0.4409221902017291,30183097.32
SHAWN.THORNTON,20122013,BOS,526.3499999999999,3,4,4,8,11,7,11,23,12,81,136,132,32,15,20,458,483,457,481,16,13,0.4782608695652174,30183073.89
SHEA.WEBER,20122013,NSH,1243.0166666666669,9,8,11,19,28,17,0,0,0,124,239,112,63,12,13,1062,1053,724,851,30,32,0,30183116.795
SHELDON.BROOKBANK,20122013,CHI,338.3333333333333,1,0,0,0,1,1,0,1,1,25,52,29,14,4,9,281,298,274,270,8,13,0,30183046.39
SHELDON.SOURAY,20122013,ANA,1038,7,2,8,10,17,9,1,1,0,93,191,35,65,6,24,927,1031,690,747,37,26,1,30183096.65
SIDNEY.CROSBY,20122013,PIT,1082.95,22,33,16,49,71,55,625,1178,553,183,298,25,53,22,12,1357,857,868,706,57,30,0.530560271646859,30183132.82
SIMON.DESPRES,20122013,PIT,532.1666666666667,2,3,2,5,7,5,0,0,0,33,65,50,23,1,10,484,421,430,390,22,15,0,30183056.11
SIMON.GAGNE,20122013,L.A,151.36666666666667,0,3,2,5,5,3,0,0,0,20,38,6,10,3,1,157,97,117,86,5,4,0,30183027.28
SIMON.GAGNE,20122013,PHI,385.8666666666667,5,2,4,6,11,7,2,2,0,56,97,18,22,1,4,347,373,279,332,12,14,1,30183058.54
SLAVA.VOYNOV,20122013,L.A,1464.9,12,12,13,25,37,24,2,2,0,113,287,123,106,5,7,1400,1181,1082,973,50,38,1,30183110.655
STEFAN.ELLIOTT,20122013,COL,315.0833333333333,1,3,0,3,4,4,0,0,0,35,78,9,29,0,1,321,275,259,251,9,14,0,30183042.75
STEFAN.MATTEAU,20122013,N.J,156.18333333333334,1,2,0,2,3,3,0,4,4,22,28,25,5,2,2,128,121,125,120,4,5,0,30183033.32
STEPHANE.DA COSTA,20122013,OTT,106.73333333333335,1,1,0,1,2,2,39,64,25,15,35,8,10,2,0,132,83,91,76,0,3,0.609375,30183027.73
STEPHANE.ROBIDAS,20122013,DAL,1067.4499999999998,1,5,6,11,12,6,0,0,0,45,128,136,49,13,21,905,1084,675,724,36,33,0,30183091.03
STEPHANE.VEILLEUX,20122013,MIN,15.05,0,0,0,0,0,0,0,1,1,1,1,6,0,0,0,15,14,10,14,0,0,0,15091511.45
STEPHEN.GIONTA,20122013,N.J,625.2166666666667,4,5,5,10,14,9,137,390,253,58,95,87,9,15,7,390,462,344,346,17,16,0.35128205128205126,30183071.605
STEPHEN.WEISS,20122013,FLA,313.8333333333333,1,2,1,3,4,3,141,276,135,19,40,6,14,2,7,234,281,158,219,3,15,0.5108695652173914,30183051.135
STEVE.BEGIN,20122013,CGY,287.76666666666665,4,0,4,4,8,4,57,117,60,31,58,62,9,7,5,220,295,207,226,11,14,0.48717948717948717,30183047.950000003
STEVE.BERNIER,20122013,N.J,646.8333333333334,8,5,2,7,15,13,5,10,5,88,127,64,13,12,5,550,396,431,366,14,18,0.5,30183062.77
STEVE.DOWNIE,20122013,COL,17.783333333333335,0,1,0,1,1,1,1,1,0,2,4,5,0,0,3,14,14,13,14,1,0,1,30183021.89
STEVE.EMINGER,20122013,NYR,596.65,0,1,4,5,5,1,0,0,0,25,53,75,20,7,5,536,613,519,562,19,9,0,30183074.92
STEVE.MACINTYRE,20122013,PIT,4.516666666666667,0,0,0,0,0,0,0,0,0,0,0,2,0,0,2,1,2,1,2,0,0,0,15091510.3
STEVE.OLEKSY,20122013,WSH,589.5999999999999,1,3,6,9,10,4,0,0,0,31,90,72,41,11,14,540,614,521,477,26,17,0,30183061.509999998
STEVE.OTT,20122013,BUF,890.7833333333333,9,9,6,15,24,18,298,535,237,73,126,187,29,19,30,696,913,441,659,21,15,0.5570093457943925,30183117.71
STEVE.SULLIVAN,20122013,ARI,473.8833333333333,5,2,5,7,12,7,0,1,1,48,87,11,29,4,9,531,359,373,330,11,18,0,30183053.165
STEVE.SULLIVAN,20122013,N.J,137.38333333333333,2,2,1,3,5,4,3,5,2,13,22,1,4,1,2,145,69,85,54,3,5,0.6,30183025.905
STEVEN.PINIZZOTTO,20122013,VAN,123.85,0,0,0,0,0,0,0,0,0,10,16,32,2,4,6,83,119,83,119,0,6,0,30183034.34
STEVEN.STAMKOS,20122013,T.B,1057.1,29,17,11,28,57,46,406,819,413,157,287,63,62,16,15,1024,854,703,709,39,40,0.49572649572649574,30183132.875
STU.BICKEL,20122013,NYR,88.26666666666667,0,0,0,0,0,0,0,0,0,2,6,13,3,4,11,51,78,48,77,1,3,0,30183029.84
SVEN.BAERTSCHI,20122013,CGY,267.96666666666664,3,4,3,7,10,7,1,1,0,28,44,12,8,6,4,242,233,192,218,8,10,1,30183046.775
T.J..OSHIE,20122013,STL,683.9333333333334,9,7,5,12,21,16,7,21,14,71,141,42,35,10,7,635,556,430,442,12,17,0.3333333333333333,30183073.105
TANNER.GLASS,20122013,PIT,524.5666666666666,2,0,1,1,3,2,24,58,34,41,58,135,12,13,19,303,540,290,408,7,16,0.41379310344827586,30183071.314999998
TANNER.PEARSON,20122013,L.A,5.733333333333333,0,0,0,0,0,0,0,0,0,0,1,0,1,0,0,5,3,5,3,0,0,0,15091509.8
TAYLOR.BECK,20122013,NSH,257.5,3,2,2,4,7,5,6,9,3,39,64,13,15,2,2,246,205,196,196,10,8,0.6666666666666666,30183041.060000002
TAYLOR.HALL,20122013,EDM,837.9166666666667,16,25,9,34,50,41,29,53,24,154,258,24,55,16,11,911,699,648,639,35,30,0.5471698113207547,30183105.494999997
TAYLOR.PYATT,20122013,NYR,791.3666666666667,8,4,3,7,15,12,3,10,7,75,120,117,15,2,5,706,763,636,744,24,16,0.3,30183106.314999998
TEDDY.PURCELL,20122013,T.B,803.65,11,20,5,25,36,31,2,6,4,94,158,11,36,4,7,808,655,554,587,31,28,0.3333333333333333,30183094.845
TEEMU.HARTIKAINEN,20122013,EDM,243.06666666666666,1,1,1,2,3,2,1,4,3,21,48,22,9,2,4,220,192,153,178,0,7,0.25,30183040.335
TEEMU.SELANNE,20122013,ANA,819.8333333333334,13,12,2,14,27,25,94,184,90,112,193,16,42,9,7,818,727,561,663,19,22,0.5108695652173914,30183107.9
THEO.PECKHAM,20122013,EDM,70.55,0,0,0,0,0,0,0,0,0,2,8,14,3,1,3,43,68,39,49,2,3,0,30183024.71
THOMAS.HICKEY,20122013,NYI,694.0833333333333,1,1,2,3,4,2,0,0,0,41,95,29,40,4,5,655,569,608,482,26,18,0,30183055.740000002
THOMAS.VANEK,20122013,BUF,699.4166666666667,20,14,7,21,41,34,8,12,4,119,200,13,42,9,9,739,655,489,577,26,29,0.6666666666666666,30183101.134999998
TIM.BRENT,20122013,CAR,293.79999999999995,0,0,3,3,3,0,124,240,116,23,44,31,11,4,4,299,237,211,171,3,5,0.5166666666666667,30183039.075
TIM.ERIXON,20122013,CBJ,486.58333333333326,0,3,2,5,5,3,0,0,0,21,61,19,27,4,7,405,407,339,373,20,15,0,30183055.39
TIM.GLEASON,20122013,CAR,820.2166666666667,0,2,6,8,8,2,0,0,0,36,100,90,43,13,10,708,956,655,698,29,33,0,30183085.63
TIM.JACKMAN,20122013,CGY,319.18333333333334,1,4,0,4,5,5,11,24,13,42,72,98,14,15,18,283,294,270,294,5,14,0.4583333333333333,30183055.64
TIM.KENNEDY,20122013,S.J,202.91666666666666,2,0,0,0,2,2,6,19,13,24,39,28,8,2,2,172,186,156,181,3,5,0.3157894736842105,30183040.71
TIM.SESTITO,20122013,N.J,47.233333333333334,0,0,0,0,0,0,14,26,12,4,9,10,2,2,1,36,30,36,30,2,0,0.5384615384615384,30183022.43
TIM.WALLACE,20122013,CAR,280.8,1,1,0,1,2,2,9,30,21,20,35,69,5,8,3,198,255,191,215,3,12,0.3,30183044.740000002
TJ.BRENNAN,20122013,BUF,148.11666666666667,1,0,0,0,1,1,0,0,0,18,34,3,8,2,3,140,135,98,118,5,4,0,30183032.42
TJ.BRENNAN,20122013,FLA,335.85,2,4,3,7,9,6,0,0,0,24,72,28,25,6,1,355,290,284,267,7,14,0,30183045.784999996
TJ.BRODIE,20122013,CGY,950.1833333333334,2,5,5,10,12,7,0,0,0,44,107,24,38,7,4,866,791,709,698,24,33,0,30183086.845
TJ.GALIARDI,20122013,S.J,684.4833333333333,6,6,4,10,16,12,10,25,15,87,158,48,35,7,9,679,644,599,563,19,17,0.4,30183080.12
TOBIAS.ENSTROM,20122013,WPG,495.5333333333333,4,3,8,11,15,7,0,0,0,21,50,9,15,3,4,484,450,337,353,10,19,0,30183058.58
TOBY.PETERSEN,20122013,DAL,6.666666666666667,0,0,0,0,0,0,1,2,1,0,2,1,1,0,0,7,7,7,7,0,0,0.5,15091510.34
TODD.BERTUZZI,20122013,DET,166.56666666666666,2,0,1,1,3,2,0,2,2,16,26,13,5,0,2,149,118,128,106,5,4,0,30183030.174999997
TOM.GILBERT,20122013,MIN,912.0833333333333,3,4,6,10,13,7,0,0,0,36,107,28,42,7,10,749,770,582,628,27,40,0,30183082.37
TOM.KOSTOPOULOS,20122013,N.J,136.45,1,0,0,0,1,1,3,5,2,13,22,23,4,7,6,110,72,108,69,3,3,0.6,30183025.79
TOM.POTI,20122013,WSH,243.58333333333331,0,2,0,2,2,2,0,0,0,8,24,5,11,3,2,208,263,200,235,7,9,0,30183043.880000003
TOM.PYATT,20122013,T.B,584.0166666666667,8,6,2,8,16,14,144,289,145,60,100,22,19,12,6,424,619,392,472,23,19,0.4982698961937716,30183083.28
TOM.SESTITO,20122013,PHI,40.416666666666664,2,0,0,0,2,2,1,1,0,3,6,9,3,4,3,28,38,27,38,2,1,1,30183025.130000003
TOM.SESTITO,20122013,VAN,158.3,1,0,0,0,1,1,0,1,1,11,19,32,4,7,10,112,141,112,141,3,6,0,30183036.869999997
TOM.WANDELL,20122013,DAL,151.95,1,0,0,0,1,1,45,110,65,14,36,15,15,4,2,127,138,121,131,3,3,0.4090909090909091,30183034.94
TOM.WILSON,20122013,WSH,20.633333333333333,0,0,0,0,0,0,0,0,0,4,6,8,2,0,0,25,14,25,14,0,1,0,30183020.25
TOMAS.FLEISCHMANN,20122013,FLA,899.2333333333333,12,15,8,23,35,27,10,20,10,121,208,29,49,9,8,819,744,602,628,23,33,0.5,30183097.79
TOMAS.KABERLE,20122013,MTL,135.45,0,1,2,3,3,1,0,0,0,11,23,2,7,0,0,152,95,117,90,8,3,0,30183026.15
TOMAS.KOPECKY,20122013,FLA,831.2166666666667,15,7,5,12,27,22,42,85,43,93,166,22,40,10,10,706,769,527,580,16,27,0.49411764705882355,30183094.455
TOMAS.KUNDRATEK,20122013,WSH,403.6333333333333,1,3,3,6,7,4,0,0,0,23,62,21,27,5,4,335,388,291,329,8,15,0,30183053.425
TOMAS.PLEKANEC,20122013,MTL,1007.3666666666667,14,13,10,23,37,27,555,1085,530,148,258,28,64,10,13,989,890,641,603,23,22,0.511520737327189,30183112.950000003
TOMAS.TATAR,20122013,DET,204.73333333333332,4,2,1,3,7,6,1,1,0,32,57,9,14,5,2,235,115,171,111,8,5,1,30183030.215
TOMAS.VINCOUR,20122013,COL,18.116666666666667,0,0,1,1,1,0,0,0,0,1,2,2,1,0,1,12,21,10,20,1,2,0,15091512.225
TOMAS.VINCOUR,20122013,DAL,132.51666666666665,2,0,1,1,3,2,0,5,5,11,24,22,9,1,1,107,111,103,110,4,4,0,30183031.335
TOMMY.WINGELS,20122013,S.J,750.5166666666667,5,7,3,10,15,12,5,19,14,88,138,159,26,18,12,660,786,582,666,18,23,0.2631578947368421,30183098.305
TONI.LYDMAN,20122013,ANA,723.95,0,3,3,6,6,3,0,0,0,29,63,87,21,1,6,536,685,482,517,18,19,0,30183071.335
TOREY.KRUG,20122013,BOS,253.14999999999998,4,2,1,3,7,6,0,0,0,34,70,19,26,1,0,285,199,215,179,9,4,0,30183036.035
TORREY.MITCHELL,20122013,MIN,529.4333333333333,5,3,1,4,9,8,26,57,31,47,86,57,13,14,9,332,476,303,392,8,20,0.45614035087719296,30183070.355
TRAVIS.HAMONIC,20122013,NYI,1244.4833333333333,3,3,5,8,11,6,0,0,0,89,208,79,72,12,NA,1062,1324,880,999,38,53,0,NA
TRAVIS.MOEN,20122013,MTL,588.8666666666667,2,2,2,4,6,4,5,11,6,37,75,93,14,14,13,385,593,352,408,8,15,0.45454545454545453,30183066.64
TRAVIS.ZAJAC,20122013,N.J,937.5833333333333,7,7,6,13,20,14,506,881,375,82,146,33,27,14,NA,930,609,582,438,17,18,0.5743473325766175,NA
TREVOR.DALEY,20122013,DAL,942.1333333333333,4,3,6,9,13,7,0,0,0,58,147,27,53,6,7,804,964,605,684,32,27,0,30183088.01
TREVOR.LEWIS,20122013,L.A,1025.2333333333333,6,7,3,10,16,13,64,146,82,117,183,140,18,13,10,781,814,667,573,22,20,0.4383561643835616,30183085.314999998
TREVOR.SMITH,20122013,PIT,10.4,0,0,0,0,0,0,0,0,0,0,0,0,0,0,0,2,15,2,15,0,0,0,15091511.9
TROY.BROUWER,20122013,WSH,1008.1833333333334,20,12,3,15,35,32,118,252,134,124,210,127,38,6,14,1002,916,619,656,21,26,0.46825396825396826,30183112.805
TUOMO.RUUTU,20122013,CAR,259.06666666666666,4,3,2,5,9,7,1,8,7,30,59,51,19,1,4,292,227,246,212,11,15,0.125,30183041.549999997
TYE.MCGINN,20122013,PHI,228.95,3,0,2,2,5,3,0,0,0,33,51,19,10,6,5,253,173,205,159,7,7,0,30183035.259999998
TYLER.BOZAK,20122013,TOR,1042.9166666666665,13,8,9,17,30,21,622,1211,589,74,131,78,32,11,5,1054,1116,704,872,36,32,0.5136251032204789,30183146.865000002
TYLER.ENNIS,20122013,BUF,840.25,10,9,12,21,31,19,157,376,219,108,180,28,38,10,8,822,697,523,615,19,28,0.4175531914893617,30183105.979999997
TYLER.JOHNSON,20122013,T.B,183.03333333333333,3,2,1,3,6,5,72,121,49,11,28,18,8,3,2,158,157,127,124,7,4,0.5950413223140496,30183035.384999998
TYLER.KENNEDY,20122013,PIT,686.2,8,4,4,8,16,12,16,35,19,112,192,55,54,13,10,642,600,536,565,19,19,0.45714285714285713,30183082.62
TYLER.MYERS,20122013,BUF,831.2333333333333,3,3,2,5,8,6,0,0,0,48,102,58,35,4,15,663,820,496,585,21,27,0,30183082.64
TYLER.SEGUIN,20122013,BOS,1169.9166666666665,17,14,9,23,40,31,26,58,32,229,409,59,90,14,11,1437,881,1094,810,44,22,0.4482758620689655,30183101.055
TYLER.TOFFOLI,20122013,L.A,249.06666666666666,4,4,3,7,11,8,0,1,1,39,79,20,16,2,1,268,197,212,189,11,3,0,30183040.595
TYSON.BARRIE,20122013,COL,690.6166666666667,2,5,4,9,11,7,0,0,0,58,143,30,48,6,4,657,629,517,498,14,20,0,30183067.060000002
TYSON.STRACHAN,20122013,FLA,720.45,0,2,2,4,4,2,0,0,0,42,95,110,34,9,10,590,669,561,552,18,30,0,30183071.39
VALTTERI.FILPPULA,20122013,DET,960.6666666666667,11,9,3,12,23,20,255,461,206,102,175,28,30,12,6,957,739,695,625,23,28,0.5531453362255966,30183097.295
VERNON.FIDDLER,20122013,DAL,591.3,4,10,3,13,17,14,319,619,300,56,103,34,24,16,21,407,680,351,429,18,15,0.5153473344103393,30183086.445
VICTOR.BARTLEY,20122013,NSH,469.01666666666665,0,4,2,6,6,4,0,0,0,19,52,34,18,2,3,351,428,322,364,15,13,0,30183056.82
VICTOR.HEDMAN,20122013,T.B,997.0166666666667,4,8,7,15,19,12,0,0,0,76,156,56,45,9,15,788,950,633,681,41,37,0,30183090.965
VIKTOR.STALBERG,20122013,CHI,864.8666666666667,9,14,3,17,26,23,0,1,1,140,246,66,51,11,15,840,571,683,528,29,15,0,30183076.185
VILLE.LEINO,20122013,BUF,126.43333333333334,2,1,3,4,6,3,4,10,6,11,16,5,4,0,3,107,120,78,114,4,4,0.4,30183034.935000002
VINCENT.LECAVALIER,20122013,T.B,697.4333333333334,10,15,7,22,32,25,403,740,337,86,136,74,21,11,10,656,600,451,528,26,29,0.5445945945945946,30183103.604999997
VINNY.PROSPAL,20122013,CBJ,793.2666666666667,12,5,13,18,30,17,4,9,5,85,153,37,42,3,12,771,623,540,574,27,22,0.4444444444444444,30183086.665
VLADIMIR.SOBOTKA,20122013,STL,841.5833333333334,8,8,6,14,22,16,329,582,253,75,128,130,27,16,14,683,673,584,470,21,20,0.5652920962199313,30183079.42
VLADIMIR.TARASENKO,20122013,STL,515.4333333333334,8,9,2,11,19,17,1,1,0,75,135,28,26,11,4,553,336,415,310,15,14,1,30183054.25
WADE.REDDEN,20122013,BOS,171.43333333333334,2,2,0,2,4,4,0,0,0,14,30,13,9,0,0,183,139,160,128,8,6,0,30183031.35
WADE.REDDEN,20122013,STL,344.6,2,1,2,3,5,3,0,0,0,23,52,12,16,2,4,328,227,283,207,11,12,0,30183036.22
WAYNE.SIMMONDS,20122013,PHI,703.6833333333334,15,8,9,17,32,23,2,3,1,109,171,72,31,19,27,813,595,497,547,19,22,0.6666666666666666,30183094.495
WOJTEK.WOLSKI,20122013,WSH,360.45000000000005,4,4,1,5,9,8,1,5,4,49,80,5,12,0,3,351,281,307,270,12,12,0.2,30183049.215
YANNICK.WEBER,20122013,MTL,82.5,0,1,1,2,2,1,0,0,0,3,16,3,11,3,2,76,71,57,59,1,2,0,30183024.805
ZAC.DALPE,20122013,CAR,123.01666666666665,1,1,1,2,3,2,1,3,2,18,37,14,8,2,1,168,125,147,118,3,10,0.3333333333333333,30183030.685
ZAC.RINALDO,20122013,PHI,268.15,3,2,0,2,5,5,1,2,1,15,25,143,2,24,21,177,259,173,257,4,13,0.5,30183055.880000003
ZACH.BOGOSIAN,20122013,WPG,763.0666666666666,5,2,7,9,14,7,0,0,0,85,171,79,48,4,8,729,759,575,616,26,30,0,30183082.665
ZACH.BOYCHUK,20122013,CAR,10.216666666666667,0,0,0,0,0,0,0,0,0,0,2,0,0,1,0,8,5,8,5,0,0,0,15091510.11
ZACH.BOYCHUK,20122013,NSH,68.51666666666667,1,1,0,1,2,2,0,0,0,8,16,3,4,0,2,63,42,59,41,4,3,0,30183023.450000003
ZACH.BOYCHUK,20122013,PIT,81.31666666666666,0,0,0,0,0,0,0,0,0,6,10,7,1,2,1,63,63,63,63,1,3,0,30183025.97
ZACH.PARISE,20122013,MIN,1098.9833333333333,19,14,6,20,39,33,3,9,6,198,287,71,38,16,8,1149,804,715,615,27,34,0.3333333333333333,30183099.23
ZACH.REDMOND,20122013,WPG,156.63333333333333,1,2,1,3,4,3,0,0,0,13,28,12,9,0,5,152,103,126,87,3,4,0,30183027.725
ZACK.KASSIAN,20122013,VAN,574.05,7,2,2,4,11,9,6,16,10,53,NA,79,NA,13,15,517,485,439,464,15,24,0.375,NA
ZACK.SMITH,20122013,OTT,859.9333333333333,5,6,4,10,15,11,447,864,417,103,186,122,39,20,25,854,785,741,670,19,26,0.5173611111111112,30183106.83
ZBYNEK.MICHALEK,20122013,ARI,724.4,0,1,1,2,2,1,0,0,0,42,92,42,29,5,7,576,714,508,489,23,20,0,30183063.475
ZDENO.CHARA,20122013,BOS,1846.5666666666666,10,15,7,22,32,25,0,1,1,174,358,173,115,13,37,1841,1652,1387,1203,61,41,0,30183134.405
ZENON.KONOPKA,20122013,MIN,331.8666666666667,0,0,0,0,0,0,169,285,116,20,33,27,8,16,29,205,292,190,278,3,10,0.5929824561403508,30183059.67
AARON.NESS,20132014,NYI,295.8833333333333,1,0,1,1,2,1,0,0,0,23,49,14,17,2,5,273,309,253,271,3,13,0,30198048.695
AARON.PALUSHAJ,20132014,CAR,18.65,0,0,0,0,0,0,0,1,1,2,4,3,0,0,0,20,16,18,14,0,1,0,30198022.35
AARON.ROME,20132014,DAL,336.05,0,1,0,1,1,1,0,0,0,15,36,20,14,2,4,293,349,273,297,11,18,0,30198050.07
AARON.VOLPATTI,20132014,WSH,301.8666666666667,2,0,0,0,2,2,4,12,8,18,39,77,12,6,13,194,292,191,292,4,7,0.3333333333333333,30198057.520000003
ADAM.ALMQUIST,20132014,DET,34.43333333333333,1,0,0,0,1,1,0,0,0,2,3,1,1,0,0,29,26,21,21,2,2,0,30198023.450000003
ADAM.BURISH,20132014,S.J,144.3,0,0,0,0,0,0,39,75,36,9,18,23,2,1,3,117,136,113,101,2,6,0.52,30198032.22
ADAM.CRACKNELL,20132014,STL,219.05,1,1,1,2,3,2,11,29,18,22,39,57,8,4,1,182,200,175,195,7,7,0.3793103448275862,30198042.655
ADAM.HALL,20132014,PHI,857.2333333333333,4,4,2,6,10,8,352,589,237,67,110,89,24,8,12,492,954,424,551,13,30,0.597623089983022,30198095.61
ADAM.HENRIQUE,20132014,N.J,1390.1833333333334,25,9,9,18,43,34,407,918,511,137,223,73,42,20,10,1153,1063,825,739,33,36,0.4433551198257081,30198132.505
ADAM.LARSSON,20132014,N.J,462.4,1,2,0,2,3,3,0,0,0,20,54,41,23,3,6,373,333,348,279,10,13,0,30198044.23
ADAM.MCQUAID,20132014,BOS,481.4333333333333,1,2,3,5,6,3,0,0,0,25,57,54,25,12,19,396,448,366,359,20,10,0,30198056.045
ADAM.PARDY,20132014,WPG,865.25,0,2,4,6,6,2,0,0,0,47,100,77,32,8,17,753,739,730,632,30,26,0,30198076.38
ADAM.PAYERL,20132014,PIT,18.3,0,0,0,0,0,0,0,0,0,4,5,6,0,0,1,12,24,12,24,0,1,0,30198024.35
ALEC.MARTINEZ,20132014,L.A,1389.0833333333335,16,6,10,16,32,22,0,0,0,117,315,135,112,8,13,1564,1027,1156,896,49,35,0,30198096.58
ALEKSANDER.BARKOV,20132014,FLA,922.9000000000001,8,12,4,16,24,20,399,816,417,87,134,16,31,6,4,950,714,681,617,28,33,0.4889705882352941,30198105.02
ALES.HEMSKY,20132014,EDM,884.3,9,11,6,17,26,20,1,4,3,94,162,26,43,11,12,792,756,591,658,22,29,0.25,30198099.950000003
ALES.HEMSKY,20132014,OTT,312.5833333333333,4,4,9,13,17,8,0,0,0,44,73,11,14,5,2,389,276,297,245,17,16,0,30198046.475
ALEX.BURROWS,20132014,VAN,873.0833333333333,5,6,4,10,15,11,23,55,32,104,201,84,46,24,28,937,730,691,534,16,22,0.41818181818181815,30198075.36
ALEX.CHIASSON,20132014,DAL,1288.0833333333333,14,11,12,23,37,25,72,145,73,158,302,86,63,17,16,1497,1009,828,833,32,54,0.496551724137931,30198120.450000003
ALEX.EDLER,20132014,VAN,1467.0500000000002,7,5,9,14,21,12,2,3,1,178,404,112,158,14,25,1580,1305,1091,993,19,43,0.6666666666666666,30198109.995
ALEX.GALCHENYUK,20132014,MTL,1010.7333333333333,15,13,6,19,34,28,5,15,10,118,203,52,48,16,13,1045,940,773,869,25,40,0.3333333333333333,30198128.31
ALEX.GOLIGOSKI,20132014,DAL,2140.416666666667,7,19,19,38,45,26,0,1,1,149,329,110,121,9,18,2235,1966,1453,1368,68,51,0,30198152.265
ALEX.GRANT,20132014,ANA,24.35,2,0,0,0,2,2,0,0,0,2,7,1,4,0,1,30,20,30,20,3,0,0,30198023.1
ALEX.KHOKHLACHEV,20132014,BOS,15.233333333333333,0,0,0,0,0,0,8,17,9,2,2,1,0,1,1,7,12,7,12,0,0,0.47058823529411764,15099012.58
ALEX.KILLORN,20132014,T.B,1450.5666666666666,18,10,15,25,43,28,77,177,100,190,327,84,71,21,27,1387,1178,1124,1059,53,44,0.4350282485875706,30198142.265
ALEX.OVECHKIN,20132014,WSH,1602.5333333333333,51,17,11,28,79,68,2,3,1,385,766,204,200,24,24,1996,1318,1110,1142,33,61,0.6666666666666666,30198170.845
ALEX.PETROVIC,20132014,FLA,85.65,0,1,0,1,1,1,0,0,0,4,11,24,4,2,4,64,84,61,77,6,4,0,30198029.37
ALEX.PIETRANGELO,20132014,STL,2235.5666666666666,9,26,18,44,53,35,0,0,0,177,452,29,168,12,12,2176,1954,1593,1325,77,52,0,30198136.07
ALEX.SEMIN,20132014,CAR,1294.1333333333332,22,13,7,20,42,35,1,10,9,210,486,22,154,22,21,1624,1069,1117,907,42,35,0.1,30198109.185000002
ALEX.STEEN,20132014,STL,1531.5666666666666,34,18,12,30,64,52,279,582,303,237,501,51,146,44,26,1737,1151,1095,830,51,41,0.4793814432989691,30198124.35
ALEX.SULZER,20132014,BUF,453.1333333333333,0,1,1,2,2,1,0,0,0,21,49,11,14,1,4,334,519,291,418,8,11,0,30198068.134999998
ALEX.TANGUAY,20132014,COL,275.95,4,1,6,7,11,5,1,3,2,24,38,8,10,2,2,237,221,172,174,13,5,0.3333333333333333,30198040.46
ALEX.URBOM,20132014,WSH,292.1166666666667,1,1,0,1,2,2,0,0,0,16,34,25,9,2,4,208,329,202,258,8,7,0,30198049.72
ALEXEI.EMELIN,20132014,MTL,1471.4,3,4,10,14,17,7,0,0,0,73,173,241,60,19,26,1223,1653,1108,1322,42,43,0,30198161.39
ALEXEY.MARCHENKO,20132014,DET,13.35,0,0,0,0,0,0,0,0,0,0,0,0,0,0,1,12,14,12,12,2,0,0,15099011.55
ANDERS.LEE,20132014,NYI,345.9,9,2,3,5,14,11,1,6,5,67,98,48,10,3,8,384,248,272,228,13,10,0.16666666666666666,30198050.595
ANDRE.BENOIT,20132014,COL,1745.2833333333333,7,12,9,21,28,19,0,0,0,119,244,62,85,12,16,1524,1685,1110,1300,53,51,0,30198160.445
ANDREI.LOKTIONOV,20132014,CAR,291.9,3,6,1,7,10,9,19,54,35,34,60,10,13,3,1,305,234,230,219,13,15,0.35185185185185186,30198047.365000002
ANDREI.LOKTIONOV,20132014,N.J,591.1666666666667,4,6,2,8,12,10,135,315,180,44,96,23,23,4,6,481,369,430,322,16,12,0.42857142857142855,30198058.990000002
ANDREI.MARKOV,20132014,MTL,2486.3166666666666,8,24,20,44,52,32,0,0,0,162,346,78,114,17,18,2575,2350,1615,1696,61,57,0,30198199.67
ANDREJ.MESZAROS,20132014,BOS,334.96666666666664,2,2,3,5,7,4,0,0,0,27,51,14,19,1,4,268,311,230,271,12,8,0,30198050.185000002
ANDREJ.MESZAROS,20132014,PHI,660.1833333333334,5,6,6,12,17,11,0,0,0,62,143,54,52,7,13,632,604,517,535,27,25,0,30198075.92
ANDREJ.SEKERA,20132014,CAR,1752.2,11,14,16,30,41,25,0,0,0,142,310,54,109,9,10,1819,1686,1328,1249,59,57,0,30198142.04
ANDREJ.SUSTR,20132014,T.B,734.4,1,0,7,7,8,1,0,0,0,44,81,28,25,2,9,627,663,584,561,16,22,0,30198074.595
ANDREW.ALBERTS,20132014,VAN,73.85,0,0,0,0,0,0,0,0,0,5,13,6,6,0,0,57,68,57,65,2,2,0,30198026.95
ANDREW.CAMPBELL,20132014,L.A,38.08333333333333,0,0,0,0,0,0,0,0,0,4,7,3,2,1,0,35,38,33,38,1,1,0,15099014.31
ANDREW.COGLIANO,20132014,ANA,1455.9166666666667,23,17,8,25,48,40,12,33,21,175,304,115,60,23,17,1199,1473,1039,1134,44,46,0.36363636363636365,30198162.06
ANDREW.DESJARDINS,20132014,S.J,973.8,3,7,7,14,17,10,401,731,330,97,166,115,41,30,27,773,929,723,744,20,28,0.5485636114911081,30198115.465
ANDREW.EBBETT,20132014,PIT,99.44999999999999,0,1,0,1,1,1,15,35,20,9,17,10,4,1,0,66,103,57,88,1,5,0.42857142857142855,30198032.46
ANDREW.FERENCE,20132014,EDM,1495.3000000000002,3,4,9,13,16,7,2,3,1,77,148,135,49,16,27,1083,1763,969,1283,40,56,0.6666666666666666,30198164.715
ANDREW.LADD,20132014,WPG,1538.6166666666668,23,18,13,31,54,41,24,62,38,189,348,153,79,21,20,1666,1378,1123,992,50,43,0.3870967741935484,30198135.595
ANDREW.MACDONALD,20132014,NYI,1601.5666666666666,4,9,11,20,24,13,0,0,0,72,209,48,77,13,16,1357,1626,903,1184,40,54,0,30198150.605
ANDREW.MACDONALD,20132014,PHI,576.2166666666667,1,1,4,5,6,2,0,0,0,26,74,25,35,7,12,516,570,417,470,11,16,0,30198068.47
ANDREW.SHAW,20132014,CHI,1460.5166666666667,22,10,14,24,46,32,343,786,443,168,272,205,60,35,36,1647,1005,1160,894,64,44,0.43638676844783714,30198133.32
ANDY.GREENE,20132014,N.J,2015.4166666666667,8,8,16,24,32,16,0,0,0,133,313,87,103,11,16,1619,1488,1222,948,47,52,0,30198099.96
ANDY.MIELE,20132014,ARI,65.44999999999999,0,0,2,2,2,0,15,42,27,6,10,4,3,2,1,65,72,56,71,5,1,0.35714285714285715,30198029.47
ANTHONY.PELUSO,20132014,WPG,306.06666666666666,2,2,1,3,5,4,1,3,2,24,32,85,1,12,14,220,259,216,256,9,15,0.3333333333333333,30198053.185000002
ANTOINE.ROUSSEL,20132014,DAL,1160.6,14,9,9,18,32,23,20,50,30,118,224,164,47,43,61,1072,1227,1003,903,37,36,0.4,30198125.905
ANTOINE.VERMETTE,20132014,ARI,1575.35,24,12,8,20,44,36,1004,1781,777,160,247,90,41,19,21,1422,1508,952,1017,39,31,0.5637282425603594,30198178.1
ANTON.BELOV,20132014,EDM,951,1,2,4,6,7,3,0,0,0,54,132,103,53,6,14,850,864,669,771,29,37,0,30198097.86
ANTON.LANDER,20132014,EDM,366.8833333333333,0,1,0,1,1,1,71,160,89,18,38,29,8,8,2,260,365,210,266,4,14,0.44375,30198054.17
ANTON.STRALMAN,20132014,NYR,2098.6,1,7,10,17,18,8,0,0,0,122,253,112,95,13,16,1915,1814,1739,1449,67,56,0,30198141.03
ANTON.VOLCHENKOV,20132014,N.J,939.8666666666667,0,6,2,8,8,6,0,0,0,42,114,129,39,12,10,629,818,581,468,22,23,0,30198060.17
ANZE.KOPITAR,20132014,L.A,2264.8,34,36,25,61,95,70,1074,2018,944,246,415,153,79,33,18,2589,1731,1715,1177,76,36,0.5322101090188305,30198185.814999998
ARRON.ASHAM,20132014,NYR,44.883333333333326,0,0,0,0,0,0,0,0,0,1,2,8,1,2,4,31,48,31,48,0,5,0,30198027.17
ARTEM.ANISIMOV,20132014,CBJ,1449.1,23,11,7,18,41,34,505,1021,516,177,339,39,81,18,11,1304,1306,877,878,39,39,0.49461312438785504,30198144.955
B.J..CROMBEEN,20132014,T.B,574.7166666666667,3,2,5,7,10,5,3,8,5,60,108,59,24,18,23,425,601,409,445,10,14,0.375,30198072.625
BARRET.JACKMAN,20132014,STL,1535.75,4,4,9,13,17,8,0,1,1,90,179,110,51,19,36,1241,1352,1138,1019,53,56,0,30198117.165
BEAU.BENNETT,20132014,PIT,439.48333333333335,4,5,3,8,12,9,2,3,1,41,81,54,20,8,4,404,304,355,286,12,17,0.6666666666666666,30198049.884999998
BEN.CHIAROT,20132014,WPG,10.783333333333333,0,0,0,0,0,0,0,0,0,0,0,3,0,0,0,8,14,8,14,0,3,0,15099012.2
BEN.EAGER,20132014,EDM,50.55,0,1,0,1,1,1,1,2,1,4,11,9,4,1,1,36,45,36,45,1,0,0.5,30198026.15
BEN.HANOWSKI,20132014,CGY,79.71666666666667,0,0,2,2,2,0,1,1,0,10,13,13,3,1,1,61,73,59,72,3,5,1,30198028.75
BEN.LOVEJOY,20132014,ANA,1768.2666666666667,7,7,4,11,18,14,0,0,0,120,248,252,74,9,22,1422,1754,1263,1352,53,39,0,30198160.04
BEN.SMITH,20132014,CHI,1244.6333333333332,18,9,5,14,32,27,270,535,265,117,200,61,40,12,2,972,1082,868,886,42,35,0.5046728971962616,30198132.945
BEN.STREET,20132014,CGY,137.7,0,0,1,1,1,0,63,137,74,17,30,14,6,2,2,115,176,98,141,3,5,0.45985401459854014,30198040.215
BENN.FERRIERO,20132014,VAN,8.716666666666667,0,0,0,0,0,0,0,0,0,0,0,1,0,0,0,2,11,2,11,0,0,0,30198022.55
BENOIT.POULIOT,20132014,NYR,1467.7666666666667,20,12,14,26,46,32,28,56,28,179,295,200,41,21,34,1595,1073,1164,988,55,35,0.5,30198133.630000003
BILL.ARNOLD,20132014,CGY,13.583333333333332,0,0,0,0,0,0,5,9,4,0,1,1,0,0,0,10,12,10,12,0,1,0.5555555555555556,15099011.95
BLAIR.JONES,20132014,CGY,159.26666666666665,2,0,0,0,2,2,36,76,40,14,33,30,10,4,5,118,161,104,134,2,2,0.47368421052631576,30198038.63
BLAKE.COMEAU,20132014,CBJ,806.75,5,6,5,11,16,11,11,20,9,114,205,230,57,14,21,696,640,668,597,25,30,0.55,30198081.355
BLAKE.WHEELER,20132014,WPG,1532.4666666666667,28,27,14,41,69,55,15,40,25,225,408,150,84,29,26,1641,1336,1105,1107,50,44,0.375,30198163.740000002
BOBBY.BUTLER,20132014,FLA,27.666666666666668,0,0,1,1,1,0,0,0,0,5,9,2,4,0,0,32,12,28,10,2,1,0,15099010.025
BOBBY.RYAN,20132014,OTT,1180.8333333333333,23,15,10,25,48,38,8,13,5,190,349,104,76,11,16,1309,1055,964,932,48,38,0.6153846153846154,30198131.28
BOONE.JENNER,20132014,CBJ,1117.2,19,8,7,15,34,27,15,32,17,143,240,237,48,34,22,1106,966,911,926,34,28,0.46875,30198131.765
BOYD.GORDON,20132014,EDM,1091.85,7,7,5,12,19,14,843,1492,649,80,141,27,31,5,8,692,1251,590,804,20,34,0.5650134048257373,30198142.845
BRACKEN.KEARNS,20132014,S.J,329.81666666666666,3,2,0,2,5,5,30,71,41,37,55,45,7,2,2,309,280,276,244,7,10,0.4225352112676056,30198048.82
BRAD.BOYES,20132014,FLA,1329.4333333333334,21,5,10,15,36,26,37,69,32,175,304,46,55,6,12,1342,1089,987,943,47,55,0.5362318840579711,30198127.84
BRAD.HUNT,20132014,EDM,37.8,0,0,0,0,0,0,0,0,0,1,2,0,1,0,0,17,36,16,36,0,3,0,30198025.5
BRAD.MALONE,20132014,COL,251.7,3,0,2,2,5,3,51,107,56,20,39,86,9,5,7,158,226,155,223,5,10,0.4766355140186916,30198051.240000002
BRAD.MARCHAND,20132014,BOS,1519.3166666666666,25,22,10,32,57,47,7,27,20,177,295,90,55,29,38,1537,1224,1379,942,61,31,0.25925925925925924,30198122.07
BRAD.MILLS,20132014,CHI,30.98333333333333,0,0,0,0,0,0,7,13,6,2,6,9,2,0,0,25,30,23,20,1,2,0.5384615384615384,30198022.73
BRAD.RICHARDS,20132014,NYR,1957.4,25,25,13,38,63,50,650,1323,673,332,645,41,183,10,9,2400,1556,1489,1362,52,52,0.491307634164777,30198193.025
BRAD.RICHARDSON,20132014,VAN,1087.8,11,10,2,12,23,21,533,966,433,85,174,63,47,18,18,851,1118,788,864,32,35,0.55175983436853,30198136.15
BRAD.STUART,20132014,S.J,1305.8833333333332,3,4,3,7,10,7,0,0,0,68,177,135,73,14,16,1176,1377,1075,1056,45,39,0,30198118.415
BRANDON.BOLLIG,20132014,CHI,938.6500000000001,7,7,1,8,15,14,1,1,0,117,205,237,51,20,32,754,791,730,751,28,37,1,30198104.965000004
BRANDON.DUBINSKY,20132014,CBJ,1551.2333333333333,17,25,14,39,56,42,647,1231,584,212,379,274,84,30,35,1561,1388,1035,963,47,36,0.5255889520714866,30198159.630000003
BRANDON.GORMLEY,20132014,ARI,72.71666666666667,0,0,0,0,0,0,0,0,0,4,11,5,4,0,1,57,68,53,58,3,0,0,30198026.35
BRANDON.MASHINTER,20132014,NYR,27.433333333333334,0,0,0,0,0,0,0,0,0,3,5,5,1,2,2,28,27,27,23,0,1,0,30198023.42
BRANDON.MCMILLAN,20132014,ARI,276.8666666666667,2,1,3,4,6,3,7,14,7,35,52,50,6,8,2,238,239,232,196,9,8,0.5,30198041.134999998
BRANDON.PIRRI,20132014,CHI,343.1333333333333,6,2,1,3,9,8,106,247,141,34,76,14,19,5,3,356,284,311,277,16,10,0.4291497975708502,30198055.315
BRANDON.PIRRI,20132014,FLA,292.70000000000005,7,2,5,7,14,9,98,206,108,46,82,10,21,3,0,315,233,219,217,10,9,0.47572815533980584,30198051.075
BRANDON.PRUST,20132014,MTL,825.6500000000001,6,6,3,9,15,12,78,149,71,60,82,127,15,28,40,560,915,521,700,23,25,0.5234899328859061,30198114.025
BRANDON.SAAD,20132014,CHI,1603.45,25,29,8,37,62,54,64,165,101,194,343,72,83,28,13,1680,1145,1307,998,74,50,0.3878787878787879,30198132.189999998
BRANDON.SUTTER,20132014,PIT,1483.7333333333333,18,10,5,15,33,28,660,1352,692,172,257,82,40,19,7,1025,1494,812,1033,27,33,0.4881656804733728,30198181.615000002
BRANDON.YIP,20132014,ARI,13.75,0,0,0,0,0,0,0,0,0,1,1,6,0,0,0,11,10,11,10,1,1,0,30198021.85
BRAYDEN.MCNABB,20132014,BUF,206.73333333333332,0,0,0,0,0,0,0,0,0,10,25,25,11,6,3,164,194,136,166,4,3,0,30198037.86
BRAYDEN.SCHENN,20132014,PHI,1390.7833333333333,20,14,9,23,43,34,314,725,411,186,328,221,76,22,21,1375,1227,1037,1128,42,44,0.43310344827586206,30198173.105
BRAYDON.COBURN,20132014,PHI,1988.7,5,7,8,15,20,12,0,0,0,131,294,117,100,11,28,1610,2035,1413,1356,54,73,0,30198149.46
BRENDAN.GALLAGHER,20132014,MTL,1575.4333333333332,23,11,18,29,52,34,52,137,85,249,461,47,124,39,33,1767,1330,1311,1224,56,50,0.3795620437956204,30198157.07
BRENDAN.SMITH,20132014,DET,1403.65,5,7,6,13,18,12,0,0,0,97,207,67,58,24,34,1206,1124,1125,956,50,47,0,30198109.939999998
BRENDEN.DILLON,20132014,DAL,1723.9,6,5,5,10,16,11,0,0,0,100,209,173,68,23,35,1510,1791,1370,1323,60,53,0,30198149.555
BRENDEN.MORROW,20132014,STL,870.25,13,8,4,12,25,21,9,30,21,57,87,116,14,22,32,733,694,627,661,29,25,0.3,30198104.98
BRENT.BURNS,20132014,S.J,1282.8333333333333,24,10,16,26,50,34,61,133,72,278,502,175,104,19,22,1655,1027,1199,914,56,37,0.45864661654135336,30198118.03
BRENT.SEABROOK,20132014,CHI,2199.5666666666666,10,18,24,42,52,28,0,0,0,173,377,211,121,11,19,2238,1879,1771,1438,88,71,0,30198147.11
BRETT.BELLEMORE,20132014,CAR,1118.2166666666667,2,2,3,5,7,4,0,0,0,54,105,169,35,12,18,922,1128,861,917,26,27,0,30198114.595
BRETT.BULMER,20132014,MIN,53.449999999999996,0,0,0,0,0,0,0,0,0,7,12,14,2,3,1,41,43,41,43,0,2,0,30198025.630000003
BRETT.CONNOLLY,20132014,T.B,132.2,1,0,0,0,1,1,25,52,27,12,18,9,1,2,2,116,105,99,101,3,7,0.4807692307692308,30198033.32
BRETT.GALLANT,20132014,NYI,27.53333333333333,0,0,0,0,0,0,0,0,0,3,6,9,1,3,3,27,25,27,24,0,0,0,30198023.73
BRETT.SUTTER,20132014,CAR,128.53333333333333,1,1,0,1,2,2,37,73,36,16,25,34,2,6,3,104,131,101,115,3,7,0.5068493150684932,30198036.439999998
BRIAN.BOYLE,20132014,NYR,1378.6,9,10,5,15,24,19,381,731,350,167,264,223,46,19,27,993,1506,883,1008,25,34,0.521203830369357,30198155.855
BRIAN.CAMPBELL,20132014,FLA,2209.0666666666666,7,16,12,28,35,23,0,1,1,116,279,50,99,10,10,2098,1737,1451,1306,55,63,0,30198143.299999997
BRIAN.DUMOULIN,20132014,PIT,115.4,0,1,0,1,1,1,0,0,0,3,11,1,3,1,2,86,94,58,77,4,3,0,30198029.61
BRIAN.FLYNN,20132014,BUF,1139.1,6,5,2,7,13,11,184,389,205,102,154,51,30,10,7,732,1291,661,926,18,31,0.4730077120822622,30198141.41
BRIAN.GIBBONS,20132014,PIT,574.6333333333333,7,8,5,13,20,15,9,24,15,40,71,27,17,16,4,479,491,436,407,22,14,0.375,30198067.495
BRIAN.GIONTA,20132014,MTL,1748.5333333333333,19,21,7,28,47,40,27,67,40,224,405,57,84,22,11,1503,1818,1177,1407,42,43,0.40298507462686567,30198194.475
BRIAN.LASHOFF,20132014,DET,1152.35,1,2,3,5,6,3,0,0,0,41,104,66,37,11,19,847,1124,795,788,33,36,0,30198095.985
BRIAN.MCGRATTAN,20132014,CGY,510.5,4,3,0,3,7,7,2,3,1,78,125,82,23,21,19,366,598,362,586,14,18,0.6666666666666666,30198096.689999998
BRIAN.STRAIT,20132014,NYI,843.8499999999999,3,2,3,5,8,5,0,0,0,40,79,65,24,10,7,606,915,543,680,22,38,0,30198095.525
BROCK.NELSON,20132014,NYI,1026.8833333333334,14,4,7,11,25,18,191,451,260,131,260,74,73,16,6,1048,840,765,673,27,37,0.42350332594235035,30198099.924999997
BROOKS.LAICH,20132014,WSH,879.8333333333333,8,5,1,6,14,13,203,460,257,75,129,62,35,5,8,719,947,539,586,20,24,0.44130434782608696,30198097.945
BROOKS.ORPIK,20132014,PIT,1625.8166666666666,3,3,9,12,15,6,0,0,0,58,141,232,54,10,15,1157,1692,1075,1215,55,57,0,30198142.825000003
BRYAN.ALLEN,20132014,ANA,1431.95,1,0,10,10,11,1,0,0,0,69,172,156,56,11,39,1177,1562,1076,1135,54,43,0,30198131.810000002
BRYAN.BICKELL,20132014,CHI,978.8833333333334,18,6,1,7,25,24,3,6,3,137,264,185,75,9,16,1008,703,896,678,34,39,0.5,30198086.985
BRYAN.LITTLE,20132014,WPG,1640.3000000000002,23,24,16,40,63,47,785,1652,867,170,291,84,63,21,19,1757,1484,1195,1053,55,50,0.475181598062954,30198179.06
BRYCE.SALVADOR,20132014,N.J,811.75,1,3,0,3,4,4,0,0,0,24,71,47,33,8,13,535,767,495,487,20,22,0,30198066.93
BRYCE.VAN BRABANT,20132014,CGY,54.95,0,0,0,0,0,0,0,0,0,4,8,17,1,1,1,37,66,37,65,1,2,0,30198028.96
CAL.CLUTTERBUCK,20132014,NYI,1046.2,12,3,3,6,18,15,7,16,9,171,285,270,58,29,20,964,1043,724,761,17,32,0.4375,30198110.195
CALLE.JARNKROK,20132014,NSH,168.81666666666666,2,3,4,7,9,5,58,147,89,13,22,2,6,1,3,143,116,115,108,11,4,0.3945578231292517,30198037.23
CALVIN.DE HAAN,20132014,NYI,1072.2333333333333,3,7,6,13,16,10,0,0,0,71,153,114,57,9,13,1014,970,820,752,32,35,0,30198091.439999998
CAM.ATKINSON,20132014,CBJ,1347.85,22,14,6,20,42,36,0,0,0,229,376,65,74,11,9,1422,1060,1004,965,39,35,0,30198135.060000002
CAM.FOWLER,20132014,ANA,1980.65,6,13,17,30,36,19,0,0,0,120,262,59,93,4,9,1895,1868,1199,1261,55,42,0,30198148.015
CAM.JANSSEN,20132014,N.J,117.85,3,0,0,0,3,3,0,0,0,11,15,32,2,2,4,80,77,80,76,5,2,0,30198030.62
CAMERON.GAUNCE,20132014,DAL,124.53333333333333,0,0,0,0,0,0,0,0,0,9,15,11,4,2,2,139,126,135,111,8,6,0,30198029.869999997
CAMERON.SCHILLING,20132014,WSH,17.75,0,0,0,0,0,0,0,0,0,2,3,2,1,0,0,13,27,13,26,0,1,0,15099013.7
CARL.GUNNARSSON,20132014,TOR,1552.7833333333333,3,5,6,11,14,8,0,0,0,48,102,166,34,8,17,1052,1934,941,1401,51,45,0,30198181.68
CARL.HAGELIN,20132014,NYR,1517.5833333333333,24,10,10,20,44,34,1,7,6,200,338,85,74,24,30,1378,1543,1257,1195,50,47,0.14285714285714285,30198156.880000003
CARL.KLINGBERG,20132014,WPG,26.616666666666667,1,0,0,0,1,1,0,0,0,3,6,2,2,0,0,21,27,21,25,2,0,0,30198023.950000003
CARL.SODERBERG,20132014,BOS,1229.1,17,26,11,37,54,43,211,477,266,154,284,66,70,16,19,1226,878,947,821,45,34,0.44234800838574423,30198128.475
CARLO.COLAIACOVO,20132014,STL,378.81666666666666,1,3,0,3,4,4,0,0,0,18,52,29,24,3,9,350,296,299,280,8,10,0,30198047.88
CARSON.MCMILLAN,20132014,MIN,8.1,0,0,0,0,0,0,0,0,0,0,1,0,0,0,0,4,9,4,7,0,0,0,15099011.35
CARTER.ASHTON,20132014,TOR,200.75,0,2,1,3,3,2,12,23,11,23,38,46,8,8,5,155,197,153,193,5,4,0.5217391304347826,30198043.935000002
CASEY.CIZIKAS,20132014,NYI,1069.8833333333332,6,6,3,9,15,12,488,1009,521,79,141,128,27,17,15,744,1166,645,781,14,29,0.4836471754212091,30198135.015
CASEY.WELLMAN,20132014,WSH,121.86666666666666,2,0,1,1,3,2,50,97,47,15,25,9,4,1,1,99,111,98,109,5,2,0.5154639175257731,30198035.335
CEDRIC.PAQUETTE,20132014,T.B,71.31666666666666,0,1,2,3,3,1,32,64,32,4,9,13,3,3,4,52,63,52,55,3,4,0.5,30198028.560000002
CHAD.BILLINS,20132014,CGY,122.08333333333333,0,0,2,2,2,0,0,0,0,3,16,0,8,0,0,99,111,87,109,4,7,0,30198031.5
CHAD.RUHWEDEL,20132014,BUF,375.45000000000005,0,1,0,1,1,1,0,0,0,35,66,20,22,1,1,312,375,265,326,5,8,0,30198055.06
CHARLIE.COYLE,20132014,MIN,1428.2166666666667,15,11,10,21,36,26,200,476,276,158,250,139,42,23,18,1291,1120,975,990,40,47,0.42016806722689076,30198148.38
CHRIS.BREEN,20132014,CGY,84.46666666666667,0,1,1,2,2,1,0,0,0,4,10,3,3,1,1,85,104,83,102,6,5,0,30198031.785
CHRIS.BROWN,20132014,ARI,46,0,0,0,0,0,0,0,2,2,4,5,10,1,2,3,38,32,37,32,0,0,0,30198024.57
CHRIS.BROWN,20132014,WSH,58.233333333333334,1,1,0,1,2,2,15,38,23,4,13,12,6,0,0,39,61,39,61,2,2,0.39473684210526316,30198029.450000003
CHRIS.BUTLER,20132014,CGY,1661.8,2,9,3,12,14,11,0,0,0,83,191,68,69,11,13,1218,1875,1090,1463,36,60,0,30198182.985
CHRIS.CONNER,20132014,PIT,223.58333333333331,4,0,1,1,5,4,0,1,1,17,31,21,7,2,1,151,244,135,237,7,10,0,30198051.645000003
CHRIS.HIGGINS,20132014,VAN,1495.6333333333332,17,16,6,22,39,33,17,38,21,216,347,98,65,10,14,1426,1430,1116,1089,43,47,0.4473684210526316,30198147.38
CHRIS.KELLY,20132014,BOS,837.55,9,6,2,8,17,15,283,579,296,69,122,72,29,14,14,665,769,603,567,28,25,0.48877374784110533,30198094.759999998
CHRIS.KREIDER,20132014,NYR,1290.2833333333333,22,17,11,28,50,39,8,21,13,164,273,196,37,15,33,1501,1017,1096,931,49,35,0.38095238095238093,30198132.395
CHRIS.KUNITZ,20132014,PIT,1741.5,38,19,19,38,76,57,4,5,1,258,416,197,79,25,40,2099,1335,1335,1171,72,49,0.8,30198164.884999998
CHRIS.MUELLER,20132014,DAL,109.11666666666666,0,0,0,0,0,0,43,80,37,10,19,15,8,1,1,95,97,92,95,0,4,0.5375,30198031.53
CHRIS.NEIL,20132014,OTT,897.0166666666667,8,4,2,6,14,12,1,3,2,99,174,253,40,32,58,886,816,800,773,23,29,0.3333333333333333,30198109.51
CHRIS.PHILLIPS,20132014,OTT,1345.0333333333333,1,6,7,13,14,7,0,0,0,90,173,140,54,5,15,1257,1348,980,911,36,50,0,30198106.475
CHRIS.PORTER,20132014,STL,301.6166666666667,1,0,3,3,4,1,4,13,9,39,61,87,4,1,0,237,275,230,261,7,8,0.3076923076923077,30198050.295
CHRIS.STEWART,20132014,BUF,68,0,0,0,0,0,0,4,10,6,3,11,4,2,1,3,62,75,46,72,2,4,0.4,30198029.77
CHRIS.STEWART,20132014,STL,794.3166666666666,15,9,2,11,26,24,8,25,17,107,179,76,30,13,27,773,662,573,612,29,26,0.32,30198101.200000003
CHRIS.SUMMERS,20132014,ARI,268.6,2,0,1,1,3,2,0,0,0,17,26,33,5,1,6,176,299,170,221,6,6,0,30198047.235
CHRIS.TANEV,20132014,VAN,1327.15,6,2,9,11,17,8,0,0,0,65,130,25,41,7,6,1055,1280,950,911,44,34,0,30198107.595
CHRIS.TERRY,20132014,CAR,120.65,0,1,1,2,2,1,0,0,0,13,30,9,9,0,0,106,88,81,84,1,5,0,30198029.325
CHRIS.THORBURN,20132014,WPG,492.3666666666667,2,4,5,9,11,6,20,33,13,26,50,108,9,8,18,357,478,352,464,18,18,0.6060606060606061,30198077.455
CHRIS.VANDEVELDE,20132014,PHI,139.11666666666667,0,0,1,1,1,0,16,40,24,8,17,24,5,2,3,81,121,73,87,2,5,0.4,30198031.335
CHRISTIAN.EHRHOFF,20132014,BUF,1889.05,6,9,17,26,32,15,0,0,0,161,334,49,98,16,19,1664,1833,1102,1303,41,60,0,30198161.985
CHRISTIAN.FOLIN,20132014,MIN,19.433333333333334,0,1,0,1,1,1,0,0,0,0,0,1,0,0,0,8,15,4,12,2,0,0,15099012.35
CHRISTIAN.THOMAS,20132014,MTL,14.366666666666667,0,0,0,0,0,0,0,0,0,1,3,1,2,0,0,9,23,9,23,0,1,0,15099013.25
CHUCK.KOBASEW,20132014,PIT,369.95000000000005,2,0,0,0,2,2,1,2,1,37,66,48,13,5,6,276,332,240,290,6,5,0.5,30198053.89
CLARKE.MACARTHUR,20132014,OTT,1391.4333333333334,23,22,9,31,54,45,15,32,17,158,265,108,53,15,29,1549,1239,1083,920,51,36,0.46875,30198131.225
CLAUDE.GIROUX,20132014,PHI,1811.4,30,26,36,62,92,56,1013,1906,893,239,472,102,136,41,23,2218,1480,1345,1184,59,49,0.531479538300105,30198190.43
CLAYTON.STONER,20132014,MIN,999.2166666666667,2,3,3,6,8,5,0,0,0,61,123,135,42,21,39,734,898,697,757,26,30,0,30198101.884999998
CODY.BASS,20132014,CBJ,2.716666666666667,0,0,0,0,0,0,0,0,0,0,0,0,0,1,1,1,3,1,3,0,0,0,15099011.06
CODY.CECI,20132014,OTT,842.1166666666666,3,4,2,6,9,7,0,0,0,82,166,45,55,4,7,827,822,659,629,27,30,0,30198079.740000002
CODY.EAKIN,20132014,DAL,1515.0666666666666,18,12,10,22,40,30,641,1343,702,174,339,100,89,26,18,1521,1410,1063,1015,36,48,0.47728965003723006,30198161.65
CODY.FRANSON,20132014,TOR,1634.2666666666667,5,14,13,27,32,19,0,0,0,115,271,282,97,10,15,1543,1638,1039,1273,45,56,0,30198158.975
CODY.GOLOUBEF,20132014,CBJ,49.11666666666667,0,0,0,0,0,0,0,0,0,4,5,3,1,0,1,38,41,37,41,0,0,0,30198025.5
CODY.HODGSON,20132014,BUF,1306.2833333333333,20,18,5,23,43,38,453,968,515,182,321,47,88,13,10,1271,1265,811,1098,26,44,0.46797520661157027,30198184.275
CODY.KUNYK,20132014,T.B,10.2,0,0,0,0,0,0,1,5,4,2,3,1,1,0,0,11,10,11,10,0,0,0.2,15099011.59
CODY.MCCORMICK,20132014,BUF,246.18333333333334,1,3,1,4,5,4,67,153,86,20,34,60,8,10,12,130,281,123,205,5,13,0.43790849673202614,30198052.605
CODY.MCCORMICK,20132014,MIN,244.43333333333334,2,1,0,1,3,3,23,54,31,12,24,50,7,7,3,143,222,135,169,6,3,0.42592592592592593,30198042.04
CODY.MCLEOD,20132014,COL,809.1166666666667,6,4,4,8,14,10,2,10,8,87,125,167,23,23,30,489,886,469,680,17,17,0.2,30198109.71
COLBY.ROBAK,20132014,FLA,297.1666666666667,0,1,1,2,2,1,0,0,0,15,26,17,8,3,3,236,290,210,211,5,10,0,30198042.055
COLIN.FRASER,20132014,L.A,296.6166666666667,0,2,0,2,2,2,87,172,85,22,41,58,8,14,12,241,245,236,217,2,6,0.5058139534883721,30198047.77
COLIN.GREENING,20132014,OTT,1043.8666666666668,6,7,4,11,17,13,22,59,37,108,183,225,35,18,16,962,1002,861,828,24,38,0.3728813559322034,30198111.259999998
COLIN.MCDONALD,20132014,NYI,867.1666666666666,8,6,4,10,18,14,7,15,8,96,161,217,29,24,14,729,808,677,754,25,45,0.4666666666666667,30198108.82
COLIN.WILSON,20132014,NSH,1232.5,11,14,8,22,33,25,166,343,177,112,200,49,41,14,11,1171,1074,936,1000,37,41,0.4839650145772595,30198143.08
COLTON.ORR,20132014,TOR,290.4666666666667,0,0,0,0,0,0,1,2,1,12,26,112,4,12,22,179,276,177,273,6,9,0.5,30198055.66
COLTON.SCEVIOUR,20132014,DAL,477.04999999999995,9,2,3,5,14,11,22,52,30,81,121,30,18,4,2,479,409,364,358,18,18,0.4230769230769231,30198064.395
COLTON.SISSONS,20132014,NSH,180.5,1,2,1,3,4,3,70,144,74,13,21,9,2,0,2,122,137,119,125,6,6,0.4861111111111111,30198038.424999997
CONNOR.CARRICK,20132014,WSH,543.0666666666666,1,0,5,5,6,1,0,0,0,26,71,25,29,5,9,418,599,390,494,14,22,0,30198072.925
CONNOR.MURPHY,20132014,ARI,539.4166666666666,1,3,4,7,8,4,0,0,0,30,69,44,29,6,5,465,532,429,410,21,17,0,30198058.51
CONOR.ALLEN,20132014,NYR,43.31666666666666,0,0,0,0,0,0,0,0,0,2,7,1,4,2,0,26,29,26,27,0,1,0,15099012.77
CORBAN.KNIGHT,20132014,CGY,55.55,1,0,0,0,1,1,24,51,27,4,5,9,0,0,0,45,56,42,55,3,4,0.47058823529411764,30198028.71
COREY.PERRY,20132014,ANA,1833.9166666666667,47,32,14,46,93,79,9,28,19,317,567,113,106,54,38,2085,1458,1288,1182,81,49,0.32142857142857145,30198180.35
COREY.POTTER,20132014,BOS,58.18333333333334,0,0,0,0,0,0,0,0,0,2,6,4,2,1,0,48,47,46,44,0,1,0,30198025.11
COREY.POTTER,20132014,EDM,220.43333333333334,0,3,2,5,5,3,0,0,0,16,23,16,6,4,5,151,228,125,191,10,10,0,30198044.39
COREY.TROPP,20132014,BUF,94.4,0,1,0,1,1,1,0,0,0,7,9,19,1,3,0,62,99,55,93,1,9,0,30198032.83
COREY.TROPP,20132014,CBJ,391.8333333333333,2,3,5,8,10,5,0,1,1,29,47,94,13,11,14,326,345,314,342,20,9,0,30198058.785
CORY.CONACHER,20132014,BUF,284.18333333333334,3,2,1,3,6,5,1,1,0,28,49,10,13,9,8,252,274,177,267,6,12,1,30198055.305
CORY.CONACHER,20132014,OTT,738.05,4,8,8,16,20,12,8,13,5,73,120,41,20,27,17,761,598,629,555,32,23,0.6153846153846154,30198079.439999998
CORY.EMMERTON,20132014,DET,161.15,0,1,1,2,2,1,58,107,49,22,28,7,4,2,2,114,142,106,105,2,4,0.5420560747663551,30198034.465
CORY.SARICH,20132014,COL,922.7833333333333,1,1,7,8,9,2,0,1,1,48,111,107,40,4,16,726,932,670,736,34,28,0,30198093.465
CRAIG.ADAMS,20132014,PIT,1160.9333333333334,6,6,1,7,13,12,62,148,86,83,141,225,29,12,15,591,1321,550,761,14,32,0.4189189189189189,30198118.975
CRAIG.CUNNINGHAM,20132014,BOS,18.96666666666667,0,0,0,0,0,0,3,7,4,4,4,1,0,0,0,17,16,16,14,0,0,0.42857142857142855,30198022.67
CRAIG.SMITH,20132014,NSH,1293.5833333333335,24,15,12,27,51,39,3,19,16,215,386,54,81,17,11,1263,1035,968,948,51,38,0.15789473684210525,30198134.29
CURTIS.GLENCROSS,20132014,CGY,669.4333333333334,12,5,7,12,24,17,14,41,27,77,148,59,36,5,6,615,624,418,557,18,29,0.34146341463414637,30198093.235
DAINIUS.ZUBRUS,20132014,N.J,1439.5,13,5,8,13,26,18,216,424,208,120,187,107,32,13,23,1059,1137,965,816,40,40,0.5094339622641509,30198114.619999997
DALE.WEISE,20132014,MTL,335.66666666666663,6,3,2,5,11,9,0,1,1,30,49,77,9,8,5,230,337,221,295,12,4,0,30198059.43
DALE.WEISE,20132014,VAN,341.55,3,5,4,9,12,8,0,4,4,29,43,65,5,10,11,272,341,263,333,13,14,0,30198063.65
DALTON.PROUT,20132014,CBJ,869.4166666666667,2,1,3,4,6,3,0,1,1,57,114,105,40,10,12,693,805,655,661,22,30,0,30198085.075000003
DAMIEN.BRUNNER,20132014,N.J,812.05,11,12,2,14,25,23,1,8,7,110,196,15,44,10,13,740,555,564,503,21,26,0.125,30198080.840000004
DAN.BOYLE,20132014,S.J,1749.25,12,13,13,26,38,25,0,0,0,171,348,54,118,14,18,2157,1425,1409,1240,43,46,0,30198140.314999998
DAN.CARCILLO,20132014,L.A,256.68333333333334,1,0,1,1,2,1,1,1,0,22,49,53,14,15,17,250,214,243,210,6,6,1,30198041.915
DAN.CARCILLO,20132014,NYR,342.4666666666667,5,0,0,0,5,5,0,0,0,33,69,76,21,17,20,307,329,302,324,12,11,0,30198057.869999997
DAN.CLEARY,20132014,DET,722.75,4,3,1,4,8,7,12,22,10,64,99,51,20,9,13,579,671,444,495,11,23,0.5454545454545454,30198078.545
DAN.GIRARDI,20132014,NYR,2478.783333333333,6,11,14,25,31,17,0,0,0,119,307,271,129,12,13,2221,2579,1719,1829,71,71,0,30198198.72
DAN.HAMHUIS,20132014,VAN,1892.6000000000001,5,13,4,17,22,18,0,0,0,149,307,87,100,21,13,1690,1697,1302,1228,62,47,0,30198136.36
DANA.TYRELL,20132014,T.B,64.64999999999999,0,0,0,0,0,0,2,6,4,4,4,10,0,0,2,29,68,26,56,0,1,0.3333333333333333,30198028.78
DANIEL.ALFREDSSON,20132014,DET,1198.5,18,16,15,31,49,34,5,14,9,153,277,60,73,13,6,1218,805,751,714,32,29,0.35714285714285715,30198106.405
DANIEL.BRIERE,20132014,MTL,1042.45,16,12,4,16,32,28,224,461,237,138,220,31,45,17,16,1008,946,775,889,34,34,0.48590021691973967,30198140.93
DANIEL.PAILLE,20132014,BOS,869.9333333333334,10,6,3,9,19,16,11,17,6,76,127,82,27,15,4,624,835,589,632,23,16,0.6470588235294118,30198094.115000002
DANIEL.SEDIN,20132014,VAN,1504.2,16,20,11,31,47,36,8,27,19,223,369,37,71,26,14,1747,1042,1103,837,43,33,0.2962962962962963,30198111.705
DANIEL.WINNIK,20132014,ANA,1292.0833333333335,6,19,4,23,29,25,91,205,114,126,220,72,44,15,11,956,1480,872,983,38,34,0.44390243902439025,30198140.39
DANNY.DEKEYSER,20132014,DET,1522.55,4,6,11,17,21,10,0,0,0,89,186,71,59,14,18,1206,1344,938,967,35,31,0,30198119.265
DANY.HEATLEY,20132014,MIN,1253.1833333333334,13,13,8,21,34,26,7,19,12,119,223,45,54,14,12,1117,1018,785,932,34,39,0.3684210526315789,30198133.62
DARREN.ARCHIBALD,20132014,VAN,124.75,1,1,1,2,3,2,0,1,1,11,20,30,5,4,0,104,119,104,115,6,5,0,30198033.365000002
DARREN.HELM,20132014,DET,713.15,12,5,4,9,21,17,296,600,304,97,175,83,46,21,7,572,617,489,448,22,23,0.49333333333333335,30198083.35
DARROLL.POWE,20132014,NYR,8.55,0,0,0,0,0,0,1,1,0,0,1,1,0,0,0,6,6,6,6,0,2,1,15099011.09
DAVE.BOLLAND,20132014,TOR,332.7166666666667,8,3,1,4,12,11,152,337,185,34,56,38,10,1,12,277,345,222,280,8,12,0.45103857566765576,30198067.765
DAVID.BACKES,20132014,STL,1540.3,27,16,14,30,57,43,663,1288,625,173,290,297,47,28,44,1592,1214,1089,887,51,38,0.514751552795031,30198153.8
DAVID.BOOTH,20132014,VAN,889.2666666666667,9,6,4,10,19,15,13,23,10,117,228,121,56,16,9,866,788,806,747,26,24,0.5652173913043478,30198098.08
DAVID.BROLL,20132014,TOR,40.916666666666664,0,0,1,1,1,0,0,0,0,3,7,7,3,1,1,36,48,36,48,2,1,0,30198026.035
DAVID.CLARKSON,20132014,TOR,906.1,5,5,1,6,11,10,8,21,13,101,177,159,43,19,29,786,951,666,907,19,31,0.38095238095238093,30198130.935000002
DAVID.DESHARNAIS,20132014,MTL,1676.2833333333333,18,26,16,42,60,44,780,1535,755,122,205,34,46,13,16,1806,1382,1264,1248,58,38,0.50814332247557,30198196.08
DAVID.JONES,20132014,CGY,742.0666666666666,9,6,2,8,17,15,38,73,35,104,168,102,30,5,5,691,671,529,640,21,20,0.5205479452054794,30198100.02
DAVID.KREJCI,20132014,BOS,1780.0333333333333,19,25,27,52,71,44,721,1400,679,194,327,88,65,27,16,1999,1560,1423,1305,63,37,0.515,30198194.585
DAVID.LEGWAND,20132014,DET,411.6166666666667,4,6,1,7,11,10,136,281,145,43,67,27,11,2,11,389,326,279,294,10,18,0.48398576512455516,30198063.885
DAVID.LEGWAND,20132014,NSH,1067.4166666666667,10,17,13,30,40,27,454,888,434,107,161,29,21,7,15,1110,855,759,766,32,41,0.5112612612612613,30198132.155
DAVID.MOSS,20132014,ARI,1157.5500000000002,8,6,8,14,22,14,21,51,30,151,268,120,57,17,8,1020,1199,917,834,34,32,0.4117647058823529,30198106.31
DAVID.PERRON,20132014,EDM,1490.45,28,20,9,29,57,48,13,39,26,220,383,116,94,40,42,1410,1318,965,1150,48,55,0.3333333333333333,30198174.095
DAVID.RUNDBLAD,20132014,ARI,191.96666666666667,0,0,1,1,1,0,0,0,0,17,43,12,19,1,3,235,165,189,156,2,3,0,30198033.185
DAVID.RUNDBLAD,20132014,CHI,41.68333333333334,0,0,0,0,0,0,0,0,0,4,8,6,1,0,0,45,30,45,30,3,4,0,30198022.85
DAVID.SAVARD,20132014,CBJ,1388,5,6,7,13,18,11,1,1,0,71,151,159,56,6,16,1133,1339,974,1086,42,36,1,30198133.825000003
DAVID.SCHLEMKO,20132014,ARI,787.0666666666666,1,4,4,8,9,5,0,0,0,61,123,61,43,3,9,750,761,640,550,25,21,0,30198068.93
DAVID.STECKEL,20132014,ANA,65.03333333333333,0,0,0,0,0,0,44,68,24,8,11,15,2,0,0,65,48,61,35,0,0,0.6470588235294118,30198024.060000002
DAVID.VAN DER GULIK,20132014,COL,11.35,0,0,0,0,0,0,1,2,1,3,5,1,0,0,0,10,8,10,8,0,0,0.5,15099011.39
DAVID.WARSOFSKY,20132014,BOS,97.01666666666667,1,1,0,1,2,2,0,0,0,10,18,0,5,0,0,97,69,74,63,6,4,0,30198026.85
DENIS.GREBESHKOV,20132014,EDM,95.83333333333334,0,0,1,1,1,0,0,0,0,3,5,3,2,0,1,88,77,78,71,4,4,0,30198027.225
DENNIS.SEIDENBERG,20132014,BOS,742.4833333333333,1,5,4,9,10,6,0,0,0,53,115,61,42,2,6,651,747,584,589,28,22,0,30198076.97
DENNIS.WIDEMAN,20132014,CGY,1043.9,4,5,11,16,20,9,0,0,0,102,227,62,68,8,9,974,1013,699,816,31,41,0,30198106.505
DEREK.DORSETT,20132014,NYR,779.8666666666667,4,4,1,5,9,8,1,4,3,86,150,158,34,39,39,647,698,624,625,14,17,0.25,30198092.105
DEREK.GRANT,20132014,OTT,191.23333333333332,0,2,0,2,2,2,79,150,71,31,51,32,9,3,2,161,201,145,123,4,8,0.5266666666666666,30198035.990000002
DEREK.MACKENZIE,20132014,CBJ,882.75,10,5,3,8,18,15,275,530,255,76,145,269,36,18,17,625,874,577,602,20,26,0.5188679245283019,30198100.555
DEREK.MORRIS,20132014,ARI,1225.1333333333332,5,5,6,11,16,10,0,0,0,82,200,99,64,6,19,1108,1221,963,946,37,41,0,30198113.31
DEREK.ROY,20132014,STL,1070.1333333333332,9,17,12,29,38,26,228,493,265,122,224,18,49,13,15,1110,786,749,700,30,31,0.46247464503042596,30198112.700000003
DEREK.SMITH,20132014,CGY,133.43333333333334,0,0,0,0,0,0,2,3,1,12,27,6,7,1,1,109,119,109,117,2,12,0.6666666666666666,30198032.54
DEREK.STEPAN,20132014,NYR,1955.3166666666666,22,28,22,50,72,50,895,2019,1124,249,459,50,95,20,10,2178,1672,1423,1283,54,39,0.4432887568103021,30198213.8
DERICK.BRASSARD,20132014,NYR,1642.0666666666666,24,17,16,33,57,41,626,1308,682,204,352,156,83,32,21,1806,1227,1218,1082,53,46,0.4785932721712538,30198170.86
DERYK.ENGELLAND,20132014,PIT,730.4833333333333,6,0,6,6,12,6,0,0,0,59,89,117,19,12,16,526,757,507,644,22,27,0,30198096.22
DEVANTE.SMITH-PELLY,20132014,ANA,416.55,7,3,5,8,15,10,1,5,4,49,86,103,9,9,8,376,412,287,371,15,10,0.2,30198069.555
DEVIN.SETOGUCHI,20132014,WPG,1128.1666666666665,11,10,6,16,27,21,5,20,15,129,221,142,55,15,13,1127,992,894,933,27,36,0.25,30198126.85
DION.PHANEUF,20132014,TOR,1885.15,8,11,11,22,30,19,0,1,1,145,324,226,107,22,47,1647,2145,1041,1506,55,50,0,30198197.595
DMITRIJ.JASKIN,20132014,STL,191.21666666666667,1,1,0,1,2,2,1,2,1,18,36,40,12,3,4,160,140,148,134,3,5,0.5,30198034.27
DMITRY.KOROBOV,20132014,T.B,32.06666666666666,0,0,0,0,0,0,0,0,0,0,0,5,0,0,1,24,31,24,31,0,0,0,30198024.6
DMITRY.KULIKOV,20132014,FLA,1757.1999999999998,8,4,6,10,18,12,0,0,0,127,254,125,69,15,25,1543,1531,1194,1140,47,72,0,30198133.4
DMITRY.ORLOV,20132014,WSH,1058.2833333333333,3,3,5,8,11,6,0,0,0,59,129,75,42,13,8,954,897,853,818,33,36,0,30198098.205
DOMINIC.MOORE,20132014,NYR,1191.8333333333335,9,12,5,17,26,21,529,969,440,124,195,86,30,23,20,904,1240,829,916,26,33,0.5459236326109391,30198147.965
DOUGIE.HAMILTON,20132014,BOS,1451.8833333333332,9,9,12,21,30,18,0,0,0,136,288,89,84,6,27,1476,1068,1183,928,47,25,0,30198104.46
DOUGLAS.MURRAY,20132014,MTL,796.9833333333333,0,0,2,2,2,0,0,0,0,26,71,158,30,5,10,537,991,493,727,13,27,0,30198101.95
DRAYSON.BOWMAN,20132014,CAR,724.9333333333333,4,3,5,8,12,7,6,10,4,80,150,45,39,8,9,621,717,559,659,21,22,0.6,30198093.295
DREW.DOUGHTY,20132014,L.A,2753.45,15,27,11,38,53,42,0,0,0,237,543,223,184,26,48,2909,2193,1998,1500,75,58,0,30198152.735
DREW.MILLER,20132014,DET,1232.1,7,6,3,9,16,13,10,25,15,118,185,139,29,12,8,772,1235,720,762,26,36,0.4,30198107.345
DREW.SHORE,20132014,FLA,287.8666666666667,5,0,2,2,7,5,86,208,122,23,40,23,12,2,3,228,266,196,185,6,7,0.41346153846153844,30198046.759999998
DREW.STAFFORD,20132014,BUF,1304.9,16,13,5,18,34,29,106,197,91,185,306,78,67,18,15,1123,1333,785,1048,34,44,0.5380710659898477,30198157.695
DUNCAN.KEITH,20132014,CHI,2475.883333333333,9,23,35,58,67,32,0,0,0,224,509,50,189,10,18,2595,2146,1866,1536,94,68,0,30198151.225
DUSTIN.BROWN,20132014,L.A,1691.9499999999998,21,12,8,20,41,33,9,28,19,259,484,370,123,49,33,1872,1326,1392,1095,50,36,0.32142857142857145,30198130.85
DUSTIN.BYFUGLIEN,20132014,WPG,1800.7,20,17,19,36,56,37,0,2,2,256,489,213,124,22,37,1932,1587,1257,1229,50,72,0,30198159.845
DUSTIN.JEFFREY,20132014,DAL,217.16666666666669,2,0,1,1,3,2,47,102,55,21,45,2,12,3,0,190,192,181,187,5,6,0.46078431372549017,30198042.285
DUSTIN.JEFFREY,20132014,PIT,108.25,0,0,1,1,1,0,8,13,5,9,14,4,2,0,1,91,81,74,72,2,4,0.6153846153846154,30198028.345
DUSTIN.PENNER,20132014,ANA,747.9666666666667,13,9,10,19,32,22,12,41,29,100,163,77,25,6,11,744,560,533,527,41,17,0.2926829268292683,30198086.34
DUSTIN.PENNER,20132014,WSH,221.43333333333334,1,2,0,2,3,3,3,6,3,19,32,15,9,3,1,178,181,159,178,4,0,0.5,30198040.85
DWIGHT.KING,20132014,L.A,1546.7,18,9,14,23,41,27,4,9,5,143,240,177,43,13,14,1550,1299,1423,1042,60,46,0.4444444444444444,30198118.89
DYLAN.MCILRATH,20132014,NYR,14.05,0,0,0,0,0,0,0,0,0,0,2,2,2,2,2,20,12,20,12,0,1,0,15099011.32
DYLAN.OLSEN,20132014,FLA,679.2166666666667,3,4,5,9,12,7,0,0,0,60,98,116,25,3,4,597,659,556,527,25,29,0,30198073.055
ED.JOVANOVSKI,20132014,FLA,598.2833333333333,1,1,3,4,5,2,0,0,0,44,83,34,28,5,13,515,624,425,466,19,24,0,30198068.275
ELIAS.LINDHOLM,20132014,CAR,842.5,9,6,6,12,21,15,106,229,123,70,130,51,31,3,2,908,709,633,641,24,31,0.462882096069869,30198096.22
EMERSON.ETEM,20132014,ANA,412.20000000000005,7,2,2,4,11,9,0,1,1,53,100,54,22,3,4,373,392,306,333,12,11,0,30198060.03
ERIAH.HAYES,20132014,S.J,117.51666666666667,1,0,0,0,1,1,9,21,12,17,28,40,1,3,1,113,106,110,104,2,3,0.42857142857142855,30198032.89
ERIC.BOULTON,20132014,NYI,147.43333333333334,2,1,1,2,4,3,0,0,0,21,31,32,7,13,20,104,168,99,166,4,4,0,30198045.505000003
ERIC.BREWER,20132014,T.B,1438.7166666666667,4,7,6,13,17,11,0,0,0,86,189,149,58,12,25,1134,1398,1045,1034,37,40,0,30198124.869999997
ERIC.FEHR,20132014,WSH,1077,13,11,6,17,30,24,196,426,230,138,235,81,57,14,16,949,1053,816,843,34,35,0.460093896713615,30198127.58
ERIC.GELINAS,20132014,N.J,1015.4333333333334,7,13,8,21,28,20,0,0,0,124,247,99,71,5,11,928,657,664,585,31,32,0,30198080.8
ERIC.GRYBA,20132014,OTT,998.7,2,2,6,8,10,4,0,0,0,57,127,161,45,22,29,814,1031,733,700,32,24,0,30198088.17
ERIC.NYSTROM,20132014,NSH,1173.8166666666666,15,1,5,6,21,16,2,10,8,120,208,154,51,22,15,828,1211,793,923,32,52,0.2,30198127.625
ERIC.O'DELL,20132014,WPG,290.7166666666667,3,0,4,4,7,3,77,155,78,17,31,31,2,6,6,261,241,243,233,10,12,0.4967741935483871,30198049.34
ERIC.STAAL,20132014,CAR,1602.7,21,29,11,40,61,50,753,1429,676,230,402,67,79,24,36,1899,1414,1267,1157,51,57,0.5269419174247726,30198186.585
ERIC.TANGRADI,20132014,WPG,475.43333333333334,3,2,1,3,6,5,3,3,0,52,90,105,15,8,10,443,369,426,364,11,15,1,30198057.825
ERIK.COLE,20132014,DAL,1166.55,16,7,6,13,29,23,19,41,22,141,270,94,67,20,12,1244,988,857,888,30,45,0.4634146341463415,30198122.259999998
ERIK.CONDRA,20132014,OTT,885.3,6,6,4,10,16,12,1,15,14,85,180,28,46,18,14,781,919,713,612,20,21,0.06666666666666667,30198082.270000003
ERIK.GUDBRANSON,20132014,FLA,1168.7666666666667,3,3,3,6,9,6,0,0,0,92,209,158,61,21,30,1023,1114,897,856,36,44,0,30198103.285
ERIK.GUSTAFSSON,20132014,PHI,577.4666666666667,3,2,5,7,10,5,0,0,0,35,77,12,23,1,4,546,580,492,519,25,19,0,30198072.985
ERIK.HAULA,20132014,MIN,651.3833333333333,10,5,7,12,22,15,239,491,252,85,136,36,24,3,9,490,564,450,441,25,11,0.48676171079429736,30198083.415
ERIK.JOHNSON,20132014,COL,2024.0333333333333,10,15,13,28,38,25,0,0,0,170,349,151,118,8,22,1859,1894,1383,1577,58,60,0,30198190.105
ERIK.KARLSSON,20132014,OTT,2217.9,20,26,27,53,73,46,0,0,0,256,588,122,206,19,18,2553,1905,1803,1498,71,76,0,30198160.015
EVANDER.KANE,20132014,WPG,1278.1333333333334,19,19,3,22,41,38,45,105,60,250,478,171,120,24,30,1307,1177,961,904,41,50,0.42857142857142855,30198128.165
EVGENI.MALKIN,20132014,PIT,1476.8,29,39,17,56,85,68,345,713,368,231,418,34,110,37,34,1839,1059,1093,922,60,40,0.4838709677419355,30198154.145
EVGENY.KUZNETSOV,20132014,WSH,229.05,3,2,4,6,9,5,5,27,22,22,37,7,8,3,3,169,207,141,192,7,10,0.18518518518518517,30198046.630000003
FEDOR.TYUTIN,20132014,CBJ,1537.0666666666666,5,7,15,22,27,12,0,0,0,88,187,98,51,9,25,1283,1444,954,1015,44,46,0,30198128.015
FILIP.FORSBERG,20132014,NSH,148.26666666666665,1,1,3,4,5,2,0,0,0,20,38,6,9,1,3,125,110,95,107,2,9,0,30198033.585
FRANCIS.BOUILLON,20132014,MTL,1047.6166666666668,4,2,2,4,8,6,0,0,0,41,87,88,31,6,16,869,1047,740,947,35,41,0,30198124.71
FRANCOIS.BEAUCHEMIN,20132014,ANA,1928.4666666666667,4,8,8,16,20,12,0,0,0,114,269,145,92,13,19,1723,2044,1256,1379,77,62,0,30198156.18
FRANK.CORRADO,20132014,VAN,188.46666666666667,1,0,0,0,1,1,0,0,0,20,42,9,11,1,2,180,187,168,177,6,7,0,30198038.61
FRANS.NIELSEN,20132014,NYI,1466.6333333333332,25,23,10,33,58,48,534,1083,549,167,281,39,60,13,4,1466,1221,859,847,36,49,0.4930747922437673,30198152.79
FRAZER.MCLAREN,20132014,TOR,108.16666666666666,0,0,0,0,0,0,1,1,0,4,8,24,2,12,15,64,93,64,92,1,3,1,30198033.71
FREDDIE.HAMILTON,20132014,S.J,113.55000000000001,0,0,0,0,0,0,14,36,22,13,26,24,6,0,1,91,99,87,91,1,5,0.3888888888888889,30198031.009999998
GABRIEL.BOURQUE,20132014,NSH,1024.0166666666667,9,11,6,17,26,20,0,1,1,108,195,70,39,9,5,961,907,878,800,40,43,0,30198104.34
GABRIEL.DUMONT,20132014,MTL,13.666666666666666,0,0,0,0,0,0,3,8,5,1,1,3,0,1,0,8,17,8,15,0,0,0.375,15099012.63
GABRIEL.LANDESKOG,20132014,COL,1660.6833333333334,29,29,11,40,69,58,14,19,5,243,426,193,104,28,38,1639,1461,1207,1272,71,48,0.7368421052631579,30198180.515
GARRETT.WILSON,20132014,FLA,31,0,0,0,0,0,0,0,0,0,4,4,11,0,0,0,18,20,17,20,0,1,0,15099012.85
GEORGE.PARROS,20132014,MTL,100.1,0,0,1,1,1,0,0,0,0,4,5,14,0,12,16,49,129,47,128,3,9,0,30198040.195
GILBERT.BRULE,20132014,ARI,34.66666666666667,0,0,0,0,0,0,0,0,0,3,6,3,1,0,1,34,32,33,32,0,1,0,15099013.8
GRANT.CLITSOME,20132014,WPG,633.1833333333334,2,3,7,10,12,5,0,0,0,42,94,51,31,3,10,653,606,519,485,23,30,0,30198066.905
GREG.MCKEGG,20132014,TOR,3.716666666666667,0,0,0,0,0,0,1,6,5,1,1,2,0,0,0,3,0,3,0,0,0,0.16666666666666666,15099010.64
GREGORY.CAMPBELL,20132014,BOS,1111.7833333333333,8,7,5,12,20,15,409,855,446,94,161,154,35,17,17,772,1204,710,861,23,29,0.4783625730994152,30198141.405
GUSTAV.NYQUIST,20132014,DET,1037.5,28,12,8,20,48,40,5,9,4,165,290,22,59,15,6,1118,706,753,615,41,20,0.5555555555555556,30198096.85
HAL.GILL,20132014,PHI,101.08333333333334,0,0,0,0,0,0,0,0,0,2,9,9,3,0,1,69,90,68,76,3,5,0,30198028.35
HAMPUS.LINDHOLM,20132014,ANA,1715.4666666666667,6,14,11,25,31,20,0,1,1,122,244,63,86,10,17,1774,1495,1328,1324,79,50,0,30198149.975
HARRY.ZOLNIERCZYK,20132014,PIT,131.66666666666666,2,0,0,0,2,2,2,2,0,12,19,14,3,7,5,75,102,75,100,2,2,1,30198034.299999997
HENRIK.SEDIN,20132014,VAN,1447.0666666666666,11,19,20,39,50,30,573,1096,523,97,177,43,43,21,21,1685,1030,1035,829,43,29,0.5228102189781022,30198128.979999997
HENRIK.TALLINDER,20132014,BUF,1215.9833333333331,2,2,4,6,8,4,1,1,0,40,94,39,40,3,16,833,1336,774,1041,23,47,1,30198136.22
HENRIK.ZETTERBERG,20132014,DET,963.9333333333333,17,20,13,33,50,37,259,490,231,156,276,26,56,17,10,1102,744,679,600,44,22,0.5285714285714286,30198104.355
IAN.COLE,20132014,STL,693.8666666666667,3,2,6,8,11,5,0,0,0,45,105,24,33,7,14,576,623,538,555,25,12,0,30198076.72
J.T..BROWN,20132014,T.B,881.1166666666668,4,12,5,17,21,16,7,22,15,118,203,79,41,8,3,810,812,735,662,23,30,0.3181818181818182,30198090.835
J.T..MILLER,20132014,NYR,380.66666666666663,3,1,4,5,8,4,28,53,25,49,88,56,15,8,9,400,322,329,306,10,10,0.5283018867924528,30198054.5
JACK.HILLEN,20132014,WSH,237.83333333333334,0,1,0,1,1,1,0,0,0,12,24,10,4,1,2,175,268,161,214,2,7,0,30198045.61
JACK.JOHNSON,20132014,CBJ,2199.766666666667,8,11,20,31,39,19,0,1,1,161,317,196,92,15,26,1952,2068,1262,1401,61,63,0,30198170.4
JACK.SKILLE,20132014,CBJ,204.66666666666669,4,1,0,1,5,5,1,1,0,31,51,43,7,5,3,174,210,173,206,7,7,1,30198046.54
JACOB.JOSEFSON,20132014,N.J,273.5833333333333,1,0,2,2,3,1,83,168,85,21,37,15,8,4,2,184,215,172,173,6,9,0.49404761904761907,30198041.91
JACOB.TROUBA,20132014,WPG,1458.3666666666668,10,9,10,19,29,19,0,0,0,121,293,95,106,21,16,1356,1490,1044,1076,47,51,0,30198128.61
JADEN.SCHWARTZ,20132014,STL,1535.1833333333334,26,20,12,32,58,46,44,83,39,203,333,66,68,19,12,1560,1180,1159,903,58,36,0.5301204819277109,30198123.35
JAKE.DOWELL,20132014,MIN,7.15,0,0,0,0,0,0,2,4,2,1,2,3,0,0,0,5,6,5,5,0,1,0.5,15099011.13
JAKE.GARDINER,20132014,TOR,1686.1,10,10,11,21,31,20,0,0,0,136,275,108,87,14,8,1617,1602,1195,1377,49,45,0,30198168.865000002
JAKE.MCCABE,20132014,BUF,106.5,0,0,1,1,1,0,0,0,0,1,5,5,4,2,2,72,128,65,109,2,5,0,30198033.645
JAKE.MUZZIN,20132014,L.A,2054.583333333333,11,11,12,23,34,22,0,0,0,223,505,242,191,22,33,2279,1457,1740,1215,59,43,0,30198109.72
JAKOB.SILFVERBERG,20132014,ANA,935.7333333333333,12,9,4,13,25,21,1,12,11,136,221,47,41,11,10,883,921,694,717,28,30,0.08333333333333333,30198106.1
JAKUB.KINDL,20132014,DET,1206.25,2,6,11,17,19,8,0,0,0,101,221,62,70,11,13,1135,911,888,839,35,32,0,30198099.335
JAKUB.VORACEK,20132014,PHI,1533.5833333333333,25,24,17,41,66,49,4,6,2,249,470,28,144,21,14,1973,1166,1235,1016,52,37,0.6666666666666666,30198129.045
JAMES.NEAL,20132014,PIT,1328.1999999999998,29,22,14,36,65,51,6,21,15,287,515,75,127,27,31,1676,958,1058,861,55,39,0.2857142857142857,30198123.36
JAMES.SHEPPARD,20132014,S.J,901.15,6,11,9,20,26,17,120,275,155,94,161,140,36,15,20,837,767,794,716,33,26,0.43636363636363634,30198103.674999997
JAMES.VAN RIEMSDYK,20132014,TOR,1684.5166666666667,30,18,13,31,61,48,46,113,67,278,401,118,51,17,23,1721,1799,1156,1460,64,59,0.40707964601769914,30198217.235
JAMES.WISNIEWSKI,20132014,CBJ,1845.1666666666665,7,20,24,44,51,27,0,0,0,178,372,115,115,22,30,1910,1464,1255,1070,50,46,0,30198125.32
JAMES.WRIGHT,20132014,WPG,565.1666666666667,0,1,1,2,2,1,126,269,143,41,78,63,22,8,6,376,589,325,358,11,15,0.4684014869888476,30198063.045
JAMIE.BENN,20132014,DAL,1678.2833333333333,38,24,22,46,84,62,438,831,393,294,553,130,122,32,27,2087,1424,1246,1126,77,47,0.5270758122743683,30198173.54
JAMIE.DEVANE,20132014,TOR,11.716666666666665,0,0,0,0,0,0,0,0,0,1,1,2,0,0,0,6,11,6,11,0,1,0,15099011.9
JAMIE.MCBAIN,20132014,BUF,1391.4666666666667,6,4,5,9,15,10,0,0,0,98,224,34,83,7,7,1145,1405,814,1190,25,36,0,30198155.395000003
JAMIE.MCGINN,20132014,COL,1367.65,21,12,10,22,43,33,1,2,1,186,347,153,68,14,15,1272,1292,1030,1171,49,53,0.5,30198161.380000003
JAMIE.OLEKSIAK,20132014,DAL,124.53333333333333,0,0,0,0,0,0,0,0,0,5,9,16,3,1,1,113,146,94,94,4,7,0,30198029.759999998
JAN.HEJDA,20132014,COL,1892.3666666666668,6,2,9,11,17,8,0,0,0,81,164,184,51,3,19,1363,2146,1232,1547,62,61,0,30198187.405
JANNIK.HANSEN,20132014,VAN,1112.2333333333333,11,5,4,9,20,16,12,29,17,112,209,99,52,8,15,1050,972,903,846,28,37,0.41379310344827586,30198110.16
JARED.BOLL,20132014,CBJ,226.71666666666664,1,0,1,1,2,1,0,1,1,12,24,57,7,19,15,146,209,143,208,3,9,0,30198047.415
JARED.COWEN,20132014,OTT,1394.8333333333335,6,4,4,8,14,10,0,0,0,68,125,214,31,5,21,1243,1506,1125,1091,47,43,0,30198130
JARED.SPURGEON,20132014,MIN,1829.8000000000002,8,15,8,23,31,23,0,0,0,113,261,101,78,9,9,1637,1513,1271,1144,62,36,0,30198129.59
JAROME.IGINLA,20132014,BOS,1642.3666666666668,35,21,12,33,68,56,9,40,31,235,455,178,117,20,18,1916,1415,1386,1231,63,35,0.225,30198162.41
JAROMIR.JAGR,20132014,N.J,1570.9833333333333,24,23,20,43,67,47,0,2,2,231,385,4,76,14,22,1547,910,1118,772,53,35,0,30198107.59
JARRED.TINORDI,20132014,MTL,319.68333333333334,0,0,2,2,2,0,0,0,0,10,33,42,13,6,10,257,314,239,225,9,12,0,30198041.71
JARRET.STOLL,20132014,L.A,1680.7833333333333,11,15,7,22,33,26,970,1754,784,141,272,297,62,10,32,1551,1514,1224,1014,44,32,0.5530216647662486,30198153.925
JASON.AKESON,20132014,PHI,104.31666666666666,2,2,0,2,4,4,0,0,0,13,29,8,9,0,1,122,95,100,84,4,5,0,30198029.95
JASON.CHIMERA,20132014,WSH,1264.4166666666667,15,18,9,27,42,33,38,87,49,167,253,140,42,20,17,1074,1349,894,1029,48,44,0.4367816091954023,30198151.395
JASON.DEMERS,20132014,S.J,1601.3,5,15,15,30,35,20,0,0,0,115,249,78,73,14,21,1748,1381,1320,1086,60,54,0,30198119.865000002
JASON.GARRISON,20132014,VAN,1692.6333333333332,7,18,6,24,31,25,0,0,0,181,379,58,119,4,23,1685,1482,1168,1211,45,48,0,30198147.44
JASON.POMINVILLE,20132014,MIN,1761.7833333333333,32,22,15,37,69,54,98,183,85,258,468,35,105,24,7,1871,1257,1213,1052,50,33,0.5355191256830601,30198147.985
JASON.SPEZZA,20132014,OTT,1364.5,23,26,17,43,66,49,774,1434,660,222,391,17,87,7,22,1561,1213,1060,977,48,65,0.5397489539748954,30198165.705
JASON.ZUCKER,20132014,MIN,272.73333333333335,4,0,1,1,5,4,0,0,0,40,68,16,10,3,1,213,267,192,256,8,7,0,30198052.155
JAY.BEAGLE,20132014,WSH,696.5833333333333,4,2,2,4,8,6,296,573,277,60,105,93,15,6,14,499,702,478,592,11,20,0.5165794066317626,30198102.1
JAY.BOUWMEESTER,20132014,STL,2127.133333333333,4,14,17,31,35,18,3,4,1,165,315,55,84,9,11,1911,1877,1508,1297,74,54,0.75,30198138.235
JAY.HARRISON,20132014,CAR,1130.6,4,4,7,11,15,8,0,0,0,102,215,140,74,10,19,1098,1141,921,1010,36,37,0,30198123.525
JAY.MCCLEMENT,20132014,TOR,1195.6999999999998,4,5,1,6,10,9,676,1260,584,67,136,141,45,10,16,642,1481,578,910,18,29,0.5365079365079365,30198153.065
JAY.ROSEHILL,20132014,PHI,168.03333333333333,2,0,0,0,2,2,0,1,1,14,26,48,6,17,22,117,147,113,143,3,10,0,30198041.07
JAYSON.MEGNA,20132014,PIT,395.7833333333333,5,3,1,4,9,8,2,11,9,37,66,50,17,7,3,288,368,285,348,15,15,0.18181818181818182,30198062.175
JEAN-GABRIEL.PAGEAU,20132014,OTT,286.95000000000005,2,0,0,0,2,2,118,246,128,31,58,41,9,6,6,239,287,213,203,4,9,0.4796747967479675,30198047.98
JEAN-PHILIPPE.COTE,20132014,T.B,190.01666666666665,0,0,1,1,1,0,0,0,0,12,33,40,10,4,8,195,167,190,140,2,2,0,30198032.615000002
JEFF.CARTER,20132014,L.A,1839.2666666666667,37,23,15,38,75,60,475,933,458,329,602,108,136,16,20,2150,1520,1437,1104,58,48,0.5091103965702036,30198163.085
JEFF.HALPERN,20132014,ARI,709.6833333333334,5,3,4,7,12,8,296,562,266,45,74,64,17,13,12,495,731,464,478,17,24,0.5266903914590747,30198084.369999997
JEFF.PETRY,20132014,EDM,1726.7833333333333,7,5,4,9,16,12,0,0,0,96,220,181,77,14,21,1329,1839,1133,1291,42,61,0,30198156.189999998
JEFF.SCHULTZ,20132014,L.A,131.98333333333335,0,0,0,0,0,0,0,0,0,2,9,14,5,0,0,112,128,105,88,2,3,0,30198028
JEFF.SKINNER,20132014,CAR,1220.7666666666667,33,16,5,21,54,49,23,51,28,274,474,22,113,27,11,1447,1026,961,919,41,45,0.45098039215686275,30198136.765
JEREMY.MORIN,20132014,CHI,232.79999999999998,5,5,1,6,11,10,4,6,2,49,81,22,17,13,9,261,151,246,151,13,10,0.6666666666666666,30198037.165
JEREMY.WELSH,20132014,VAN,130.28333333333333,1,0,0,0,1,1,46,90,44,13,20,16,2,3,3,107,120,102,117,4,5,0.5111111111111111,30198036.119999997
JERRED.SMITHSON,20132014,TOR,157.61666666666667,0,0,0,0,0,0,126,216,90,2,11,36,3,3,3,64,192,61,125,0,4,0.5833333333333334,30198040.07
JERRY.D'AMIGO,20132014,TOR,177.01666666666668,1,1,1,2,3,2,1,4,3,12,20,23,5,6,0,98,188,94,149,5,6,0.25,30198039.275
JESPER.FAST,20132014,NYR,153.16666666666666,0,0,1,1,1,0,0,0,0,7,17,29,4,3,1,126,116,117,88,2,7,0,30198028.055
JESSE.JOENSUU,20132014,EDM,391.5,3,1,1,2,5,4,0,5,5,41,75,63,17,7,8,330,375,286,368,6,21,0,30198064.744999997
JESSE.WINCHESTER,20132014,FLA,662.3333333333333,9,9,0,9,18,18,63,130,67,100,156,65,26,9,12,541,633,497,462,21,23,0.4846153846153846,30198079.259999998
JIM.SLATER,20132014,WPG,287.0333333333333,1,0,1,1,2,1,162,280,118,24,33,41,4,3,4,225,291,201,203,4,10,0.5785714285714286,30198047.085
JIMMY.HAYES,20132014,CHI,23.683333333333334,0,0,0,0,0,0,0,0,0,1,7,6,4,1,0,22,14,22,14,1,0,0,30198021.310000002
JIMMY.HAYES,20132014,FLA,579.5166666666667,11,5,2,7,18,16,11,30,19,71,120,109,16,4,9,540,491,419,467,21,23,0.36666666666666664,30198080.93
JIRI.HUDLER,20132014,CGY,1413.3666666666668,17,23,14,37,54,40,4,22,18,109,204,35,45,14,8,1348,1112,892,1008,49,38,0.18181818181818182,30198146.75
JIRI.TLUSTY,20132014,CAR,1031.5,16,10,4,14,30,26,3,15,12,131,238,88,53,17,11,1061,938,846,808,37,34,0.2,30198112.34
JOAKIM.ANDERSSON,20132014,DET,907.0833333333333,8,5,4,9,17,13,346,672,326,77,118,26,17,7,6,626,908,575,578,22,31,0.5148809523809523,30198099.41
JOAKIM.NORDSTROM,20132014,CHI,246.51666666666668,1,2,0,2,3,3,12,32,20,32,57,24,15,0,1,184,235,177,203,5,11,0.375,30198044.03
JOE.COLBORNE,20132014,CGY,1141.3333333333333,10,9,9,18,28,19,214,441,227,80,137,128,25,9,17,991,1033,785,940,33,45,0.4852607709750567,30198142.525
JOE.CORVO,20132014,OTT,438.04999999999995,3,4,3,7,10,7,0,0,0,54,103,15,30,2,5,477,378,371,340,13,17,0,30198054.995
JOE.PAVELSKI,20132014,S.J,1771.5333333333333,43,31,11,42,85,74,735,1334,599,252,510,63,117,28,16,2234,1487,1377,1084,55,33,0.5509745127436282,30198174.805
JOE.PISKULA,20132014,NSH,24.35,0,0,0,0,0,0,0,0,0,2,4,2,1,0,0,22,12,22,12,1,0,0,15099011
JOE.THORNTON,20132014,S.J,1687.6,13,37,29,66,79,50,675,1190,515,138,250,62,64,23,20,2313,1275,1426,1036,63,45,0.5672268907563025,30198146.805
JOE.VITALE,20132014,PIT,702.45,1,5,7,12,13,6,243,403,160,55,97,124,21,14,15,512,681,486,591,17,18,0.6029776674937966,30198094.335
JOE.WHITNEY,20132014,N.J,8,0,0,0,0,0,0,0,1,1,0,0,1,0,0,0,4,5,4,5,0,0,0,15099011.1
JOEL.WARD,20132014,WSH,1317.8333333333333,24,9,16,25,49,33,90,199,109,133,228,54,48,17,15,1154,1297,860,961,47,40,0.45226130653266333,30198144.47
JOEY.CRABB,20132014,FLA,129.41666666666669,0,1,0,1,1,1,10,20,10,5,12,23,4,3,2,70,144,63,102,1,3,0.5,30198033.93
JOEY.HISHON,20132014,COL,18.616666666666667,0,1,0,1,1,1,4,10,6,1,2,1,0,0,1,17,8,12,7,1,1,0.4,30198022.31
JOFFREY.LUPUL,20132014,TOR,1273.25,22,13,9,22,44,35,24,55,31,192,313,118,57,25,16,1240,1312,875,1174,38,50,0.43636363636363634,30198175.884999998
JOHAN.FRANZEN,20132014,DET,1047.7666666666667,16,23,4,27,43,39,120,226,106,163,277,76,52,10,13,1035,742,657,638,29,28,0.5309734513274337,30198110.15
JOHAN.LARSSON,20132014,BUF,376.68333333333334,0,2,2,4,4,2,135,284,149,21,43,51,8,6,8,267,340,244,281,6,7,0.4753521126760563,30198058.509999998
JOHAN.SUNDSTROM,20132014,NYI,95.31666666666666,0,0,1,1,1,0,4,11,7,13,16,4,0,3,3,91,85,87,82,2,2,0.36363636363636365,30198030.165
JOHN-MICHAEL.LILES,20132014,CAR,703.4666666666667,2,4,3,7,9,6,0,0,0,51,103,35,33,3,4,745,580,549,514,23,15,0,30198069.255
JOHN-MICHAEL.LILES,20132014,TOR,102.36666666666667,0,0,0,0,0,0,1,1,0,5,11,15,4,1,0,89,132,75,125,3,5,1,30198035.200000003
JOHN.ALBERT,20132014,WPG,46.016666666666666,1,0,0,0,1,1,9,21,12,5,6,8,1,0,0,37,45,37,45,1,4,0.42857142857142855,30198027.06
JOHN.CARLSON,20132014,WSH,2010.3666666666668,10,14,12,26,36,24,0,1,1,208,388,64,126,12,11,1871,2161,1176,1326,46,51,0,30198163.119999997
JOHN.ERSKINE,20132014,WSH,577.0666666666666,1,2,1,3,4,3,0,0,0,38,77,64,27,10,21,431,657,419,496,21,26,0,30198074.275
JOHN.MCCARTHY,20132014,S.J,398.05,1,1,0,1,2,2,71,133,62,49,77,25,20,2,2,320,393,302,312,5,15,0.5338345864661654,30198055.36
JOHN.MITCHELL,20132014,COL,1220.3666666666668,11,13,8,21,32,24,374,748,374,107,206,112,56,13,17,957,1236,799,942,36,26,0.5,30198146.990000002
JOHN.MOORE,20132014,NYR,1439.5500000000002,4,6,6,12,16,10,0,0,0,134,302,77,111,11,16,1481,1243,1204,1139,42,36,0,30198124.46
JOHN.PERSSON,20132014,NYI,120.36666666666666,1,0,0,0,1,1,0,2,2,16,27,18,7,3,3,110,120,109,119,2,6,0,30198034.130000003
JOHN.SCOTT,20132014,BUF,378.26666666666665,1,0,0,0,1,1,0,0,0,16,24,94,5,10,32,251,373,240,367,6,18,0,30198068.799999997
JOHN.TAVARES,20132014,NYI,1252.3000000000002,24,26,16,42,66,50,552,1127,575,187,333,23,85,16,15,1462,1102,945,968,49,42,0.4897959183673469,30198166.14
JOHNNY.BOYCHUK,20132014,BOS,1856.85,6,11,7,18,24,17,0,0,0,167,338,191,109,13,22,1680,1741,1519,1236,76,53,0,30198125.255000003
JOHNNY.GAUDREAU,20132014,CGY,15.183333333333334,1,0,0,0,1,1,0,0,0,1,2,0,0,1,0,14,9,11,9,1,0,0,15099011.91
JOHNNY.ODUYA,20132014,CHI,1964.2333333333336,5,7,8,15,20,12,1,1,0,100,210,71,72,11,23,1574,1741,1440,1329,65,62,1,30198144.299999997
JON.MERRILL,20132014,N.J,999.7666666666667,2,5,4,9,11,7,0,0,0,45,123,27,54,3,7,796,693,664,583,21,25,0,30198071.78
JONAS.BRODIN,20132014,MIN,2195.45,8,2,11,13,21,10,0,0,0,85,207,42,85,15,17,1628,1916,1347,1434,52,55,0,30198162.675
JONATHAN.ERICSSON,20132014,DET,1019.8333333333333,1,3,6,9,10,4,0,0,0,66,124,91,33,5,16,794,940,711,661,34,38,0,30198083.1
JONATHAN.HUBERDEAU,20132014,FLA,1080.8833333333334,9,8,10,18,27,17,4,10,6,108,190,73,46,37,19,1081,873,827,797,36,40,0.4,30198107.23
JONATHAN.RACINE,20132014,FLA,15.583333333333334,0,0,0,0,0,0,0,0,0,0,3,1,2,0,1,12,22,11,20,0,1,0,15099012.8
JONATHAN.TOEWS,20132014,CHI,1967.9666666666667,37,30,18,48,85,67,1144,2021,877,227,338,45,52,24,17,2239,1500,1534,1118,80,57,0.566056407718951,30198182.5
JONATHON.BLUM,20132014,MIN,174.9666666666667,0,1,0,1,1,1,0,0,0,11,25,10,7,1,0,146,133,140,117,2,2,0,30198031.310000002
JOONAS.NATTINEN,20132014,MTL,1.75,0,0,0,0,0,0,0,2,2,0,0,0,0,0,0,0,5,0,5,0,0,0,15099011.35
JORDAN.CARON,20132014,BOS,437.7,2,2,0,2,4,4,1,4,3,61,95,58,20,8,16,360,420,351,376,8,15,0.25,30198063.82
JORDAN.EBERLE,20132014,EDM,1563.7833333333333,28,23,14,37,65,51,8,21,13,200,360,51,87,19,8,1582,1459,1050,1222,50,56,0.38095238095238093,30198176.509999998
JORDAN.LEOPOLD,20132014,STL,521.2,1,4,2,6,7,5,0,0,0,43,84,12,28,5,4,463,404,407,375,13,11,0,30198056.6
JORDAN.NOLAN,20132014,L.A,600.4833333333333,6,0,3,3,9,6,1,4,3,58,102,108,27,19,17,535,475,528,467,11,14,0.25,30198069.155
JORDAN.SCHROEDER,20132014,VAN,300.2833333333333,3,1,2,3,6,4,112,244,132,25,47,20,10,2,1,299,243,243,221,6,10,0.45901639344262296,30198049.3
JORDAN.STAAL,20132014,CAR,1553.8833333333332,15,18,7,25,40,33,803,1477,674,165,298,194,52,18,17,1697,1388,1243,1065,32,28,0.5436696005416385,30198163.575000003
JORDAN.SZWARZ,20132014,ARI,224.81666666666666,3,0,0,0,3,3,1,3,2,25,37,23,5,3,4,177,218,170,178,4,10,0.3333333333333333,30198041.92
JORDIE.BENN,20132014,DAL,1625.7666666666669,3,5,14,19,22,8,1,1,0,96,230,129,78,8,16,1486,1594,1296,1251,55,42,1,30198137.07
JORDIN.TOOTOO,20132014,DET,76.83333333333334,0,0,1,1,1,0,0,0,0,11,20,27,3,3,1,62,59,61,59,2,5,0,30198026.855
JOSH.BAILEY,20132014,NYI,1219.7833333333333,8,21,9,30,38,29,113,228,115,98,197,44,63,8,9,1233,974,924,841,38,40,0.4956140350877193,30198114.575000003
JOSH.GORGES,20132014,MTL,1800.5333333333333,1,8,6,14,15,9,0,1,1,39,119,124,38,6,10,1336,1923,1176,1386,49,44,0,30198166.16
JOSH.LEIVO,20132014,TOR,69.01666666666667,1,1,0,1,2,2,0,1,1,4,6,5,0,1,0,44,58,41,58,2,2,0,30198028.86
JULIAN.MELCHIORI,20132014,WPG,8.683333333333334,0,0,0,0,0,0,0,0,0,0,0,1,0,0,0,2,5,2,5,0,1,0,15099011.15
JULIEN.BROUILLETTE,20132014,WSH,155.51666666666665,1,1,0,1,2,2,0,0,0,4,16,10,8,1,0,108,161,101,152,6,5,0,30198038.11
JUSSI.JOKINEN,20132014,PIT,1476.1,28,25,14,39,67,53,174,326,152,203,345,42,80,18,16,1644,1064,1214,984,61,43,0.5337423312883436,30198139.740000002
JUSTIN.ABDELKADER,20132014,DET,1148.8833333333332,10,13,7,20,30,23,23,56,33,154,236,193,26,23,17,1017,945,892,851,41,34,0.4107142857142857,30198120.575000003
JUSTIN.BRAUN,20132014,S.J,1862.1166666666668,5,6,8,14,19,11,0,0,0,127,282,84,108,11,12,1788,1784,1511,1321,62,49,0,30198133.76
JUSTIN.FALK,20132014,NYR,250.56666666666666,0,0,1,1,1,0,0,0,0,10,24,39,9,3,7,188,247,187,229,3,9,0,30198045.854999997
JUSTIN.FAULK,20132014,CAR,1779.2833333333333,5,8,15,23,28,13,0,0,0,152,337,94,120,8,17,1792,1728,1374,1276,57,65,0,30198136.405
JUSTIN.FLOREK,20132014,BOS,118.35,2,1,0,1,3,3,0,1,1,15,22,13,3,0,1,95,84,92,77,4,3,0,30198029.799999997
JUSTIN.FONTAINE,20132014,MIN,908.9333333333333,14,6,3,9,23,20,2,2,0,92,160,13,33,9,14,707,737,619,702,27,21,1,30198106.445
JUSTIN.JOHNSON,20132014,NYI,12.966666666666667,0,0,0,0,0,0,0,0,0,0,0,6,0,1,2,11,11,11,10,0,1,0,15099011.76
JUSTIN.SCHULTZ,20132014,EDM,1726.3000000000002,11,11,10,21,32,22,0,1,1,109,242,30,72,9,7,1563,1669,1030,1382,47,62,0,30198180.09
JUSTIN.WILLIAMS,20132014,L.A,1827.4499999999998,28,20,20,40,68,48,5,15,10,306,520,75,87,26,35,2106,1259,1550,1068,66,42,0.3333333333333333,30198134.11
KARL.ALZNER,20132014,WSH,1683.8833333333332,2,5,11,16,18,7,0,0,0,95,201,73,58,11,13,1264,1976,1119,1251,41,51,0,30198149.634999998
KARL.STOLLERY,20132014,COL,13.016666666666667,0,0,0,0,0,0,0,0,0,1,2,3,0,0,1,11,5,11,5,1,0,0,30198021.25
KEATON.ELLERBY,20132014,WPG,709.3499999999999,2,2,1,3,5,4,0,0,0,33,84,76,40,9,1,604,671,580,634,23,21,0,30198082.115000002
KEITH.AUCOIN,20132014,STL,26.616666666666667,0,0,0,0,0,0,9,15,6,1,1,0,0,0,0,20,25,17,20,0,3,0.6,30198023.41
KEITH.AULIE,20132014,T.B,159.71666666666667,0,0,1,1,1,0,0,0,0,6,19,19,11,2,3,111,172,107,161,3,6,0,30198038.545
KEITH.BALLARD,20132014,MIN,644.6833333333334,2,4,3,7,9,6,0,0,0,31,84,62,37,13,14,494,573,413,490,19,30,0,30198073.055
KEITH.YANDLE,20132014,ARI,1979.9833333333333,8,27,18,45,53,35,0,0,0,241,521,22,164,13,21,2251,1626,1488,1403,58,64,0,30198160.880000003
KELLAN.LAIN,20132014,VAN,46.96666666666667,1,0,0,0,1,1,18,37,19,7,10,7,2,3,5,43,54,43,53,2,1,0.4864864864864865,30198028.799999997
KENNY.AGOSTINO,20132014,CGY,88.73333333333333,1,1,0,1,2,2,0,0,0,12,20,9,2,1,0,74,95,71,94,2,4,0,30198032.810000002
KEVAN.MILLER,20132014,BOS,1034.4,1,2,5,7,8,3,0,0,0,47,114,148,44,14,17,832,980,779,758,27,13,0,30198092.314999998
KEVIN.BIEKSA,20132014,VAN,1730.8333333333333,4,9,10,19,23,13,1,1,0,166,337,143,109,25,36,1717,1631,1340,1263,48,50,1,30198142.34
KEVIN.CONNAUTON,20132014,DAL,594.8333333333333,1,2,4,6,7,3,0,0,0,56,125,49,43,5,12,597,589,525,541,18,22,0,30198073.5
KEVIN.CZUCZMAN,20132014,NYI,254.06666666666666,0,2,0,2,2,2,1,1,0,24,44,15,7,1,7,213,258,182,203,7,12,1,30198043.6
KEVIN.KLEIN,20132014,NSH,883.8,1,1,1,2,3,2,0,0,0,49,106,75,42,8,6,594,914,566,725,17,30,0,30198097.355
KEVIN.KLEIN,20132014,NYR,782.8333333333333,2,2,5,7,9,4,0,0,0,42,103,89,39,4,3,745,732,706,662,29,20,0,30198080.265
KEVIN.PORTER,20132014,BUF,139.5,0,1,0,1,1,1,18,53,35,3,11,24,3,4,1,84,143,81,114,1,6,0.33962264150943394,30198035.91
KEVIN.SHATTENKIRK,20132014,STL,1820,11,14,24,38,49,25,0,0,0,210,439,80,153,11,20,1960,1264,1288,1062,54,49,0,30198115.66
KEVIN.WESTGARTH,20132014,CAR,58.56666666666666,0,0,0,0,0,0,0,0,0,6,14,7,2,0,1,57,62,57,61,1,3,0,30198027.299999997
KEVIN.WESTGARTH,20132014,CGY,253.11666666666667,4,3,0,3,7,7,1,5,4,25,42,38,9,10,19,189,270,186,267,9,11,0.2,30198057.89
KIMMO.TIMONEN,20132014,PHI,1705.5,6,17,13,30,36,23,0,0,0,158,310,89,87,7,19,1772,1440,1045,870,38,41,0,30198105.845
KRIS.LETANG,20132014,PIT,1210.9,13,8,7,15,28,21,0,0,0,137,252,62,68,17,15,1209,1060,813,786,26,31,0,30198107.445
KRIS.NEWBURY,20132014,PHI,20.1,0,1,0,1,1,1,6,14,8,1,3,10,0,1,2,10,19,10,19,1,1,0.42857142857142855,30198024.45
KRIS.RUSSELL,20132014,CGY,1573.15,7,12,10,22,29,19,0,0,0,109,224,42,63,7,6,1432,1509,1009,1308,47,55,0,30198168.92
KRIS.VERSTEEG,20132014,CHI,1067.7666666666667,11,12,9,21,32,23,52,111,59,126,221,30,50,18,13,1035,759,794,714,33,32,0.46846846846846846,30198101.785
KRIS.VERSTEEG,20132014,FLA,282.33333333333337,2,2,3,5,7,4,9,18,9,47,85,6,19,5,3,280,223,206,187,7,15,0.5,30198040.785
KRYS.BARCH,20132014,FLA,328.75,0,2,2,4,4,2,1,1,0,19,31,64,6,15,22,237,303,230,296,4,15,1,30198058.04
KYLE.BRODZIAK,20132014,MIN,1472.8333333333333,11,9,8,17,28,20,651,1364,713,130,261,85,70,15,26,938,1490,853,1061,33,36,0.4772727272727273,30198174.990000002
KYLE.CHIPCHURA,20132014,ARI,777.4333333333333,5,8,7,15,20,13,175,330,155,46,85,116,24,20,16,698,668,685,642,29,25,0.5303030303030303,30198094.425
KYLE.CLIFFORD,20132014,L.A,956.2333333333333,4,4,7,11,15,8,6,13,7,96,168,253,37,18,36,832,756,805,718,27,23,0.46153846153846156,30198095.045
KYLE.OKPOSO,20132014,NYI,1449.8000000000002,27,22,20,42,69,49,97,204,107,194,380,43,106,19,20,1688,1240,1112,1116,59,55,0.47549019607843135,30198157.82
KYLE.PALMIERI,20132014,ANA,939.75,17,6,11,17,34,23,9,23,14,159,259,122,46,23,19,942,853,746,804,42,31,0.391304347826087,30198118.765
KYLE.QUINCEY,20132014,DET,1813.1,4,4,5,9,13,8,0,0,0,115,232,104,73,9,37,1355,1666,1231,1239,47,53,0,30198144.064999998
KYLE.TURRIS,20132014,OTT,1534.4333333333334,26,22,9,31,57,48,724,1428,704,215,389,45,91,29,18,1658,1461,1200,1071,62,38,0.5070028011204482,30198171.375
LADISLAV.SMID,20132014,CGY,1019.25,1,2,3,5,6,3,0,0,0,35,70,141,19,5,21,677,1090,619,885,20,28,0,30198123.925
LADISLAV.SMID,20132014,EDM,304.2,1,0,0,0,1,1,0,0,0,6,16,52,9,2,8,198,326,180,240,9,16,0,30198047.52
LANCE.BOUMA,20132014,CGY,983.3333333333333,5,6,4,10,15,11,22,85,63,82,151,180,30,17,18,692,1141,643,837,26,30,0.25882352941176473,30198123
LANDON.FERRARO,20132014,DET,35.9,0,0,0,0,0,0,0,0,0,2,2,7,0,0,1,14,38,14,29,0,0,0,30198024.9
LANE.MACDERMID,20132014,CGY,4.133333333333334,0,0,0,0,0,0,0,0,0,0,0,3,0,2,2,0,4,0,4,0,1,0,15099011.42
LANE.MACDERMID,20132014,DAL,34.86666666666667,0,1,1,2,2,1,1,2,1,1,2,7,1,1,1,33,26,33,26,2,0,0.5,30198023.675
LARS.ELLER,20132014,MTL,1508.8166666666666,17,13,8,21,38,30,637,1248,611,161,308,160,89,32,36,1368,1481,1133,1218,39,53,0.5104166666666666,30198185.45
LAURI.KORPIKOSKI,20132014,ARI,1028.2166666666667,9,9,7,16,25,18,5,17,12,108,207,136,50,9,10,846,1111,696,807,22,24,0.29411764705882354,30198115.765
LEE.STEMPNIAK,20132014,CGY,1009.1500000000001,8,9,6,15,23,17,9,28,19,144,229,71,45,7,10,900,881,661,706,20,45,0.32142857142857145,30198104.73
LEE.STEMPNIAK,20132014,PIT,534.2666666666667,6,6,2,8,14,12,3,12,9,56,108,52,33,5,4,463,478,393,417,20,17,0.25,30198067.47
LINDEN.VEY,20132014,L.A,218.4,0,3,2,5,5,3,54,123,69,8,20,2,4,4,0,188,167,141,137,4,4,0.43902439024390244,30198038.450000003
LINUS.OMARK,20132014,BUF,166,0,0,2,2,2,0,0,1,1,10,23,3,6,5,2,144,137,119,129,2,7,0,30198034.25
LINUS.OMARK,20132014,EDM,9.066666666666666,0,0,0,0,0,0,0,0,0,0,2,1,0,0,0,10,10,10,10,0,1,0,15099011.5
LOGAN.COUTURE,20132014,S.J,1361.15,24,18,15,33,57,42,531,1059,528,251,436,33,84,24,11,1703,1171,1021,878,50,33,0.5014164305949008,30198144.905
LOUI.ERIKSSON,20132014,BOS,1219.95,12,13,17,30,42,25,2,3,1,139,215,14,31,11,5,1261,878,938,666,42,26,0.6666666666666666,30198087.715
LOUIS.LEBLANC,20132014,MTL,78.96666666666667,0,0,0,0,0,0,2,4,2,7,14,3,5,1,2,61,73,59,70,2,1,0.5,30198028.240000002
LUBOMIR.VISNOVSKY,20132014,NYI,492.3666666666667,3,2,6,8,11,5,0,0,0,34,84,14,38,1,5,574,363,362,310,15,13,0,30198047.560000002
LUCA.SBISA,20132014,ANA,540.3666666666666,1,1,5,6,7,2,0,0,0,33,85,88,32,7,17,456,517,399,426,16,18,0,30198063.645
LUCAS.LESSIO,20132014,ARI,34.583333333333336,0,0,0,0,0,0,0,0,0,4,7,2,1,2,1,30,36,30,36,0,2,0,30198025.12
LUKE.ADAM,20132014,BUF,154,1,0,0,0,1,1,10,26,16,16,35,16,12,3,1,130,121,116,117,3,3,0.38461538461538464,30198032.88
LUKE.GAZDIC,20132014,EDM,388.66666666666663,2,1,1,2,4,3,3,3,0,30,51,103,12,26,28,256,423,249,421,6,13,1,30198076.955
LUKE.GLENDENING,20132014,DET,850.1,2,6,0,6,8,8,345,727,382,57,92,99,16,13,11,521,887,480,560,14,24,0.47455295735900965,30198101.48
LUKE.SCHENN,20132014,PHI,1428.15,5,6,2,8,13,11,0,0,0,90,216,285,91,11,15,1215,1518,1138,1257,48,50,0,30198145.61
MAGNUS.PAAJARVI,20132014,STL,563.6166666666667,6,4,2,6,12,10,2,6,4,60,104,25,29,8,3,502,444,485,428,15,22,0.3333333333333333,30198064.61
MANNY.MALHOTRA,20132014,CAR,800.0666666666667,7,3,2,5,12,10,566,952,386,53,86,82,18,7,8,531,903,486,683,19,24,0.5945378151260504,30198117.86
MARC-ANDRE.CLICHE,20132014,COL,902.6666666666667,1,4,2,6,7,5,383,830,447,71,109,29,18,6,9,476,1037,432,647,8,22,0.4614457831325301,30198119.08
MARC-EDOUARD.VLASIC,20132014,S.J,1762.85,6,9,12,21,27,15,0,0,0,148,355,60,125,11,11,1847,1562,1562,1135,65,44,0,30198103.86
MARC.METHOT,20132014,OTT,1630.5833333333333,6,8,7,15,21,14,0,0,0,117,210,180,56,6,14,1533,1676,1332,1225,55,59,0,30198138.634999998
MARC.STAAL,20132014,NYR,2023.6333333333334,4,5,7,12,16,9,1,1,0,119,275,115,99,10,15,1772,1849,1595,1441,58,58,1,30198148.215
MARCEL.GOC,20132014,FLA,1053.2,11,4,8,12,23,15,576,1090,514,105,210,103,52,9,10,881,954,729,652,27,34,0.5284403669724771,30198107.78
MARCEL.GOC,20132014,PIT,259.18333333333334,0,0,3,3,3,0,137,237,100,21,29,32,6,2,4,164,273,144,176,5,4,0.5780590717299579,30198044.075
MARCO.SCANDELLA,20132014,MIN,1708.8000000000002,5,5,10,15,20,10,0,0,0,99,231,91,85,7,10,1361,1539,1226,1183,52,38,0,30198130.119999997
MARCUS.FOLIGNO,20132014,BUF,1114.6166666666668,7,6,6,12,19,13,145,299,154,79,131,206,21,15,23,854,1087,693,928,23,38,0.48494983277591974,30198141.4
MARCUS.JOHANSSON,20132014,WSH,1403.0666666666666,8,28,8,36,44,36,95,274,179,107,172,49,33,15,2,1479,1185,955,1020,35,50,0.3467153284671533,30198151.45
MARCUS.KRUGER,20132014,CHI,1421.2666666666669,9,15,8,23,32,24,514,911,397,119,192,30,34,15,21,1010,1440,930,912,39,41,0.5642151481888035,30198139.46
MAREK.ZIDLICKY,20132014,N.J,1753.6333333333332,12,15,14,29,41,27,0,0,0,128,259,124,81,12,31,1568,1152,1142,1005,44,46,0,30198124.77
MARIAN.GABORIK,20132014,CBJ,361.06666666666666,6,3,5,8,14,9,0,0,0,47,86,5,22,3,3,364,295,248,262,14,9,0,30198051.555
MARIAN.GABORIK,20132014,L.A,798.5,19,12,7,19,38,31,0,2,2,134,216,25,31,8,5,939,564,652,515,34,19,0,30198083.955
MARIAN.HOSSA,20132014,CHI,1703.5833333333335,32,24,18,42,74,56,1,3,2,317,530,63,139,10,14,1788,1350,1349,1054,61,46,0.3333333333333333,30198136.740000002
MARK.ARCOBELLO,20132014,EDM,618.0166666666667,4,7,6,13,17,11,206,404,198,70,127,78,28,11,4,534,633,446,478,17,20,0.5099009900990099,30198082.799999997
MARK.BARBERIO,20132014,T.B,732.3833333333334,5,0,5,5,10,5,0,0,0,55,126,29,49,0,17,704,643,652,581,31,22,0,30198072.725
MARK.BOROWIECKI,20132014,OTT,163.58333333333334,1,0,0,0,1,1,0,0,0,6,15,41,8,9,14,124,158,118,128,3,6,0,30198035.840000004
MARK.CUNDARI,20132014,CGY,43.11666666666666,0,0,0,0,0,0,0,0,0,6,10,10,2,0,0,41,45,41,45,0,4,0,30198025.7
MARK.FAYNE,20132014,N.J,1318.4166666666667,4,3,3,6,10,7,0,0,0,88,188,77,68,4,15,995,986,934,755,37,45,0,30198083.165
MARK.FISTRIC,20132014,ANA,590.9166666666667,0,3,2,5,5,3,0,0,0,25,53,175,14,4,17,473,616,442,477,21,16,0,30198070.84
MARK.FRASER,20132014,EDM,356.48333333333335,1,0,0,0,1,1,0,0,0,5,21,52,6,6,13,265,421,256,332,9,16,0,30198058.71
MARK.FRASER,20132014,TOR,289.08333333333337,0,1,0,1,1,1,0,0,0,6,16,66,8,5,12,205,369,198,278,5,13,0,30198053.549999997
MARK.GIORDANO,20132014,CGY,1614.9666666666667,14,14,18,32,46,28,0,0,0,180,403,73,149,20,29,1531,1294,1041,908,47,40,0,30198108.15
MARK.LETESTU,20132014,CBJ,1305.7166666666667,13,19,3,22,35,32,409,791,382,138,228,76,52,5,11,1063,1227,753,782,26,32,0.5170670037926675,30198132.335
MARK.PYSYK,20132014,BUF,863.3666666666666,1,1,4,5,6,2,0,0,0,51,109,37,31,5,7,663,863,531,626,18,28,0,30198086.200000003
MARK.SCHEIFELE,20132014,WPG,1030.5666666666666,13,10,11,21,34,23,331,785,454,100,183,63,38,20,7,1046,912,786,845,38,35,0.42165605095541403,30198138.115000002
MARK.STONE,20132014,OTT,274.06666666666666,4,3,1,4,8,7,1,1,0,36,72,10,11,1,2,341,214,273,198,10,6,1,30198040.525
MARK.STREIT,20132014,PHI,1832.5500000000002,11,19,17,36,47,30,0,0,0,125,290,44,106,16,21,1954,1533,1390,1368,55,50,0,30198161.535
MARK.STUART,20132014,WPG,1285.8166666666666,2,3,6,9,11,5,0,0,0,73,152,229,51,21,36,1061,1470,990,1087,43,37,0,30198133.21
MARK.VAN GUILDER,20132014,NSH,8.45,0,0,0,0,0,0,0,0,0,0,0,0,0,0,0,4,4,4,4,0,0,0,15099010.9
MARKUS.GRANLUND,20132014,CGY,84.58333333333334,2,1,0,1,3,3,28,54,26,9,12,3,1,1,0,58,66,44,56,3,2,0.5185185185185185,30198030.03
MARTIN.ERAT,20132014,ARI,246.06666666666666,2,2,1,3,5,4,1,3,2,7,20,28,4,1,3,196,180,177,151,7,2,0.3333333333333333,30198036.625
MARTIN.ERAT,20132014,WSH,781.0166666666667,1,12,11,23,24,13,96,210,114,46,91,47,17,9,11,692,721,541,565,23,24,0.45714285714285713,30198089.604999997
MARTIN.HANZAL,20132014,ARI,1214.3166666666666,15,17,7,24,39,32,597,1097,500,169,267,200,36,27,34,1264,1068,829,828,30,34,0.544211485870556,30198147.075
MARTIN.MARINCIN,20132014,EDM,843.1666666666667,0,3,3,6,6,3,0,0,0,27,75,17,29,4,8,675,884,601,660,20,23,0,30198087.064999998
MARTIN.ST PIERRE,20132014,MTL,9.883333333333333,0,0,0,0,0,0,2,3,1,0,1,1,0,0,0,7,12,5,11,0,0,0.6666666666666666,15099011.93
MARTIN.ST. LOUIS,20132014,NYR,832.95,9,10,4,14,23,19,2,9,7,92,167,19,40,12,3,841,743,544,592,19,19,0.2222222222222222,30198091.35
MARTIN.ST. LOUIS,20132014,T.B,1344.8166666666666,29,18,14,32,61,47,67,160,93,167,297,15,57,12,3,1295,1146,898,900,50,34,0.41875,30198139.2
MARTY.HAVLAT,20132014,S.J,718.5666666666666,12,8,2,10,22,20,0,4,4,73,139,9,29,10,4,748,626,559,564,29,19,0,30198086.45
MASON.RAYMOND,20132014,TOR,1422.1666666666665,19,16,9,25,44,35,7,16,9,178,299,38,70,17,10,1288,1478,981,1234,42,47,0.4375,30198173.975
MATHEW.DUMBA,20132014,MIN,114.71666666666667,1,0,1,1,2,1,0,0,0,9,22,5,7,2,1,115,75,87,72,1,2,0,30198027.645000003
MATHIEU.PERREAULT,20132014,ANA,1095.5,20,17,11,28,48,37,496,967,471,135,233,106,59,23,23,1198,878,825,803,41,30,0.5129265770423992,30198138.395
MATS.ZUCCARELLO,20132014,NYR,1761.6333333333334,24,33,15,48,72,57,4,11,7,222,404,170,94,42,25,1878,1351,1261,1121,63,44,0.36363636363636365,30198154.205
MATT.BARTKOWSKI,20132014,BOS,1413.1333333333334,0,7,9,16,16,7,0,0,0,103,227,180,83,5,20,1292,1280,1213,1031,55,35,0,30198107.025
MATT.BELESKEY,20132014,ANA,756.7333333333333,11,10,7,17,28,21,10,21,11,125,236,156,56,14,24,778,699,604,624,28,20,0.47619047619047616,30198095.965
MATT.CALVERT,20132014,CBJ,1007.2833333333333,11,10,6,16,27,21,6,12,6,103,178,130,43,22,21,938,858,714,667,32,30,0.5,30198096.509999998
MATT.CAREY,20132014,CHI,19.266666666666666,1,0,0,0,1,1,9,20,11,1,2,2,0,0,0,17,18,15,18,1,2,0.45,15099013.51
MATT.CARKNER,20132014,NYI,635.4666666666667,0,2,0,2,2,2,0,0,0,50,90,58,24,23,40,616,642,601,611,17,25,0,30198086.28
MATT.CARLE,20132014,T.B,1920.0333333333333,3,11,14,25,28,14,0,1,1,120,228,50,64,8,14,1622,1909,1307,1442,59,53,0,30198170.93
MATT.COOKE,20132014,MIN,1359.2333333333333,10,16,5,21,31,26,12,30,18,108,197,222,52,24,25,884,1320,822,967,36,29,0.4,30198138.095
MATT.CULLEN,20132014,NSH,1193.1833333333334,10,19,10,29,39,29,438,772,334,134,230,18,57,12,15,1145,985,873,859,46,41,0.5673575129533679,30198130.340000004
MATT.D'AGOSTINI,20132014,BUF,755.8833333333333,5,1,5,6,11,6,5,15,10,98,179,48,52,15,11,647,681,512,602,10,24,0.3333333333333333,30198087.975
MATT.D'AGOSTINI,20132014,PIT,90.68333333333334,0,1,0,1,1,1,0,0,0,11,20,7,3,1,2,73,51,69,50,1,2,0,30198025.86
MATT.DONOVAN,20132014,NYI,939.5999999999999,2,4,10,14,16,6,0,0,0,86,165,68,45,3,13,1010,808,782,670,28,39,0,30198082.08
MATT.DUCHENE,20132014,COL,1353.75,23,31,19,50,73,54,544,1083,539,217,380,54,86,31,8,1451,1178,1011,1053,54,52,0.5023084025854109,30198175.845
MATT.DUMBA,20132014,MIN,47.11666666666666,0,0,0,0,0,0,0,0,0,3,9,4,5,0,0,47,37,38,37,0,3,0,30198024.05
MATT.ELLIS,20132014,BUF,473.5666666666667,4,2,0,2,6,6,69,166,97,70,102,36,12,1,2,304,495,281,378,6,14,0.41566265060240964,30198072.82
MATT.FRASER,20132014,BOS,180.48333333333335,3,1,0,1,4,4,1,2,1,17,32,14,7,3,2,179,145,173,143,8,5,0.5,30198035.42
MATT.FRATTIN,20132014,CBJ,49.45,0,0,1,1,1,0,0,0,0,1,4,7,1,2,0,41,41,33,41,2,0,0,30198025.195
MATT.FRATTIN,20132014,L.A,479.08333333333337,2,4,0,4,6,6,2,4,2,60,104,78,19,11,4,462,354,392,341,9,15,0.5,30198055.740000002
MATT.GILROY,20132014,FLA,260.0333333333333,1,1,0,1,2,2,0,0,0,27,48,5,7,1,2,225,224,193,205,8,9,0,30198042.759999998
MATT.GREENE,20132014,L.A,892.9666666666667,2,4,3,7,9,6,0,1,1,51,127,180,37,6,25,850,827,778,570,29,23,0,30198067.935000002
MATT.HALISCHUK,20132014,WPG,521.4333333333334,5,4,1,5,10,9,2,4,2,55,94,19,15,6,3,389,550,370,471,15,19,0.5,30198077.765
MATT.HENDRICKS,20132014,EDM,472.59999999999997,3,0,0,0,3,3,20,37,17,49,81,88,13,19,20,277,550,244,352,5,11,0.5405405405405406,30198067.29
MATT.HENDRICKS,20132014,NSH,508.23333333333335,2,1,1,2,4,3,14,26,12,53,79,92,15,9,17,283,560,261,357,4,9,0.5384615384615384,30198066.424999997
MATT.HUNWICK,20132014,COL,17.45,0,0,0,0,0,0,0,0,0,1,3,1,2,0,0,18,15,18,15,1,1,0,15099011.45
MATT.IRWIN,20132014,S.J,1206.0833333333333,3,9,6,15,18,12,0,1,1,151,305,69,102,7,12,1297,1109,1008,980,37,33,0,30198113.72
MATT.KASSIAN,20132014,OTT,146.45,1,1,0,1,2,2,0,0,0,12,19,52,3,12,13,131,149,130,146,3,5,0,30198039.42
MATT.LINDBLAD,20132014,BOS,23.516666666666666,0,0,0,0,0,0,2,2,0,0,0,0,0,0,0,11,25,10,23,0,0,1,30198023.93
MATT.MARTIN,20132014,NYI,940.0166666666667,8,5,1,6,14,13,3,9,6,120,187,359,40,27,25,739,968,679,837,24,31,0.3333333333333333,30198121.715
MATT.MOULSON,20132014,BUF,824.4333333333334,11,12,6,18,29,23,1,4,3,105,180,31,29,9,9,822,748,550,669,25,26,0.25,30198107.33
MATT.MOULSON,20132014,MIN,479.06666666666666,7,6,3,9,16,13,2,3,1,64,102,20,16,7,6,470,304,341,273,17,10,0.6666666666666666,30198052.575
MATT.MOULSON,20132014,NYI,194.18333333333334,6,1,2,3,9,7,0,3,3,28,44,4,10,3,3,196,165,130,161,5,2,0,30198043.33
MATT.NIETO,20132014,S.J,804.2166666666667,10,7,6,13,23,17,3,11,8,105,178,15,35,11,6,790,747,686,665,24,25,0.2727272727272727,30198095.53
MATT.NISKANEN,20132014,PIT,1983.4,12,14,26,40,52,26,0,0,0,186,424,153,148,8,28,2057,1486,1429,1244,80,49,0,30198133.58
MATT.PELECH,20132014,S.J,23.566666666666666,1,0,0,0,1,1,0,0,0,3,5,7,1,2,4,18,20,18,19,1,0,0,30198024.12
MATT.READ,20132014,PHI,1543.3666666666668,23,10,10,20,43,33,13,31,18,162,311,91,70,16,10,1301,1496,994,1017,38,46,0.41935483870967744,30198140.53
MATT.STAJAN,20132014,CGY,1157.5833333333335,14,17,2,19,33,31,526,1094,568,70,129,74,27,19,21,946,1206,824,907,34,49,0.48080438756855576,30198155.98
MATT.TAORMINA,20132014,T.B,93.78333333333333,0,0,0,0,0,0,0,0,0,6,13,5,5,0,0,94,63,69,53,1,1,0,30198024.9
MATTHEW.NIETO,20132014,S.J,225.23333333333335,2,3,1,4,6,5,0,0,0,33,48,2,9,3,1,246,209,234,184,6,7,0,30198039.605
MATTIAS.EKHOLM,20132014,NSH,1042.6333333333334,1,4,4,8,9,5,0,0,0,58,124,42,46,5,5,808,897,757,753,34,41,0,30198091
MATTIAS.TEDENBY,20132014,N.J,150.35,1,0,0,0,1,1,0,2,2,9,18,16,5,3,4,98,111,98,109,2,10,0,30198033.28
MAX.PACIORETTY,20132014,MTL,1678.2166666666667,44,21,6,27,71,65,7,14,7,323,567,108,111,23,19,1809,1398,1203,1151,52,41,0.5,30198171.36
MAX.REINHART,20132014,CGY,85.61666666666667,0,1,1,2,2,1,2,9,7,7,20,1,7,0,1,75,82,66,80,3,2,0.2222222222222222,30198029.655
MAX.TALBOT,20132014,COL,1262.3333333333333,7,10,7,17,24,17,87,211,124,118,186,121,43,16,17,843,1474,779,1057,32,31,0.41232227488151657,30198154.215
MAX.TALBOT,20132014,PHI,166.46666666666667,1,0,1,1,2,1,15,25,10,13,23,11,5,2,0,147,197,133,128,4,3,0.6,30198033.995
MAXIM.LAPIERRE,20132014,STL,891.5666666666666,10,5,1,6,16,15,326,659,333,86,147,97,25,13,23,577,858,548,678,26,26,0.4946889226100152,30198118.744999997
MAXIME.FORTUNUS,20132014,DAL,16.283333333333335,0,0,1,1,1,0,0,0,0,0,2,0,1,0,0,13,19,13,17,1,0,0,15099012.175
MICHAEL.BOURNIVAL,20132014,MTL,719.4833333333333,6,4,3,7,13,10,27,57,30,83,136,88,27,6,9,560,753,511,684,17,29,0.47368421052631576,30198104.865000002
MICHAËL.BOURNIVAL,20132014,MTL,43.266666666666666,1,1,0,1,2,2,9,17,8,11,16,4,2,0,0,57,38,55,30,4,0,0.5294117647058824,30198023.96
MICHAEL.CHAPUT,20132014,CBJ,151.2,0,1,0,1,1,1,42,98,56,6,16,33,7,3,1,87,154,87,153,5,5,0.42857142857142855,30198041.21
MICHAEL.DEL ZOTTO,20132014,NSH,407.45,1,4,0,4,5,5,0,1,1,26,56,28,19,2,4,351,367,325,335,14,17,0,30198054.92
MICHAEL.DEL ZOTTO,20132014,NYR,745.4666666666667,2,6,3,9,11,8,0,0,0,64,143,50,58,4,5,806,656,613,579,20,22,0,30198074.415
MICHAEL.FROLIK,20132014,WPG,1350.5166666666667,15,16,9,25,40,31,43,68,25,189,344,41,85,12,6,1353,1250,1166,1039,55,46,0.6323529411764706,30198128.814999998
MICHAEL.GRABNER,20132014,NYI,908.3666666666667,12,10,4,14,26,22,7,15,8,137,214,68,39,13,6,795,868,648,627,25,39,0.4666666666666667,30198095.46
MICHAEL.KOSTKA,20132014,CHI,129.96666666666667,2,0,1,1,3,2,0,0,0,18,30,14,9,1,4,122,115,112,104,7,4,0,30198031.585
MICHAEL.KOSTKA,20132014,T.B,352.75,2,5,3,8,10,7,0,0,0,32,62,16,21,2,1,321,287,272,256,18,7,0,30198046.095
MICHAEL.LATTA,20132014,WSH,131.08333333333334,1,3,0,3,4,4,60,114,54,6,12,14,3,6,3,85,118,82,87,4,3,0.5263157894736842,30198034.16
MICHAEL.RAFFL,20132014,PHI,971.5,9,11,3,14,23,20,54,97,43,107,201,131,42,18,14,830,900,770,697,29,31,0.5567010309278351,30198098.215
MICHAEL.RYDER,20132014,N.J,1294.15,18,6,10,16,34,24,4,12,8,166,290,51,66,9,9,1178,826,863,755,30,33,0.3333333333333333,30198103.450000003
MICHAEL.STONE,20132014,ARI,1274.45,8,8,5,13,21,16,0,0,0,105,238,153,83,8,20,1129,1213,941,942,37,41,0,30198115.955
MICHAEL.ZALEWSKI,20132014,VAN,24.25,0,0,1,1,1,0,0,0,0,2,5,0,1,0,0,20,16,19,15,2,0,0,30198022.025
MICHAL.HANDZUS,20132014,CHI,1056.8166666666666,6,5,8,13,19,11,449,917,468,59,90,48,20,11,13,737,1176,689,738,21,33,0.48964013086150493,30198122.57
MICHAL.ROZSIVAL,20132014,CHI,997.9833333333333,2,6,6,12,14,8,0,0,0,52,104,98,35,6,18,925,767,857,650,37,36,0,30198075.36
MIKA.ZIBANEJAD,20132014,OTT,986.6333333333334,16,13,3,16,32,29,183,396,213,153,268,118,38,17,9,1098,820,826,712,30,39,0.4621212121212121,30198112.865000002
MIKAEL.BACKLUND,20132014,CGY,1408.6833333333334,18,9,12,21,39,27,628,1320,692,178,318,64,74,20,15,1314,1195,975,905,38,36,0.47575757575757577,30198149.32
MIKAEL.GRANLUND,20132014,MIN,1325.75,12,17,19,36,48,29,507,958,451,138,231,52,50,19,10,1199,1083,877,909,39,31,0.5292275574112735,30198145.395000003
MIKAEL.SAMUELSSON,20132014,DET,269.16666666666663,1,2,0,2,3,3,0,2,2,36,56,13,10,5,4,252,171,153,150,2,5,0,30198038.4
MIKE.BLUNDEN,20132014,MTL,42.93333333333334,0,0,0,0,0,0,0,0,0,2,4,16,1,2,1,20,61,20,57,1,3,0,30198028.520000003
MIKE.BROWN,20132014,EDM,46.56666666666666,0,0,0,0,0,0,0,0,0,1,5,25,3,5,4,20,42,20,41,1,0,0,30198026.25
MIKE.BROWN,20132014,S.J,395.15,3,3,0,3,6,6,2,3,1,48,82,146,15,24,25,308,349,295,337,12,20,0.6666666666666666,30198062.92
MIKE.CAMMALLERI,20132014,CGY,1250.2333333333333,26,12,7,19,45,38,88,191,103,191,342,26,86,15,13,1258,959,867,839,37,44,0.4607329842931937,30198126.295
MIKE.FISHER,20132014,NSH,1481.7,20,16,12,28,48,36,594,1143,549,177,280,144,54,9,22,1330,1353,918,1063,48,52,0.5196850393700787,30198176.7
MIKE.GREEN,20132014,WSH,1591.0833333333333,9,20,9,29,38,29,0,0,0,172,368,62,114,15,28,1624,1283,1177,1107,43,53,0,30198135.575
MIKE.HALMO,20132014,NYI,189.83333333333331,1,0,0,0,1,1,4,20,16,25,43,52,13,9,8,162,144,158,139,1,2,0.2,30198035.85
MIKE.HOFFMAN,20132014,OTT,329.6333333333333,3,2,1,3,6,5,6,9,3,61,118,18,31,4,0,415,260,296,237,6,6,0.6666666666666666,30198042.655
MIKE.KOMISAREK,20132014,CAR,374.28333333333336,0,1,2,3,3,1,0,0,0,20,51,70,24,5,7,344,374,324,343,10,15,0,30198053.95
MIKE.MOTTAU,20132014,FLA,101.31666666666668,0,0,0,0,0,0,0,0,0,1,5,3,3,0,2,64,113,54,82,2,6,0,30198030.200000003
MIKE.RIBEIRO,20132014,ARI,1439.4833333333333,16,17,14,31,47,33,390,902,512,110,176,71,38,13,21,1682,1123,1094,969,39,38,0.43237250554323725,30198152.18
MIKE.RICHARDS,20132014,L.A,1796.3,14,23,14,37,51,37,668,1239,571,199,367,115,69,26,20,1918,1473,1242,1058,36,54,0.5391444713478611,30198160.43
MIKE.RUPP,20132014,MIN,80.71666666666667,0,1,0,1,1,1,0,3,3,6,11,13,4,1,6,56,63,55,61,1,0,0,30198028.56
MIKE.SANTORELLI,20132014,VAN,909.6666666666667,10,10,8,18,28,20,215,418,203,91,185,23,44,9,3,855,886,723,704,32,22,0.5143540669856459,30198105.240000002
MIKE.SISLO,20132014,N.J,123.95000000000002,0,0,0,0,0,0,5,6,1,20,30,19,4,1,1,107,82,104,69,0,1,0.8333333333333334,30198026.71
MIKE.WEAVER,20132014,FLA,1033.1333333333332,0,1,4,5,5,1,1,1,0,44,95,101,24,13,10,790,1013,729,698,26,37,1,30198086.42
MIKE.WEAVER,20132014,MTL,562.1666666666666,2,1,7,8,10,3,0,0,0,13,31,37,7,7,7,367,675,334,468,24,9,0,30198074.095
MIKE.WEBER,20132014,BUF,1211.5666666666666,1,1,6,7,8,2,0,0,0,47,135,208,54,11,28,817,1398,772,1124,23,54,0,30198147.81
MIKHAIL.GRABOVSKI,20132014,WSH,913.6166666666667,13,16,6,22,35,29,346,641,295,81,133,19,34,13,10,952,807,766,733,35,25,0.5397815912636506,30198117.62
MIKHAIL.GRIGORENKO,20132014,BUF,205.73333333333335,2,1,0,1,3,3,52,101,49,20,34,6,8,0,1,143,199,124,191,5,7,0.5148514851485149,30198046.53
MIKKEL.BOEDKER,20132014,ARI,1428.0166666666664,19,16,16,32,51,35,3,7,4,166,284,105,63,21,9,1376,1197,1001,1064,38,42,0.42857142857142855,30198148.73
MIKKO.KOIVU,20132014,MIN,1627.5666666666666,12,33,16,49,61,45,903,1631,728,176,346,50,89,16,17,1653,1163,1078,827,40,38,0.5536480686695279,30198138.43
MILAN.LUCIC,20132014,BOS,1611.4166666666665,28,23,15,38,66,51,74,150,76,179,325,296,74,24,30,1881,1322,1389,1209,62,34,0.49333333333333335,30198162.625
MILAN.MICHALEK,20132014,OTT,1441.1166666666668,17,10,12,22,39,27,6,14,8,169,298,86,63,13,18,1498,1375,1101,1030,49,67,0.42857142857142855,30198133.57
MITCH.CALLAHAN,20132014,DET,9.016666666666667,0,0,0,0,0,0,0,0,0,0,3,2,2,0,0,7,4,7,4,0,0,0,15099010.45
MORGAN.RIELLY,20132014,TOR,1287.3000000000002,2,8,16,24,26,10,0,0,0,96,214,96,72,5,6,1242,1314,977,1215,46,53,0,30198149.45
NAIL.YAKUPOV,20132014,EDM,901.7833333333333,11,9,4,13,24,20,0,0,0,122,217,64,50,20,12,838,836,626,773,26,50,0,30198115.3
NATE.GUENIN,20132014,COL,1286.8833333333332,1,3,5,8,9,4,0,0,0,55,109,137,35,7,16,904,1469,830,1022,36,35,0,30198130.095
NATE.PROSSER,20132014,MIN,895.15,2,0,6,6,8,2,0,0,0,37,96,27,36,11,17,642,836,611,682,30,26,0,30198089.21
NATE.SCHMIDT,20132014,WSH,542.1333333333333,2,1,2,3,5,3,0,0,0,41,77,18,23,8,3,490,516,460,447,23,18,0,30198062.83
NATE.THOMPSON,20132014,T.B,1088.4,9,5,2,7,16,14,526,1022,496,108,168,125,28,9,11,857,1103,806,782,26,27,0.5146771037181996,30198125.78
NATHAN.BEAULIEU,20132014,MTL,300.25,0,2,2,4,4,2,0,0,0,19,57,10,25,6,6,286,289,246,274,13,3,0,30198047.259999998
NATHAN.GERBE,20132014,CAR,1328.5,16,7,8,15,31,23,2,6,4,221,368,53,70,22,18,1392,1174,1080,1012,28,33,0.3333333333333333,30198133.9
NATHAN.HORTON,20132014,CBJ,556.4833333333333,4,8,6,14,18,12,1,1,0,48,94,53,26,3,12,608,459,460,420,21,19,1,30198065.82
NATHAN.MACKINNON,20132014,COL,1566.15,26,26,21,47,73,52,205,479,274,258,419,58,72,32,15,1572,1450,1157,1312,61,45,0.4279749478079332,30198201.195
NAZEM.KADRI,20132014,TOR,1356.4333333333334,20,19,11,30,50,39,509,1126,617,148,310,141,85,42,23,1379,1394,1032,1244,45,51,0.45204262877442275,30198198.805
NICK.BJUGSTAD,20132014,FLA,1232.65,16,13,8,21,37,29,549,1122,573,184,300,117,58,9,8,1216,1054,947,912,43,49,0.4893048128342246,30198147.9
NICK.BONINO,20132014,ANA,1480.25,26,17,14,31,57,43,709,1469,760,181,305,42,66,15,15,1496,1411,919,957,49,29,0.48264125255275697,30198172.310000002
NICK.DRAZENOVIC,20132014,PIT,10.3,0,0,0,0,0,0,3,4,1,3,3,1,0,0,1,9,4,6,4,0,1,0.75,15099011.12
NICK.FOLIGNO,20132014,CBJ,1183.8333333333335,20,12,9,21,41,32,6,13,7,114,196,230,34,31,33,1089,933,865,845,48,39,0.46153846153846156,30198124.725
NICK.HOLDEN,20132014,COL,1163.85,13,6,9,15,28,19,0,0,0,78,170,142,55,10,14,1036,1134,799,900,40,32,0,30198120.975
NICK.JOHNSON,20132014,BOS,87.33333333333334,0,0,0,0,0,0,0,0,0,10,14,3,2,2,0,62,73,62,73,0,4,0,30198029.07
NICK.LEDDY,20132014,CHI,1626.4499999999998,8,12,16,28,36,20,0,0,0,141,254,65,77,9,7,1675,1122,1327,1050,58,51,0,30198113.490000002
NICK.SCHULTZ,20132014,CBJ,126.61666666666667,0,1,0,1,1,1,0,0,0,8,15,11,3,1,2,104,111,104,102,2,4,0,30198031.61
NICK.SCHULTZ,20132014,EDM,1018.3666666666667,0,2,1,3,3,2,0,0,0,27,60,64,19,7,12,654,1197,618,894,21,33,0,30198122.595
NICK.SPALING,20132014,NSH,1137.4166666666667,13,14,5,19,32,27,88,167,79,85,141,42,32,7,7,887,1109,735,877,36,36,0.5269461077844312,30198131.215
NICKLAS.BACKSTROM,20132014,WSH,1624.0833333333335,18,24,37,61,79,42,713,1414,701,196,336,89,66,21,27,1835,1448,1087,1116,41,57,0.5042432814710043,30198188.555
NICKLAS.GROSSMANN,20132014,PHI,1556.4499999999998,1,6,7,13,14,7,0,0,0,71,186,193,61,14,25,1240,1648,1147,1270,40,52,0,30198150.965000004
NICKLAS.JENSEN,20132014,VAN,265.85,3,3,0,3,6,6,0,1,1,30,62,7,13,1,5,306,192,243,177,9,9,0,30198038.16
NICOLAS.DESCHAMPS,20132014,WSH,20.45,0,0,0,0,0,0,0,0,0,2,3,1,1,0,0,13,23,13,23,0,1,0,30198023.75
NICOLAS.DESLAURIERS,20132014,BUF,223.41666666666666,1,0,0,0,1,1,0,1,1,30,49,51,9,4,6,202,192,153,181,1,8,0,30198042.189999998
NIKITA.KUCHEROV,20132014,T.B,705.1833333333334,10,7,2,9,19,17,1,1,0,105,192,16,33,10,8,738,575,627,534,20,14,1,30198079.34
NIKITA.NIKITIN,20132014,CBJ,1211.3000000000002,2,6,4,10,12,8,0,0,0,103,214,91,75,4,11,1078,1110,956,986,42,32,0,30198115.39
NIKITA.ZADOROV,20132014,BUF,120.2,1,0,0,0,1,1,0,0,0,4,9,25,3,0,2,67,105,63,94,2,5,0,30198032.4
NIKLAS.HJALMARSSON,20132014,CHI,2159.9,4,8,15,23,27,12,0,0,0,107,243,48,89,6,25,1673,2013,1525,1412,65,66,0,30198150.935000002
NIKLAS.KRONWALL,20132014,DET,2050.55,9,13,25,38,47,22,0,0,0,119,264,104,82,7,22,1925,1728,1253,1146,61,58,0,30198133.445
NIKOLAY.KULEMIN,20132014,TOR,1135.1,9,7,4,11,20,16,38,108,70,81,149,153,34,11,12,738,1346,700,993,28,35,0.35185185185185186,30198145.18
NINO.NIEDERREITER,20132014,MIN,1332.3166666666666,17,15,10,25,42,32,7,27,20,165,262,215,44,19,25,1158,1007,977,964,44,34,0.25925925925925924,30198137.57
NOLAN.YONKMAN,20132014,ANA,29.78333333333333,0,0,1,1,1,0,0,0,0,3,6,7,1,0,0,31,34,31,34,3,4,0,30198024.175
OLIVER.EKMAN-LARSSON,20132014,ARI,2070.8999999999996,15,12,17,29,44,27,0,1,1,199,443,134,158,22,25,1920,1764,1145,1189,43,39,0,30198144.295
OLLI.JOKINEN,20132014,WPG,1395.9166666666665,18,19,5,24,42,37,612,1330,718,171,293,120,64,10,27,1380,1257,1060,1090,40,49,0.46015037593984964,30198181.805
OLLI.MAATTA,20132014,PIT,1677.8999999999999,9,14,10,24,33,23,0,0,0,138,282,49,88,14,7,1553,1462,1276,1208,59,52,0,30198139.19
ONDREJ.PALAT,20132014,T.B,1514.9166666666665,25,27,10,37,62,52,5,37,32,171,298,156,59,18,10,1363,1426,1047,1025,58,33,0.13513513513513514,30198149.729999997
OSCAR.KLEFBOM,20132014,EDM,268.54999999999995,1,1,1,2,3,2,0,0,0,14,33,6,13,2,0,209,269,188,239,8,15,0,30198046.345
P.A..PARENTEAU,20132014,COL,1057.4833333333333,15,13,8,21,36,28,2,15,13,127,206,35,39,11,16,1129,912,810,836,39,33,0.13333333333333333,30198121.94
P.K..SUBBAN,20132014,MTL,2484.9166666666665,15,25,26,51,66,40,0,0,0,254,570,171,214,38,51,2695,2047,1713,1742,71,79,0,30198200.83
PASCAL.DUPUIS,20132014,PIT,690.2,7,11,2,13,20,18,2,6,4,97,161,68,30,7,4,630,662,590,506,30,20,0.3333333333333333,30198075.2
PASCAL.PELLETIER,20132014,VAN,26.833333333333332,0,0,0,0,0,0,1,4,3,1,2,3,1,0,0,16,34,16,34,0,0,0.25,15099014.84
PATRIC.HORNQVIST,20132014,NSH,1281.25,22,20,11,31,53,42,0,6,6,248,384,77,55,28,14,1386,1022,1000,960,51,49,0,30198141.405
PATRICE.BERGERON,20132014,BOS,1675.6166666666666,33,21,17,38,71,54,1188,2034,846,283,504,69,114,20,21,1813,1260,1346,858,62,33,0.584070796460177,30198139.845
PATRICE.CORMIER,20132014,WPG,62.7,0,1,1,2,2,1,26,46,20,4,8,20,4,2,2,45,55,44,53,2,0,0.5652173913043478,30198027.735
PATRICK.BORDELEAU,20132014,COL,604.8,6,3,2,5,11,9,2,4,2,39,71,188,16,20,26,392,539,385,536,14,16,0.5,30198089.78
PATRICK.DWYER,20132014,CAR,1098.8,8,8,5,13,21,16,9,24,15,134,234,107,44,20,7,898,1157,835,886,21,26,0.375,30198121.384999998
PATRICK.EAVES,20132014,DET,288.9166666666667,2,0,3,3,5,2,7,15,8,51,83,38,13,2,1,268,234,208,203,6,10,0.4666666666666667,30198042.875
PATRICK.EAVES,20132014,NSH,48.86666666666667,0,0,0,0,0,0,0,0,0,2,10,5,5,1,0,41,46,39,31,0,2,0,30198023.06
PATRICK.HOLLAND,20132014,MTL,38.150000000000006,0,0,0,0,0,0,1,2,1,2,2,2,0,0,0,13,52,13,45,0,0,0.5,30198027.24
PATRICK.KALETA,20132014,BUF,41.71666666666667,0,0,0,0,0,0,1,1,0,0,1,11,0,1,1,13,36,11,23,0,1,1,30198024.05
PATRICK.KANE,20132014,CHI,1759.05,35,31,21,52,87,66,4,10,6,282,494,20,112,22,15,1986,1272,1359,1123,69,49,0.4,30198154.305
PATRICK.MARLEAU,20132014,S.J,1823.5833333333333,36,26,15,41,77,62,170,327,157,310,526,104,106,12,10,2194,1618,1324,1164,59,55,0.5198776758409785,30198168.545
PATRICK.MAROON,20132014,ANA,933.05,13,16,7,23,36,29,7,17,10,114,198,153,39,30,28,1026,700,706,654,39,25,0.4117647058823529,30198101.155
PATRICK.SHARP,20132014,CHI,1901.0666666666666,39,29,20,49,88,68,99,189,90,373,684,89,179,22,21,2206,1409,1556,1260,79,61,0.5238095238095238,30198163.78
PATRICK.WEY,20132014,WSH,131.26666666666665,0,1,2,3,3,1,0,0,0,5,15,11,9,2,1,97,136,96,111,5,6,0,30198031.869999997
PATRICK.WIERCIOCH,20132014,OTT,867.5,4,10,8,18,22,14,0,2,2,97,215,54,73,4,10,991,748,720,639,28,25,0,30198081.090000004
PATRIK.BERGLUND,20132014,STL,1321.7833333333333,14,5,12,17,31,19,381,801,420,153,259,98,61,8,19,1240,1074,989,820,40,32,0.4756554307116105,30198120.619999997
PATRIK.ELIAS,20132014,N.J,1162.1666666666665,18,19,16,35,53,37,276,677,401,116,193,26,48,11,10,999,860,666,557,30,39,0.4076809453471196,30198108.5
PATRIK.NEMETH,20132014,DAL,186.5,0,0,0,0,0,0,0,0,0,4,13,33,6,2,5,162,168,144,139,3,8,0,30198034.27
PAUL.BISSONNETTE,20132014,ARI,185.13333333333333,2,3,3,6,8,5,1,3,2,25,38,51,5,9,13,171,155,171,154,10,4,0.3333333333333333,30198039.955
PAUL.BYRON,20132014,CGY,678.8166666666666,7,11,2,13,20,18,7,32,25,46,93,63,25,8,8,582,587,485,475,19,17,0.21875,30198077.259999998
PAUL.CAREY,20132014,COL,88.51666666666667,0,0,0,0,0,0,0,1,1,6,10,12,2,1,0,64,72,60,70,3,2,0,30198028.11
PAUL.GAUSTAD,20132014,NSH,1035.5,10,6,4,10,20,16,696,1200,504,74,110,122,20,10,22,642,1114,581,726,20,32,0.58,30198130.79
PAUL.MARTIN,20132014,PIT,1313.5833333333333,3,7,12,19,22,10,0,0,0,77,168,42,50,9,8,1226,1112,816,750,32,35,0,30198092.39
PAUL.POSTMA,20132014,WPG,322.6166666666667,1,1,1,2,3,2,0,0,0,19,45,20,18,3,4,276,295,238,264,7,7,0,30198047.855
PAUL.RANGER,20132014,TOR,923.45,6,6,2,8,14,12,0,0,0,59,118,115,29,7,19,665,1041,614,834,28,30,0,30198120.369999997
PAUL.STASTNY,20132014,COL,1461.4,30,29,11,40,70,59,733,1369,636,164,268,63,49,14,13,1451,1318,1062,1069,58,46,0.535427319211103,30198184.735
PAVEL.DATSYUK,20132014,DET,1018.0333333333333,20,13,8,21,41,33,500,938,438,137,230,34,53,16,3,1101,719,711,557,34,31,0.5330490405117271,30198102.060000002
PETER.HARROLD,20132014,N.J,616.0166666666667,0,1,2,3,3,1,0,0,0,32,72,17,24,6,6,482,404,402,330,12,12,0,30198048.259999998
PETER.HOLLAND,20132014,ANA,36.36666666666667,1,0,0,0,1,1,12,31,19,3,6,0,1,0,1,25,27,21,27,1,2,0.3870967741935484,15099015.03
PETER.HOLLAND,20132014,TOR,451.6166666666667,5,4,1,5,10,9,170,364,194,40,76,46,21,6,8,383,498,361,480,17,16,0.46703296703296704,30198086.285
PETER.LEBLANC,20132014,WSH,9.433333333333334,0,0,0,0,0,0,0,0,0,0,1,2,0,0,0,4,13,4,13,0,0,0,15099012.25
PETER.REGIN,20132014,CHI,234.41666666666669,2,1,1,2,4,3,65,138,73,20,35,31,7,6,1,189,178,174,167,6,6,0.47101449275362317,30198041.634999998
PETER.REGIN,20132014,NYI,521.15,2,4,1,5,7,6,127,309,182,53,90,24,22,8,5,495,480,434,404,10,21,0.4110032362459547,30198070.085
PETTER.GRANBERG,20132014,TOR,11.766666666666667,0,0,0,0,0,0,0,0,0,0,1,3,0,0,0,4,17,4,17,0,0,0,15099012.85
PHIL.KESSEL,20132014,TOR,1694.6333333333332,37,30,13,43,80,67,2,14,12,305,556,25,151,15,14,1836,1740,1232,1555,68,60,0.14285714285714285,30198221.255000003
PHILIP.LARSEN,20132014,EDM,513.6666666666667,3,3,6,9,12,6,0,0,0,47,97,44,32,2,4,465,480,319,430,12,18,0,30198070.12
PHILIP.SAMUELSSON,20132014,PIT,77.86666666666667,0,0,0,0,0,0,0,0,0,5,10,5,4,0,0,59,68,57,63,0,1,0,30198027.25
PHILIP.VARONE,20132014,BUF,102.66666666666666,1,1,0,1,2,2,26,56,30,15,21,7,2,0,1,94,93,93,92,2,4,0.4642857142857143,30198032.939999998
PIERRE-CEDRIC.LABRIE,20132014,T.B,89.38333333333333,0,0,0,0,0,0,2,2,0,2,7,24,5,2,6,53,81,53,81,0,5,1,30198030.75
PIERRE-LUC.LETOURNEAU-LEBLOND,20132014,PIT,4.566666666666666,0,0,0,0,0,0,0,0,0,1,1,0,0,0,0,2,8,2,8,0,0,0,15099011.65
PIERRE-MARC.BOUCHARD,20132014,NYI,390.5333333333333,4,2,3,5,9,6,3,5,2,51,82,7,19,2,6,423,335,327,315,7,17,0.6,30198055.665
QUINTON.HOWDEN,20132014,FLA,219.5,4,2,0,2,6,6,2,8,6,23,33,32,6,3,5,159,224,149,179,6,7,0.25,30198044.71
RADEK.DVORAK,20132014,CAR,638.4166666666666,4,4,1,5,9,8,6,12,6,52,92,17,21,3,13,451,666,422,564,20,18,0.5,30198088.244999997
RADEK.MARTINEK,20132014,NYI,201.18333333333334,0,1,2,3,3,1,0,0,0,12,40,9,17,0,1,218,198,206,192,13,10,0,30198036.450000003
RADIM.VRBATA,20132014,ARI,1436.55,20,14,17,31,51,34,17,43,26,263,475,67,98,13,10,1589,1202,1063,1013,44,41,0.3953488372093023,30198137.384999998
RADKO.GUDAS,20132014,T.B,1453.6333333333332,3,7,11,18,21,10,0,0,0,116,257,289,87,29,51,1253,1458,1099,1155,51,48,0,30198139.115000002
RAFFI.TORRES,20132014,S.J,115.98333333333332,5,1,2,3,8,6,2,4,2,15,22,34,3,7,7,94,112,86,109,9,1,0.5,30198037.4
RAPHAEL.DIAZ,20132014,MTL,869.1,0,8,3,11,11,8,0,1,1,41,118,20,46,2,6,672,867,555,623,14,19,0,30198085.345
RAPHAEL.DIAZ,20132014,NYR,225.58333333333331,1,1,0,1,2,2,0,0,0,26,45,8,12,2,3,258,156,185,140,7,3,0,30198032.92
RAPHAEL.DIAZ,20132014,VAN,95.83333333333333,1,1,0,1,2,2,0,0,0,9,25,10,8,1,1,124,65,85,57,1,4,0,30198025.810000002
RASMUS.RISTOLAINEN,20132014,BUF,649.9666666666667,2,2,0,2,4,4,0,0,0,52,87,66,19,4,3,496,667,386,566,13,26,0,30198087.39
RAY.WHITNEY,20132014,DAL,1020.6500000000001,9,14,9,23,32,23,2,3,1,127,246,15,62,6,8,1153,780,699,700,21,26,0.6666666666666666,30198100.915
REID.BOUCHER,20132014,N.J,261.1666666666667,2,4,1,5,7,6,1,3,2,27,53,17,11,3,2,232,168,209,160,9,7,0.3333333333333333,30198036.995
REILLY.SMITH,20132014,BOS,1395.1333333333332,24,20,12,32,56,44,0,3,3,170,285,72,55,6,6,1586,948,1258,879,61,33,0,30198110.86
RENE.BOURQUE,20132014,MTL,1142.95,17,5,5,10,27,22,4,10,6,168,308,142,64,18,23,1059,1122,903,1054,34,28,0.4,30198146.564999998
RICH.CLUNE,20132014,NSH,490.3833333333333,3,3,1,4,7,6,0,0,0,29,51,132,13,33,46,337,393,332,374,10,17,0,30198069.555
RICH.PEVERLEY,20132014,DAL,953.9166666666666,7,15,7,22,29,22,348,579,231,122,201,27,38,8,6,966,930,685,700,29,26,0.6010362694300518,30198110.525
RICHARD.PANIK,20132014,T.B,664.7166666666667,3,5,5,10,13,8,3,8,5,60,122,73,26,17,10,571,550,473,515,12,24,0.375,30198079.015
RICK.NASH,20132014,NYR,1541.5833333333335,29,12,8,20,49,41,2,2,0,341,562,56,117,36,18,1798,1310,1269,1099,47,36,1,30198145.39
RICKARD.RAKELL,20132014,ANA,254.83333333333331,1,3,2,5,6,4,125,241,116,24,61,26,15,2,1,249,198,222,189,4,10,0.5186721991701245,30198043.82
RILEY.NASH,20132014,CAR,924.8666666666666,10,7,7,14,24,17,306,666,360,86,146,81,28,10,9,856,833,722,707,29,27,0.4594594594594595,30198114.465
RILEY.SHEAHAN,20132014,DET,678.85,9,13,2,15,24,22,277,572,295,67,120,28,24,11,3,740,453,539,416,26,17,0.48426573426573427,30198078.439999998
RJ.UMBERGER,20132014,CBJ,1248.1,18,13,4,17,35,31,25,40,15,139,220,118,43,22,14,1067,1121,777,916,34,41,0.625,30198137.82
ROB.KLINKHAMMER,20132014,ARI,818.45,11,6,3,9,20,17,1,6,5,103,175,167,29,14,8,797,703,775,662,28,24,0.16666666666666666,30198090.955
ROB.SCUDERI,20132014,PIT,1233.5666666666666,0,4,0,4,4,4,0,0,0,33,58,19,18,7,4,857,1416,814,1015,32,39,0,30198129.57
ROBERT.BORTUZZO,20132014,PIT,941.7166666666667,0,6,5,11,11,6,0,1,1,63,122,147,31,19,22,720,928,686,786,28,32,0,30198106.115000002
ROBYN.REGEHR,20132014,L.A,1635.1833333333334,3,6,6,12,15,9,0,0,0,76,166,233,57,11,22,1387,1625,1276,1106,38,45,0,30198121.91
ROMAN.HORAK,20132014,CGY,4.066666666666666,0,0,0,0,0,0,0,1,1,0,0,0,0,0,0,4,7,4,7,0,0,0,15099011.4
ROMAN.HORAK,20132014,EDM,24.183333333333334,1,0,0,0,1,1,4,5,1,2,2,0,0,0,0,16,40,15,38,1,2,0.8,30198026.61
ROMAN.JOSI,20132014,NSH,1899.9833333333333,13,16,11,27,40,29,0,0,0,167,298,32,80,11,9,1723,1795,1272,1329,58,62,0,30198164.585
ROMAN.POLAK,20132014,STL,1360.0333333333333,4,4,6,10,14,8,0,0,0,88,170,164,43,15,25,1029,1255,935,977,33,42,0,30198123.15
RON.HAINSEY,20132014,CAR,1758,4,5,6,11,15,9,0,0,0,72,170,96,63,9,18,1548,1658,1363,1306,41,49,0,30198145.54
ROSTISLAV.KLESLA,20132014,ARI,387.7,1,1,2,3,4,2,0,0,0,22,47,41,18,6,9,363,421,333,308,11,12,0,30198050.11
ROSTISLAV.OLESZ,20132014,N.J,114.19999999999999,0,1,1,2,2,1,1,3,2,9,13,11,2,0,0,80,73,75,64,1,2,0.3333333333333333,30198027.564999998
RYAN.CALLAHAN,20132014,NYR,807.6833333333334,11,11,3,14,25,22,7,19,12,109,211,132,47,13,7,876,813,647,629,24,26,0.3684210526315789,30198093.485
RYAN.CALLAHAN,20132014,T.B,487.25,6,1,4,5,11,7,6,14,8,59,107,73,18,8,4,457,392,305,296,14,8,0.42857142857142855,30198054.369999997
RYAN.CARTER,20132014,N.J,702.35,7,2,1,3,10,9,16,36,20,69,117,72,19,20,15,477,509,450,420,12,19,0.4444444444444444,30198069.665
RYAN.CRAIG,20132014,CBJ,42.13333333333333,0,0,0,0,0,0,0,0,0,4,5,8,1,0,0,21,48,20,48,0,3,0,30198027.25
RYAN.ELLIS,20132014,NSH,1285.3833333333332,6,9,10,19,25,15,0,0,0,123,233,57,72,14,12,1203,1019,952,942,52,40,0,30198114.09
RYAN.GARBUTT,20132014,DAL,1051.5500000000002,20,9,6,15,35,29,4,10,6,180,315,146,62,34,46,982,1068,913,857,42,29,0.4,30198124.2
RYAN.GETZLAF,20132014,ANA,1896.1,35,42,23,65,100,77,781,1636,855,236,440,129,108,23,13,1982,1691,1169,1162,79,48,0.4773838630806846,30198207.045
RYAN.HAMILTON,20132014,EDM,20.05,0,0,0,0,0,0,0,0,0,0,4,3,0,1,0,14,20,12,16,0,2,0,15099012.31
RYAN.JOHANSEN,20132014,CBJ,1561.2833333333333,35,20,14,34,69,55,742,1415,673,254,418,127,77,12,22,1607,1297,1081,1070,46,42,0.5243816254416961,30198187.9
RYAN.JONES,20132014,EDM,511.73333333333335,2,2,2,4,6,4,2,6,4,59,106,74,27,17,14,374,563,338,459,12,13,0.3333333333333333,30198075.15
RYAN.KESLER,20132014,VAN,1679.7833333333333,25,8,9,17,42,33,739,1405,666,238,405,133,75,28,28,1814,1437,1151,1058,46,45,0.5259786476868328,30198168.865
RYAN.MALONE,20132014,T.B,671.45,5,6,4,10,15,11,2,7,5,95,140,75,21,17,22,650,568,536,526,18,23,0.2857142857142857,30198082.8
RYAN.MCDONAGH,20132014,NYR,2579.366666666667,18,17,24,41,59,35,0,0,0,223,420,140,125,31,24,2615,2480,1771,1759,74,67,0,30198205.259999998
RYAN.MURPHY,20132014,CAR,877.7,2,8,2,10,12,10,0,0,0,81,182,22,67,10,5,933,805,689,728,20,26,0,30198093.55
RYAN.MURRAY,20132014,CBJ,1425.1,4,8,10,18,22,12,0,0,0,70,157,28,53,3,5,1289,1218,984,956,45,42,0,30198112.73
RYAN.NUGENT-HOPKINS,20132014,EDM,1631.3666666666668,19,23,14,37,56,42,542,1279,737,178,307,72,72,18,13,1522,1545,1010,1241,49,57,0.42376856919468336,30198207.96
RYAN.O'REILLY,20132014,COL,1742.0333333333333,30,20,20,40,70,50,240,474,234,215,346,23,77,16,1,1710,1607,1194,1294,55,59,0.5063291139240507,30198189.46
RYAN.REAVES,20132014,STL,573.7166666666667,2,4,2,6,8,6,6,8,2,26,64,226,15,19,26,421,491,413,489,16,18,0.75,30198078.23
RYAN.SMYTH,20132014,EDM,1110.5333333333333,10,6,7,13,23,16,91,182,91,129,202,58,27,12,22,938,1057,637,768,19,29,0.5,30198121.785
RYAN.SPOONER,20132014,BOS,294.6333333333333,0,4,7,11,11,4,59,145,86,42,64,10,10,3,3,304,228,216,197,9,6,0.4068965517241379,30198045.915
RYAN.SPROUL,20132014,DET,18.416666666666668,0,0,0,0,0,0,0,0,0,3,6,2,2,0,0,21,5,13,5,0,0,0,15099010.45
RYAN.STANTON,20132014,VAN,941.5666666666667,1,5,9,14,15,6,1,1,0,65,147,97,52,8,13,870,819,843,752,36,32,1,30198087.845
RYAN.STOA,20132014,WSH,27.25,0,0,0,0,0,0,0,8,8,2,4,4,1,0,0,17,24,17,24,0,1,0,30198024.1
RYAN.STROME,20132014,NYI,562,7,5,6,11,18,12,165,374,209,89,137,29,28,3,4,617,448,445,412,17,16,0.4411764705882353,30198075.78
RYAN.SUTER,20132014,MIN,2791.833333333333,9,15,26,41,50,24,1,1,0,179,413,97,147,9,19,2463,2305,1698,1738,70,55,1,30198192.63
RYAN.WHITE,20132014,MTL,503.73333333333335,2,2,1,3,5,4,197,387,190,51,80,88,20,11,15,289,622,263,438,10,18,0.5090439276485789,30198084.064999998
RYAN.WHITNEY,20132014,FLA,117.23333333333332,0,0,0,0,0,0,0,0,0,8,16,4,6,0,3,88,106,70,96,2,6,0,30198031.55
RYAN.WILSON,20132014,COL,472.48333333333335,0,2,6,8,8,2,0,1,1,24,54,59,23,8,7,367,501,343,434,21,20,0,30198066.28
RYANE.CLOWE,20132014,N.J,693.5666666666666,7,14,5,19,26,21,1,3,2,74,110,82,17,8,10,656,505,498,463,21,31,0.3333333333333333,30198078.195
SAKU.KOIVU,20132014,ANA,1143.6833333333334,11,8,10,18,29,19,638,1244,606,86,153,43,32,14,27,909,1241,768,922,35,38,0.5128617363344051,30198156.11
SAM.GAGNER,20132014,EDM,1231.2333333333333,10,16,11,27,37,26,451,963,512,143,252,33,50,5,14,1150,1161,792,1004,32,57,0.4683281412253375,30198166.715
SAMI.SALO,20132014,T.B,1321.5,4,6,6,12,16,10,0,0,0,81,182,61,52,5,8,1161,1194,861,801,40,32,0,30198096.15
SAMI.VATANEN,20132014,ANA,938.8666666666667,6,9,7,16,22,15,0,1,1,83,181,76,56,13,10,1015,748,732,661,38,28,0,30198084.955
SCOTT.GOMEZ,20132014,FLA,604.0666666666666,2,4,6,10,12,6,239,515,276,56,88,16,17,7,12,521,484,426,452,15,24,0.4640776699029126,30198082.83
SCOTT.HANNAN,20132014,S.J,1118.8,3,5,6,11,14,8,0,0,0,59,121,33,33,6,18,970,1135,900,897,44,46,0,30198110.009999998
SCOTT.HARTNELL,20132014,PHI,1434.75,20,22,13,35,55,42,4,18,14,226,386,174,66,41,40,1858,1141,1208,1022,49,36,0.2222222222222222,30198142.095
SCOTT.MAYFIELD,20132014,NYI,86.83333333333333,0,0,0,0,0,0,0,0,0,7,13,7,5,2,2,79,78,75,66,1,4,0,30198026.92
SCOTTIE.UPSHALL,20132014,FLA,1209.7,15,16,6,22,37,31,32,70,38,161,280,134,70,32,33,1075,1016,858,792,35,34,0.45714285714285713,30198115.8
SEAN.BERGENHEIM,20132014,FLA,1023.3499999999999,16,10,3,13,29,26,2,4,2,190,310,111,45,14,17,1090,777,825,676,32,46,0.5,30198098.795
SEAN.COLLINS,20132014,CBJ,49.05,0,0,1,1,1,0,0,0,0,6,7,9,1,1,0,37,39,37,39,2,1,0,30198024.935000002
SEAN.COUTURIER,20132014,PHI,1702.2166666666667,13,16,10,26,39,29,703,1470,767,176,299,78,62,18,18,1410,1706,1098,1148,40,50,0.4782312925170068,30198184.65
SEAN.MONAHAN,20132014,CGY,1198.35,22,8,4,12,34,30,476,1036,560,140,250,42,66,6,4,1049,1069,758,975,33,46,0.4594594594594595,30198165.5
SERGEI.GONCHAR,20132014,DAL,1418.7833333333333,2,8,12,20,22,10,0,0,0,94,222,77,87,8,13,1457,1290,1066,1144,39,46,0,30198133.83
SETH.JONES,20132014,NSH,1510.7666666666667,6,6,13,19,25,12,0,0,0,100,225,55,74,11,12,1296,1325,1021,1042,34,60,0,30198125.435000002
SHANE.DOAN,20132014,ARI,1306.9333333333334,23,15,8,23,46,38,6,12,6,167,318,135,70,14,12,1402,1047,959,920,42,39,0.5,30198129.73
SHANE.O'BRIEN,20132014,CGY,506.73333333333335,0,1,2,3,3,1,0,0,0,16,57,56,27,7,17,403,506,385,491,16,25,0,30198073.07
SHAWN.HORCOFF,20132014,DAL,1075.4333333333334,8,15,3,18,26,23,218,439,221,80,124,74,26,9,25,969,1023,783,812,26,24,0.49658314350797267,30198126.634999998
SHAWN.MATTHIAS,20132014,FLA,721.5666666666666,9,4,3,7,16,13,80,209,129,88,146,73,31,11,7,561,700,501,513,22,23,0.3827751196172249,30198084.884999998
SHAWN.MATTHIAS,20132014,VAN,280.41666666666663,3,0,4,4,7,3,102,223,121,39,54,20,7,4,6,231,283,181,214,9,11,0.45739910313901344,30198051.97
SHAWN.THORNTON,20132014,BOS,651.1833333333334,5,3,1,4,9,8,4,14,10,109,178,150,31,13,20,517,571,515,568,14,14,0.2857142857142857,30198087.965
SHEA.WEBER,20132014,NSH,2123.25,23,9,22,31,54,32,0,0,0,195,401,169,98,12,22,1895,2006,1396,1507,66,69,0,30198188.52
SHELDON.BROOKBANK,20132014,CHI,722.4666666666667,2,6,1,7,9,8,0,0,0,45,107,74,38,12,13,619,640,605,591,26,23,0,30198078.895000003
SIDNEY.CROSBY,20132014,PIT,2034.8833333333334,37,37,38,75,112,74,1148,2182,1034,297,501,61,98,35,23,2468,1566,1533,1294,77,60,0.5261228230980751,30198220.17
SIMON.DESPRES,20132014,PIT,569.2333333333333,0,2,3,5,5,2,0,0,0,40,81,72,29,7,13,520,483,460,425,18,13,0,30198060.045
SIMON.MOSER,20132014,NSH,60.78333333333333,1,1,0,1,2,2,0,0,0,7,11,5,2,0,1,53,41,52,36,2,2,0,30198024.950000003
SLAVA.VOYNOV,20132014,L.A,2429.8,6,20,13,33,39,26,1,1,0,182,448,243,155,16,30,2422,2045,1793,1524,62,54,1,30198157.325000003
SPENCER.ABBOTT,20132014,TOR,5.266666666666667,0,0,0,0,0,0,0,0,0,2,2,1,0,0,0,5,12,5,12,0,2,0,15099012.15
STEFAN.ELLIOTT,20132014,COL,16.849999999999998,1,0,0,0,1,1,0,0,0,1,2,2,1,0,0,15,20,14,18,1,1,0,15099012.95
STEPHANE.DA COSTA,20132014,OTT,124.91666666666666,3,1,0,1,4,4,32,79,47,20,46,14,17,0,1,155,93,135,87,6,4,0.4050632911392405,30198029.68
STEPHANE.ROBIDAS,20132014,ANA,336.2166666666667,1,2,2,4,5,3,0,0,0,25,48,39,14,2,5,300,337,260,260,14,13,0,30198046.77
STEPHANE.ROBIDAS,20132014,DAL,477.98333333333335,4,0,1,1,5,4,0,0,0,35,80,62,24,3,6,425,497,374,357,23,18,0,30198054.354999997
STEPHANE.VEILLEUX,20132014,MIN,315.98333333333335,3,0,0,0,3,3,1,2,1,30,48,44,12,7,11,175,311,171,242,6,7,0.5,30198051.41
STEPHEN.GIONTA,20132014,N.J,822.4333333333333,4,4,3,7,11,8,237,580,343,89,137,113,23,15,8,495,644,460,455,12,17,0.4086206896551724,30198086.805
STEPHEN.WEISS,20132014,DET,383.75,2,1,1,2,4,3,183,356,173,28,37,4,5,3,6,280,328,205,283,5,9,0.5140449438202247,30198062.875
STEVE.BERNIER,20132014,N.J,970.8833333333333,3,4,5,9,12,7,6,18,12,104,160,118,21,13,9,799,643,692,614,16,32,0.3333333333333333,30198084.845
STEVE.DOWNIE,20132014,COL,183.88333333333333,1,4,2,6,7,5,0,0,0,26,48,13,11,6,11,207,152,158,148,7,4,0,30198038.66
STEVE.DOWNIE,20132014,PHI,690.4666666666667,3,8,6,14,17,11,4,7,3,62,111,57,27,16,27,641,573,527,548,24,27,0.5714285714285714,30198083.57
STEVE.OLEKSY,20132014,WSH,503.76666666666665,2,5,3,8,10,7,0,0,0,26,60,46,23,10,17,376,538,364,418,20,13,0,30198067.375
STEVE.OTT,20132014,BUF,1162.3833333333332,9,10,1,11,20,19,365,700,335,99,155,194,30,24,23,898,1253,663,892,17,37,0.5214285714285715,30198148.215
STEVE.OTT,20132014,STL,446.9,0,5,0,5,5,5,178,299,121,36,56,81,10,7,12,385,412,312,322,7,18,0.5953177257525084,30198061.84
STEVEN.PINIZZOTTO,20132014,EDM,57.86666666666667,0,1,1,2,2,1,0,0,0,2,5,10,1,1,2,41,58,41,57,2,3,0,30198028.085
STEVEN.STAMKOS,20132014,T.B,836.55,27,13,4,17,44,40,276,561,285,138,258,55,55,15,11,891,652,592,545,35,25,0.4919786096256685,30198106.189999998
SVEN.BAERTSCHI,20132014,CGY,366.9,2,4,5,9,11,6,0,0,0,30,56,22,16,8,2,301,357,260,345,12,15,0,30198061.405
T.J..OSHIE,20132014,STL,1621.5666666666666,23,26,12,38,61,49,28,72,44,164,296,84,60,38,21,1659,1268,1111,938,54,37,0.3888888888888889,30198134
TANNER.GLASS,20132014,PIT,868.4,4,5,4,9,13,9,9,19,10,66,104,272,22,23,25,489,963,463,715,13,22,0.47368421052631576,30198113.39
TANNER.PEARSON,20132014,L.A,564.9333333333334,7,9,3,12,19,16,1,4,3,83,155,87,26,11,8,621,469,564,445,21,13,0.25,30198068.175
TAYLOR.BECK,20132014,NSH,89.88333333333333,0,0,0,0,0,0,0,0,0,9,15,4,2,0,3,76,57,66,54,0,2,0,30198026.4
TAYLOR.FEDUN,20132014,EDM,48.833333333333336,2,0,0,0,2,2,0,0,0,6,10,1,2,0,0,40,55,37,43,3,4,0,15099016.05
TAYLOR.HALL,20132014,EDM,1500.3166666666666,27,24,27,51,78,51,37,81,44,249,425,54,99,26,19,1500,1396,959,1203,54,60,0.4567901234567901,30198182.064999998
TAYLOR.PYATT,20132014,NYR,278.45,0,1,0,1,1,1,4,10,6,21,36,24,4,3,5,186,289,169,228,4,12,0.4,30198048.19
TAYLOR.PYATT,20132014,PIT,369.83333333333337,4,0,0,0,4,4,3,3,0,30,56,46,12,2,5,283,354,257,347,4,18,1,30198062.84
TEDDY.PURCELL,20132014,T.B,1395.8833333333332,13,20,10,30,43,33,4,16,12,166,288,15,56,8,9,1447,1011,1039,920,42,43,0.25,30198123.49
TEEMU.PULKKINEN,20132014,DET,22.4,0,0,0,0,0,0,0,0,0,4,8,2,4,0,1,23,9,16,9,0,0,0,30198021.299999997
TEEMU.SELANNE,20132014,ANA,1051.5666666666666,11,12,10,22,33,23,53,123,70,134,230,24,44,19,7,1143,839,782,783,33,26,0.43089430894308944,30198113.759999998
TEUVO.TERAVAINEN,20132014,CHI,42.28333333333333,0,0,0,0,0,0,13,25,12,4,7,1,2,0,0,38,30,32,29,0,0,0.52,30198024.12
THOMAS.HICKEY,20132014,NYI,1547.2666666666669,4,8,9,17,21,12,0,0,0,96,226,72,75,7,16,1373,1524,1215,1189,52,49,0,30198134.695
THOMAS.VANEK,20132014,BUF,241.93333333333334,4,3,2,5,9,7,2,5,3,50,67,3,8,0,4,221,233,139,208,6,9,0.4,30198050.98
THOMAS.VANEK,20132014,MTL,580.3,11,8,6,14,25,19,20,50,30,89,162,26,42,4,6,609,498,391,451,23,17,0.4,30198078.59
THOMAS.VANEK,20132014,NYI,939.1833333333334,17,19,7,26,43,36,1,1,0,137,250,17,61,8,17,1094,834,714,762,42,30,1,30198116.495
TIM.ERIXON,20132014,CBJ,28.683333333333334,0,0,0,0,0,0,0,0,0,1,4,1,2,0,0,28,30,26,29,3,1,0,15099012.85
TIM.GLEASON,20132014,CAR,270.16666666666663,0,0,1,1,1,0,0,0,0,15,28,48,9,2,5,245,280,233,249,4,10,0,30198046.345
TIM.GLEASON,20132014,TOR,661.2,1,1,3,4,5,2,0,0,0,28,52,108,20,7,18,465,849,446,686,14,29,0,30198102.145
TIM.JACKMAN,20132014,ANA,191.83333333333331,3,0,1,1,4,3,2,2,0,37,51,53,8,9,14,187,166,177,164,7,9,1,30198040.695
TIM.JACKMAN,20132014,CGY,63.83333333333333,1,0,0,0,1,1,0,1,1,9,13,16,2,2,8,56,77,55,75,1,2,0,30198031.47
TIM.KENNEDY,20132014,ARI,435.1333333333333,2,4,2,6,8,6,18,49,31,42,63,62,11,5,4,416,401,395,387,12,13,0.3673469387755102,30198063.72
TIM.SESTITO,20132014,N.J,145.55,0,2,1,3,3,2,20,47,27,13,19,24,3,0,1,87,91,83,75,2,3,0.425531914893617,30198030.475
TJ.BRODIE,20132014,CGY,1949.1,4,11,14,25,29,15,0,0,0,104,255,58,89,16,10,1681,1627,1349,1269,58,60,0,30198138.61
TJ.GALIARDI,20132014,CGY,905.8499999999999,4,9,4,13,17,13,62,155,93,100,182,77,33,26,9,760,860,717,728,26,40,0.4,30198104.189999998
TOBIAS.ENSTROM,20132014,WPG,1959.6666666666665,10,6,12,18,28,16,1,1,0,105,223,37,70,13,28,1923,1686,1291,1259,52,52,1,30198147.77
TODD.BERTUZZI,20132014,DET,877.3666666666666,9,4,3,7,16,13,9,18,9,98,151,78,21,6,22,860,626,557,575,24,37,0.5,30198089.994999997
TOM.GILBERT,20132014,FLA,1556.3833333333332,3,13,11,24,27,16,0,0,0,90,211,59,67,8,8,1473,1285,1147,1069,47,51,0,30198122.755
TOM.PYATT,20132014,T.B,317.3666666666667,3,2,2,4,7,5,101,193,92,27,49,12,9,5,2,254,309,245,256,10,10,0.5233160621761658,30198052.939999998
TOM.SESTITO,20132014,VAN,497.2,5,1,3,4,9,6,3,11,8,31,45,121,4,22,45,392,477,374,472,11,25,0.2727272727272727,30198084.015
TOM.WILSON,20132014,WSH,650.95,3,4,3,7,10,7,0,3,3,63,97,197,15,30,42,476,569,462,563,17,16,0,30198091.975
TOMAS.FLEISCHMANN,20132014,FLA,1369.65,8,14,6,20,28,22,5,18,13,188,360,59,99,9,11,1342,1117,933,890,33,52,0.2777777777777778,30198113.54
TOMAS.HERTL,20132014,S.J,662.2666666666667,17,7,6,13,30,24,30,54,24,117,199,53,40,9,3,799,541,606,493,30,23,0.5555555555555556,30198077.64
TOMAS.JURCO,20132014,DET,523.3333333333333,8,4,3,7,15,12,0,0,0,83,136,71,24,11,7,546,344,413,327,17,19,0,30198056.585
TOMAS.KOPECKY,20132014,FLA,778.45,4,6,1,7,11,10,8,29,21,95,151,31,26,11,9,651,680,528,490,15,19,0.27586206896551724,30198075.305
TOMAS.PLEKANEC,20132014,MTL,1947.25,24,17,11,28,52,41,1014,2100,1086,241,455,56,99,22,20,1637,2071,1156,1402,42,45,0.4828571428571429,30198238.755
TOMAS.TATAR,20132014,DET,1123.1166666666668,19,12,8,20,39,31,26,52,26,177,304,95,68,21,19,1199,743,871,674,41,27,0.5,30198095.65
TOMMY.WINGELS,20132014,S.J,1358.0833333333335,16,11,14,25,41,27,21,59,38,176,297,248,57,20,17,1436,1280,1146,1035,46,45,0.3559322033898305,30198135.04
TOREY.KRUG,20132014,BOS,1618.6666666666667,16,15,19,34,50,31,1,2,1,209,449,58,171,14,16,1896,1248,1358,1117,52,38,0.5,30198121.105
TORREY.MITCHELL,20132014,BUF,140.86666666666667,1,0,0,0,1,1,3,7,4,9,13,11,3,1,2,91,164,84,112,5,5,0.42857142857142855,30198034.03
TORREY.MITCHELL,20132014,MIN,587.7833333333333,1,5,3,8,9,6,9,24,15,47,84,49,24,9,9,384,559,358,418,11,15,0.375,30198068.674999997
TRAVIS.HAMONIC,20132014,NYI,1726.1333333333334,3,7,8,15,18,10,0,0,0,134,308,93,116,12,23,1526,1729,1247,1245,48,48,0,30198137.619999997
TRAVIS.MOEN,20132014,MTL,791.3,2,5,5,10,12,7,9,10,1,63,112,104,18,18,13,536,928,478,581,17,17,0.9,30198088.765
TRAVIS.MORIN,20132014,DAL,41.31666666666666,0,0,1,1,1,0,19,38,19,4,5,0,0,0,0,45,44,45,43,3,1,0.5,30198025.785
TRAVIS.ZAJAC,20132014,N.J,1624.8666666666668,18,17,13,30,48,35,761,1394,633,166,280,53,63,13,14,1466,1138,1086,766,49,43,0.5459110473457676,30198122.295
TREVOR.DALEY,20132014,DAL,1571.5833333333333,11,10,9,19,30,21,0,0,0,126,270,51,78,5,23,1518,1567,1199,1116,58,46,0,30198131.725
TREVOR.LEWIS,20132014,L.A,1296.5833333333335,10,4,2,6,16,14,143,304,161,148,269,222,49,21,6,1030,1225,952,863,19,31,0.47039473684210525,30198117.130000003
TREVOR.SMITH,20132014,TOR,290.4166666666667,4,3,1,4,8,7,115,258,143,24,42,45,8,4,2,225,314,200,287,7,10,0.44573643410852715,30198063.865000002
TROY.BODIE,20132014,TOR,405.75,3,3,4,7,10,6,2,7,5,50,83,64,13,12,7,319,422,313,416,15,9,0.2857142857142857,30198071.5
TROY.BROUWER,20132014,WSH,1545.65,25,7,11,18,43,32,223,436,213,161,315,210,65,24,32,1552,1434,865,941,32,34,0.5114678899082569,30198148.035
TUOMO.RUUTU,20132014,CAR,812,5,4,7,11,16,9,11,31,20,79,165,168,40,20,15,908,747,712,697,22,36,0.3548387096774194,30198094.165
TUOMO.RUUTU,20132014,N.J,294.98333333333335,3,2,3,5,8,5,3,6,3,26,42,48,7,5,5,251,183,226,162,8,8,0.5,30198037.395
TY.RATTIE,20132014,STL,22.1,0,0,0,0,0,0,0,0,0,4,6,1,0,0,0,17,15,14,15,0,2,0,30198022.75
TYE.MCGINN,20132014,PHI,201.23333333333335,4,1,0,1,5,5,0,0,0,16,32,26,8,0,2,165,174,145,170,9,9,0,30198041.15
TYLER.BOZAK,20132014,TOR,1214.9499999999998,19,19,11,30,49,38,681,1399,718,90,159,62,35,11,7,1197,1355,824,1097,54,48,0.4867762687634024,30198190.325000003
TYLER.ENNIS,20132014,BUF,1508.1666666666667,21,12,10,22,43,33,242,625,383,210,347,89,77,17,17,1492,1396,986,1261,39,58,0.3872,30198195.45
TYLER.JOHNSON,20132014,T.B,1624.2333333333333,25,14,13,27,52,39,646,1344,698,192,328,58,64,21,12,1449,1474,1069,1046,53,38,0.4806547619047619,30198173.125
TYLER.KENNEDY,20132014,S.J,852.2833333333333,4,9,4,13,17,13,57,136,79,143,270,54,73,22,14,898,802,808,731,24,33,0.41911764705882354,30198096.6
TYLER.MYERS,20132014,BUF,1357.7166666666667,9,7,6,13,22,16,0,0,0,99,202,107,57,13,25,1074,1351,771,957,25,47,0,30198133.13
TYLER.PITLICK,20132014,EDM,89.71666666666667,1,0,0,0,1,1,1,3,2,9,18,26,6,0,0,63,86,61,85,1,3,0.3333333333333333,30198030.89
TYLER.SEGUIN,20132014,DAL,1667.5166666666667,38,35,14,49,87,73,320,754,434,319,579,54,116,27,5,2103,1343,1280,1142,71,45,0.4244031830238727,30198182.62
TYLER.TOFFOLI,20132014,L.A,1147.9666666666667,19,12,11,23,42,31,2,9,7,189,347,97,83,13,9,1341,820,1106,751,44,25,0.2222222222222222,30198091.285
TYLER.WOTHERSPOON,20132014,CGY,188.3,0,3,1,4,4,3,0,0,0,3,17,8,10,0,2,141,205,140,203,7,10,0,30198044.075000003
TYSON.BARRIE,20132014,COL,1241.55,13,11,15,26,39,24,0,0,0,103,211,54,67,12,10,1271,1050,938,937,45,31,0,30198120.895000003
TYSON.STRACHAN,20132014,WSH,311.3833333333333,0,0,2,2,2,0,0,0,0,7,29,31,13,3,7,200,314,187,277,6,8,0,30198051.93
VALERI.NICHUSHKIN,20132014,DAL,1263.3333333333335,15,13,8,21,36,28,0,1,1,137,247,89,51,24,4,1293,1116,1084,1041,54,33,0,30198133.189999998
VALTTERI.FILPPULA,20132014,T.B,1583.5,25,21,13,34,59,46,729,1396,667,133,214,33,41,27,9,1545,1255,1076,992,44,38,0.5222063037249284,30198167.605
VERNON.FIDDLER,20132014,DAL,1096.1833333333334,7,12,7,19,26,19,573,1082,509,121,206,53,43,21,20,869,1202,792,841,34,31,0.5295748613678374,30198137.005000003
VICTOR.BARTLEY,20132014,NSH,768.2166666666667,1,3,2,5,6,4,0,0,0,21,50,81,19,6,10,543,777,514,639,26,24,0,30198089.51
VICTOR.HEDMAN,20132014,T.B,1780.7666666666667,14,26,16,42,56,40,0,0,0,173,355,92,107,10,27,1661,1511,1265,1078,58,50,0,30198132.799999997
VIKTOR.STALBERG,20132014,NSH,880.8666666666666,8,7,3,10,18,15,1,3,2,114,199,55,42,18,17,736,777,706,738,25,36,0.3333333333333333,30198104.545
VILLE.LEINO,20132014,BUF,837.1833333333334,0,7,8,15,15,7,125,287,162,38,82,26,26,17,5,713,758,540,704,11,26,0.4355400696864111,30198108.17
VINCENT.LECAVALIER,20132014,PHI,1122.9666666666667,21,12,6,18,39,33,222,500,278,141,257,81,58,10,11,1131,1013,761,929,28,44,0.444,30198151.63
VINCENT.TROCHECK,20132014,FLA,377.73333333333335,5,1,2,3,8,6,166,348,182,38,76,39,15,5,3,343,331,226,213,6,16,0.47701149425287354,30198052.54
VLADIMIR.SOBOTKA,20132014,STL,1148.5333333333333,9,13,14,27,36,22,561,914,353,115,251,132,73,27,31,1178,904,894,677,39,31,0.6137855579868708,30198098.26
VLADIMIR.TARASENKO,20132014,STL,1084.9,25,15,7,22,47,40,2,6,4,158,314,27,74,24,9,1210,794,941,685,46,23,0.3333333333333333,30198094.645
VLADISLAV.NAMESTNIKOV,20132014,T.B,37.88333333333333,0,0,0,0,0,0,12,26,14,4,6,3,2,0,2,39,42,38,41,0,0,0.46153846153846156,30198026.03
WAYNE.SIMMONDS,20132014,PHI,1482.9,33,18,14,32,65,51,1,3,2,225,370,147,81,31,40,1781,1275,1064,1125,43,43,0.3333333333333333,30198169.65
WILL.ACTON,20132014,EDM,244.13333333333333,3,1,1,2,5,4,98,195,97,18,37,37,11,5,6,121,304,113,178,5,7,0.5025641025641026,30198048.095
WILLIE.MITCHELL,20132014,L.A,1947.0166666666667,2,4,10,14,16,6,0,0,0,96,238,136,81,9,35,1713,1870,1534,1291,63,43,0,30198130.840000004
XAVIER.OUELLET,20132014,DET,67.61666666666666,0,0,0,0,0,0,0,0,0,5,12,7,5,0,1,58,48,58,40,0,1,0,30198023.75
YANN.SAUVE,20132014,VAN,36.833333333333336,0,0,0,0,0,0,0,0,0,1,2,5,1,0,0,23,39,23,39,0,1,0,15099015.1
YANNICK.WEBER,20132014,VAN,583.8833333333333,6,3,1,4,10,9,0,0,0,70,153,39,43,2,8,565,476,420,423,16,19,0,30198065.244999997
ZAC.DALPE,20132014,VAN,392.15,4,0,3,3,7,4,106,231,125,51,95,36,14,5,3,333,385,306,378,7,14,0.4588744588744589,30198070.515
ZAC.RINALDO,20132014,PHI,563.7166666666667,2,1,0,1,3,3,2,3,1,61,119,248,29,28,42,423,554,416,498,9,24,0.6666666666666666,30198080.810000002
ZACH.BOGOSIAN,20132014,WPG,1260.0166666666667,3,5,2,7,10,8,0,0,0,134,254,94,70,6,15,1186,1230,926,945,41,40,0,30198113.810000002
ZACH.BOYCHUK,20132014,CAR,112.18333333333334,1,3,0,3,4,4,0,1,1,15,23,17,6,1,0,96,91,78,90,4,2,0,30198032.26
ZACH.PARISE,20132014,MIN,1634.8333333333333,33,19,18,37,70,52,11,27,16,294,452,90,77,24,16,1744,1236,1152,927,47,38,0.4074074074074074,30198136.78
ZACH.REDMOND,20132014,WPG,153.16666666666666,1,1,1,2,3,2,0,0,0,10,30,7,12,3,0,142,128,130,125,5,4,0,30198032.555
ZACH.SILL,20132014,PIT,215.88333333333333,0,0,0,0,0,0,34,90,56,14,27,57,7,2,3,100,255,95,185,1,5,0.37777777777777777,30198046.43
ZACH.TROTMAN,20132014,BOS,30,0,0,0,0,0,0,0,0,0,4,7,2,0,0,0,25,17,21,17,0,0,0,30198022.7
ZACK.KASSIAN,20132014,VAN,943.8166666666666,14,10,5,15,29,24,6,21,15,91,162,91,38,17,24,907,842,836,803,38,35,0.2857142857142857,30198112.935000002
ZACK.SMITH,20132014,OTT,1273.6,13,4,5,9,22,17,679,1289,610,154,250,175,45,35,40,1151,1292,1033,1015,31,42,0.5267649340574089,30198159.634999998
ZBYNEK.MICHALEK,20132014,ARI,1236.9833333333333,2,5,3,8,10,7,0,0,0,78,162,55,58,7,12,928,1239,822,861,32,25,0,30198105.695
ZDENO.CHARA,20132014,BOS,2202.3166666666666,19,12,11,23,42,31,0,0,0,190,390,208,120,21,30,2197,1916,1582,1283,61,41,0,30198142.134999998
ZEMGUS.GIRGENSONS,20132014,BUF,1072.1166666666668,8,10,4,14,22,18,100,240,140,115,191,160,31,18,6,810,1145,711,878,28,38,0.4166666666666667,30198132.53
ZENON.KONOPKA,20132014,BUF,204.15,0,0,0,0,0,0,188,328,140,6,10,25,1,6,9,94,227,82,154,3,7,0.573170731707317,30198046.23
ZENON.KONOPKA,20132014,MIN,262.01666666666665,1,1,0,1,2,2,157,239,82,15,26,21,4,9,16,173,225,170,183,5,11,0.6569037656903766,30198045.619999997
AARON.EKBLAD,20142015,FLA,1766.6166666666666,12,10,17,27,39,22,0,0,0,170,351,109,113,15,15,1760,1300,1299,1112,59,43,0,30213124.625
AARON.VOLPATTI,20142015,WSH,19.233333333333334,0,0,0,0,0,0,0,0,0,1,3,3,0,1,0,14,14,14,14,0,0,0,30213023.96
ADAM.BURISH,20142015,S.J,222.9,1,2,0,2,3,3,57,107,50,22,38,11,7,6,NA,134,279,126,216,3,9,0.5327102803738317,NA
ADAM.CLENDENING,20142015,CHI,52.68333333333334,1,0,1,1,2,1,0,0,0,2,10,1,6,1,1,63,42,37,40,3,2,0,15106515.085
ADAM.CLENDENING,20142015,VAN,296.7,0,1,1,2,2,1,0,0,0,15,39,8,13,0,4,281,246,232,230,12,10,0,30213043.625
ADAM.CRACKNELL,20142015,CBJ,169.1,0,1,0,1,1,1,20,58,38,17,29,43,3,0,1,114,174,110,163,1,9,0.3448275862068966,30213044.1
ADAM.HENRIQUE,20142015,N.J,1330.7833333333333,16,16,10,26,42,32,270,519,249,127,224,59,59,10,13,1049,1289,796,941,34,36,0.5202312138728323,30213148.8
ADAM.LARSSON,20142015,N.J,1341.6333333333334,3,9,9,18,21,12,0,0,0,91,178,92,54,6,17,885,1287,792,892,31,31,0,30213118.835
ADAM.LOWRY,20142015,WPG,1159.3333333333335,12,10,4,14,26,22,430,912,482,109,194,268,40,17,18,1046,896,946,800,35,35,0.47149122807017546,30213126.270000003
ADAM.MCQUAID,20142015,BOS,1161.4666666666667,1,2,4,6,7,3,0,1,1,60,135,141,49,17,31,914,1106,869,881,26,32,0,30213109.92
ADAM.PARDY,20142015,WPG,862.5666666666667,1,5,4,9,10,6,0,0,0,32,84,80,40,15,17,661,796,603,569,27,23,0,30213075.700000003
ALEC.MARTINEZ,20142015,L.A,1115.4,6,9,5,14,20,15,0,0,0,103,232,95,81,9,5,1089,941,838,741,38,28,0,30213089.415
ALEKSANDER.BARKOV,20142015,FLA,1242.4166666666665,16,9,11,20,36,25,462,1002,540,123,198,35,39,10,8,1196,935,872,798,36,35,0.46107784431137727,30213134.155
ALES.HEMSKY,20142015,DAL,1036.6833333333334,11,8,12,20,31,19,0,0,0,140,255,22,76,14,10,1142,901,896,832,37,41,0,30213107.189999998
ALEX.BIEGA,20142015,VAN,110.56666666666666,1,0,0,0,1,1,0,0,0,7,19,34,5,0,0,77,101,71,93,4,7,0,30213032.6
ALEX.BOLDUC,20142015,ARI,31.983333333333334,0,0,0,0,0,0,10,19,9,3,3,17,0,0,1,24,39,24,38,0,1,0.5263157894736842,30213027.65
ALEX.BURROWS,20142015,VAN,1126.5166666666667,18,10,7,17,35,28,6,14,8,156,253,76,42,27,32,1115,925,811,711,33,38,0.42857142857142855,30213109.185000002
ALEX.CHIASSON,20142015,OTT,1053.5333333333333,11,9,6,15,26,20,3,21,18,109,178,105,33,8,24,1051,859,741,729,22,33,0.14285714285714285,30213109.65
ALEX.EDLER,20142015,VAN,1916.5333333333333,8,9,14,23,31,17,0,1,1,181,388,103,137,10,30,1824,1636,1282,1180,48,40,0,30213132.950000003
ALEX.GALCHENYUK,20142015,MTL,1506.4333333333334,21,17,12,29,50,38,82,173,91,187,354,108,85,24,22,1681,1322,1241,1190,52,38,0.47398843930635837,30213159.97
ALEX.GOLIGOSKI,20142015,DAL,1928.7166666666667,4,16,13,29,33,20,0,0,0,122,282,100,95,15,12,1940,1891,1522,1318,71,62,0,30213139.825
ALEX.KHOKHLACHEV,20142015,BOS,24.6,0,0,0,0,0,0,9,17,8,1,1,1,0,0,0,17,18,15,18,0,2,0.5294117647058824,30213024.810000002
ALEX.KILLORN,20142015,T.B,1726.1333333333334,24,18,14,32,56,42,37,91,54,196,336,99,71,29,25,1647,1351,1265,1072,62,50,0.4065934065934066,30213144.02
ALEX.OVECHKIN,20142015,WSH,1925.7333333333333,58,23,9,32,90,81,3,6,3,456,966,316,278,33,32,2460,1518,1563,1344,61,58,0.5,30213177.075000003
ALEX.PETROVIC,20142015,FLA,536.5666666666666,0,0,2,2,2,0,0,0,0,29,60,76,23,7,10,448,493,421,451,15,18,0,30213066.57
ALEX.PIETRANGELO,20142015,STL,2218.883333333333,7,17,23,40,47,24,0,0,0,218,418,74,99,22,14,2019,2030,1510,1429,63,61,0,30213166.244999997
ALEX.SEMIN,20142015,CAR,907.65,6,7,6,13,19,13,3,9,6,93,207,30,70,19,15,953,660,760,602,29,33,0.3333333333333333,30213075.81
ALEX.STEEN,20142015,STL,1596,25,31,11,42,67,56,231,464,233,238,448,34,119,28,14,1730,1328,1116,980,54,44,0.4978448275862069,30213146.745
ALEX.TANGUAY,20142015,COL,1452.6166666666668,22,19,14,33,55,41,12,28,16,104,169,45,37,7,19,1237,1465,851,1152,47,50,0.42857142857142855,30213175.85
ALEX.WENNBERG,20142015,CBJ,1062.4666666666667,4,9,7,16,20,13,288,674,386,85,144,58,37,18,10,894,992,672,707,21,41,0.42729970326409494,30213116.875
ALEXEI.EMELIN,20142015,MTL,1605.4,3,4,9,13,16,7,0,0,0,52,151,246,62,16,29,1219,1665,1130,1284,47,42,0,30213154.335
ALEXEY.MARCHENKO,20142015,DET,251.03333333333333,1,0,1,1,2,1,0,0,0,8,22,11,9,0,1,212,195,201,163,4,8,0,30213036.275
ANDERS.LEE,20142015,NYI,1167.6333333333332,25,10,7,17,42,35,1,1,0,205,320,176,45,13,17,1387,986,1071,931,48,40,1,30213131.095
ANDRE.BENOIT,20142015,BUF,1069.3833333333332,1,3,4,7,8,4,0,0,0,45,106,38,37,4,11,760,1260,611,1033,25,39,0,30213144.189999998
ANDRE.BURAKOVSKY,20142015,WSH,821.3499999999999,11,7,7,14,25,18,75,168,93,82,177,37,48,9,5,917,682,764,652,38,24,0.44642857142857145,30213090.115000002
ANDREI.MARKOV,20142015,MTL,2306.6,11,22,17,39,50,33,0,0,0,150,360,64,127,8,18,2354,2158,1646,1581,69,50,0,30213179.305
ANDREJ.MESZAROS,20142015,BUF,1074.3833333333332,7,3,4,7,14,10,0,0,0,67,139,66,47,3,19,830,1208,648,1034,32,41,0,30213146.43
ANDREJ.NESTRASIL,20142015,CAR,577.2,7,7,4,11,18,14,53,92,39,66,122,49,18,4,3,629,457,537,435,20,15,0.5760869565217391,30213069.46
ANDREJ.NESTRASIL,20142015,DET,143.78333333333333,0,2,0,2,2,2,2,2,0,16,26,5,1,2,2,162,71,111,68,1,4,1,30213029.05
ANDREJ.SEKERA,20142015,CAR,1297.7833333333333,2,5,11,16,18,7,0,0,0,77,213,46,90,6,4,1305,1186,1048,917,36,42,0,30213098.235
ANDREJ.SEKERA,20142015,L.A,307.3333333333333,1,2,1,3,4,3,0,0,0,23,56,13,25,2,3,305,196,244,161,10,6,0,30213032.695
ANDREJ.SUSTR,20142015,T.B,1670.7666666666667,1,4,9,13,14,5,0,0,0,71,165,58,64,7,26,1300,1513,1240,1258,58,48,0,30213141.995
ANDREW.AGOZZINO,20142015,COL,9.75,0,0,1,1,1,0,0,2,2,1,2,1,0,0,0,8,14,8,14,1,0,0,15106513.025
ANDREW.CAMPBELL,20142015,ARI,578.7166666666667,0,0,1,1,1,0,0,0,0,28,62,67,18,2,5,469,698,433,496,7,21,0,30213073.744999997
ANDREW.COGLIANO,20142015,ANA,1455.3833333333332,18,14,6,20,38,32,23,68,45,181,317,187,65,19,NA,1288,1324,1124,1078,48,45,0.3382352941176471,NA
ANDREW.COPP,20142015,WPG,13.266666666666666,0,1,0,1,1,1,6,9,3,4,4,0,0,0,0,9,10,9,9,2,0,0.6666666666666666,15106512.69
ANDREW.DESJARDINS,20142015,CHI,448.45000000000005,1,2,2,4,5,3,21,45,24,44,83,73,26,1,4,409,413,392,364,10,14,0.4666666666666667,30213057.85
ANDREW.DESJARDINS,20142015,S.J,585.0166666666667,5,0,2,2,7,5,145,292,147,43,77,96,24,9,16,413,628,389,494,11,16,0.4965753424657534,30213086.09
ANDREW.EBBETT,20142015,PIT,216.13333333333333,1,3,1,4,5,4,39,86,47,21,37,10,11,1,2,155,194,143,149,6,6,0.45348837209302323,30213040.895
ANDREW.FERENCE,20142015,EDM,1321.3833333333332,3,0,10,10,13,3,0,2,2,58,165,156,60,10,18,1033,1391,954,1157,37,55,0,30213142.45
ANDREW.LADD,20142015,WPG,1707.8166666666666,24,25,14,39,63,49,7,21,14,237,402,237,78,10,35,1860,1378,1158,988,46,37,0.3333333333333333,30213143.63
ANDREW.MACDONALD,20142015,PHI,1160.7833333333333,2,4,6,10,12,6,0,0,0,62,152,35,54,9,19,975,1048,806,837,28,29,0,30213105.54
ANDREW.MACWILLIAM,20142015,TOR,184.83333333333331,0,0,1,1,1,0,0,1,1,5,13,35,6,3,6,118,214,106,157,2,8,0,30213040.855
ANDREW.SHAW,20142015,CHI,1538.5333333333333,20,7,11,18,38,27,442,882,440,191,311,185,64,36,36,1783,1132,1183,1035,32,50,0.5011337868480725,30213155.765
ANDY.ANDREOFF,20142015,L.A,154.23333333333335,2,0,1,1,3,2,32,61,29,14,28,33,4,3,6,126,139,123,136,2,2,0.5245901639344263,30213040.085
ANDY.GREENE,20142015,N.J,1930.6333333333334,3,7,10,17,20,10,0,0,0,83,216,82,76,11,10,1305,1959,1139,1235,43,43,0,30213145.41
ANTHONY.BITETTO,20142015,NSH,82.45,0,0,0,0,0,0,1,1,0,2,7,9,3,2,2,73,80,73,76,1,2,1,30213030.06
ANTHONY.DUCLAIR,20142015,NYR,218.81666666666666,1,4,2,6,7,5,0,0,0,18,36,6,10,4,2,207,162,162,153,8,3,0,30213038.939999998
ANTHONY.PELUSO,20142015,WPG,287.96666666666664,1,1,0,1,2,2,0,1,1,23,42,100,10,13,21,218,226,218,220,7,9,0,30213047.78
ANTOINE.ROUSSEL,20142015,DAL,1161.75,13,6,6,12,25,19,3,17,14,113,206,115,37,32,41,1133,1253,980,960,33,51,0.17647058823529413,30213132.64
ANTOINE.VERMETTE,20142015,ARI,1195.8166666666666,13,14,7,21,34,27,774,1380,606,85,146,71,32,6,16,1148,1158,746,820,29,48,0.5608695652173913,30213145.645
ANTOINE.VERMETTE,20142015,CHI,529.8666666666667,4,2,3,5,9,6,264,478,214,40,75,52,16,2,3,490,488,457,468,17,15,0.5523012552301255,30213079.555
ANTON.LANDER,20142015,EDM,570.45,6,6,8,14,20,12,226,451,225,61,88,59,13,4,7,569,515,409,432,14,24,0.5011086474501109,30213084.03
ANTON.STRALMAN,20142015,T.B,2384.95,10,19,17,36,46,29,0,0,0,190,366,154,119,15,17,2132,1976,1608,1285,82,63,0,30213135.625
ANTON.VOLCHENKOV,20142015,NSH,620.05,0,1,6,7,7,1,0,0,0,35,80,93,29,3,8,547,561,528,497,25,20,0,30213066.53
ANZE.KOPITAR,20142015,L.A,1530.3166666666666,16,30,18,48,64,46,751,1429,678,134,254,105,63,19,5,1672,1162,1148,790,45,37,0.5255423372988104,30213130.48
ARTEM.ANISIMOV,20142015,CBJ,851.8,7,15,5,20,27,22,102,229,127,88,175,32,39,7,4,759,765,560,543,25,35,0.44541484716157204,30213090.275
B.J..CROMBEEN,20142015,ARI,469.48333333333335,3,1,2,3,6,4,1,1,0,43,83,68,24,17,25,364,487,362,482,10,17,1,30213080.46
BARCLAY.GOODROW,20142015,S.J,664.3000000000001,4,7,1,8,12,11,12,23,11,67,130,76,37,9,12,562,627,514,569,17,20,0.5217391304347826,30213086.445
BARRET.JACKMAN,20142015,STL,1423.2333333333333,2,6,6,12,14,8,0,0,0,87,164,111,48,19,18,1162,1270,1088,974,38,40,0,30213113.69
BEAU.BENNETT,20142015,PIT,627.9333333333334,4,6,2,8,12,10,0,2,2,83,150,68,38,5,7,591,490,530,461,20,19,0,30213068.05
BEN.CHIAROT,20142015,WPG,707.2666666666667,2,4,1,5,7,6,0,0,0,39,93,77,36,5,9,648,615,601,534,24,21,0,30213070.575000003
BEN.LOVEJOY,20142015,ANA,741.45,1,3,6,9,10,4,0,0,0,50,101,98,27,3,7,648,739,592,581,20,19,0,30213079.380000003
BEN.LOVEJOY,20142015,PIT,538.95,1,2,2,4,5,3,0,0,0,46,93,77,29,1,4,492,513,436,366,11,19,0,30213054.46
BEN.SMITH,20142015,CHI,828.7,5,4,0,4,9,9,231,452,221,77,134,49,26,6,1,626,876,580,590,15,16,0.5110619469026548,30213094.35
BEN.SMITH,20142015,S.J,215.46666666666667,2,1,2,3,5,3,78,141,63,15,27,23,6,2,0,175,210,163,162,4,2,0.5531914893617021,30213042.39
BEN.STREET,20142015,COL,34.78333333333333,0,0,0,0,0,0,17,32,15,4,7,3,2,0,0,30,45,30,44,2,2,0.53125,30213027.78
BENOIT.POULIOT,20142015,EDM,964.0833333333333,19,11,4,15,34,30,12,33,21,105,173,71,17,14,13,970,839,709,699,36,36,0.36363636363636365,30213111.87
BLAIR.JONES,20142015,PHI,27.666666666666668,0,0,0,0,0,0,5,10,5,0,2,7,1,1,1,18,31,18,31,0,4,0.5,30213026.46
BLAKE.COMEAU,20142015,PIT,1003.3833333333332,17,10,5,15,32,27,8,12,4,151,282,202,84,12,29,1048,862,889,793,36,30,0.6666666666666666,30213108.915
BLAKE.WHEELER,20142015,WPG,1630.2333333333333,27,24,11,35,62,51,22,49,27,255,439,139,76,18,29,1777,1306,1122,969,50,30,0.4489795918367347,30213144.185000002
BO.HORVAT,20142015,VAN,909.9666666666667,14,9,5,14,28,23,475,912,437,102,157,79,25,7,9,740,991,684,834,32,38,0.5208333333333334,30213143.595
BOBBY.FARNHAM,20142015,PIT,78.93333333333334,0,0,0,0,0,0,0,0,0,6,14,26,4,11,6,62,69,56,69,1,1,0,30213030.61
BOBBY.ROBINS,20142015,BOS,22.75,0,0,0,0,0,0,0,0,0,0,0,6,0,4,4,12,19,12,19,0,0,0,30213025.39
BOBBY.RYAN,20142015,OTT,1454.65,20,18,17,35,55,38,5,18,13,232,393,123,93,19,14,1612,1233,1054,1094,47,44,0.2777777777777778,30213152.564999998
BOGDAN.YAKIMOV,20142015,EDM,11.316666666666666,0,0,0,0,0,0,3,7,4,1,1,2,0,0,0,8,5,8,5,0,1,0.42857142857142855,15106511.82
BOONE.JENNER,20142015,CBJ,566.3666666666667,9,6,2,8,17,15,151,306,155,83,137,102,29,13,5,527,548,378,410,20,21,0.4934640522875817,30213078.77
BORNA.RENDULIC,20142015,COL,103.41666666666667,1,1,0,1,2,2,0,0,0,6,11,22,4,0,3,82,89,76,85,6,5,0,30213031.95
BOYD.GORDON,20142015,EDM,906.1333333333333,6,3,4,7,13,9,681,1217,536,65,114,31,20,10,7,637,971,511,657,14,24,0.5595727198027938,30213120.939999998
BRAD.BOYES,20142015,FLA,1220.7333333333333,14,18,6,24,38,32,97,173,76,151,261,60,48,5,9,1162,902,875,822,42,30,0.5606936416184971,30213120.48
BRAD.HUNT,20142015,EDM,214.33333333333331,1,2,0,2,3,3,0,0,0,20,49,8,16,1,0,214,199,160,166,5,11,0,30213039.060000002
BRAD.MALONE,20142015,CAR,659.7833333333333,7,5,3,8,15,12,30,49,19,65,NA,162,NA,18,24,NA,NA,NA,NA,18,24,0.6122448979591837,NA
BRAD.MARCHAND,20142015,BOS,1301.3333333333335,24,14,4,18,42,38,13,33,20,180,311,72,67,28,39,1393,1088,1126,872,43,42,0.3939393939393939,30213121.299999997
BRAD.RICHARDS,20142015,CHI,1516.2833333333333,15,21,15,36,51,36,550,1129,579,249,411,51,90,9,11,1665,1251,1317,1187,63,43,0.4871567759078831,30213172.564999998
BRAD.RICHARDSON,20142015,VAN,714.2666666666667,8,6,7,13,21,14,298,626,328,72,122,61,32,9,16,569,754,516,551,20,25,0.476038338658147,30213100.485
BRAD.STUART,20142015,COL,1321,3,4,6,10,13,7,1,1,0,64,128,177,34,7,8,864,1581,760,1161,36,35,1,30213157.36
BRANDON.BOLLIG,20142015,CGY,608.8,3,1,3,4,7,4,3,5,2,82,142,156,34,15,30,469,613,451,604,12,22,0.6,30213095.345
BRANDON.DAVIDSON,20142015,EDM,181.65,1,0,0,0,1,1,0,0,0,7,20,18,6,1,0,137,178,132,162,7,10,0,30213039.310000002
BRANDON.DEFAZIO,20142015,VAN,11.883333333333333,0,0,0,0,0,0,0,0,0,2,4,0,1,1,0,11,12,11,12,0,0,0,30213023.71
BRANDON.DUBINSKY,20142015,CBJ,848.8833333333333,13,11,11,22,35,24,436,859,423,100,170,152,41,17,17,770,765,558,511,31,22,0.5075669383003493,30213100.935
BRANDON.GORMLEY,20142015,ARI,413.7,2,1,1,2,4,3,0,0,0,39,74,26,27,4,5,364,456,328,345,10,14,0,30213057.064999998
BRANDON.KOZUN,20142015,TOR,158.21666666666667,2,1,1,2,4,3,1,2,1,8,16,21,8,2,3,111,149,105,133,5,9,0.5,30213038.185
BRANDON.MANNING,20142015,PHI,188.78333333333333,0,2,1,3,3,2,0,0,0,10,24,19,8,1,2,143,179,133,129,6,3,0,30213035.085
BRANDON.MCMILLAN,20142015,ARI,518.9333333333334,1,0,2,2,3,1,9,21,12,44,87,81,23,11,8,374,562,357,406,5,23,0.42857142857142855,30213066.22
BRANDON.MCMILLAN,20142015,VAN,105.91666666666666,1,0,1,1,2,1,1,2,1,10,19,16,5,2,2,93,106,92,102,4,4,0.5,30213033.485
BRANDON.PIRRI,20142015,FLA,723.7166666666667,22,1,1,2,24,23,86,175,89,142,242,39,44,12,7,735,572,574,523,20,14,0.49142857142857144,30213090.535
BRANDON.PRUST,20142015,MTL,1228.6166666666668,5,13,4,17,22,18,18,33,15,98,159,148,30,29,38,882,1224,824,933,31,25,0.5454545454545454,30213134.509999998
BRANDON.SAAD,20142015,CHI,1881.5166666666669,31,16,14,30,61,47,44,98,54,262,427,99,81,36,9,1948,1620,1506,1298,65,52,0.4489795918367347,30213168.619999997
BRANDON.SUTTER,20142015,PIT,1465.7,22,7,6,13,35,29,722,1426,704,192,295,98,49,18,7,1218,1370,901,925,28,26,0.5063113604488079,30213163.16
BRAYDEN.MCNABB,20142015,L.A,1128.8333333333335,2,8,11,19,21,10,1,1,0,74,196,175,72,17,19,1112,851,975,736,40,25,1,30213080.685000002
BRAYDEN.SCHENN,20142015,PHI,1400.5666666666666,18,21,8,29,47,39,86,184,98,155,298,197,67,21,14,1609,1156,1009,1021,32,32,0.4673913043478261,30213149.2
BRAYDON.COBURN,20142015,PHI,789.3,1,4,4,8,9,5,0,0,0,45,107,56,34,5,8,624,760,552,529,19,25,0,30213073
BRAYDON.COBURN,20142015,T.B,509.9,1,1,3,4,5,2,0,0,0,40,74,58,26,6,12,338,554,320,435,12,14,0,30213071.385
BRENDAN.GALLAGHER,20142015,MTL,1576.5,27,18,7,25,52,45,43,102,59,296,533,62,149,26,14,1926,1319,1418,1211,56,37,0.4215686274509804,30213151.505
BRENDAN.RANFORD,20142015,DAL,9.316666666666666,0,0,0,0,0,0,0,0,0,0,2,2,1,0,0,13,8,13,8,0,0,0,15106511.65
BRENDAN.SHINNIMIN,20142015,ARI,132.41666666666669,0,0,1,1,1,0,42,101,59,10,23,12,8,3,4,116,116,107,109,1,1,0.4158415841584158,30213035.884999998
BRENDAN.SMITH,20142015,DET,1440.1666666666665,4,3,5,8,12,7,0,0,0,94,196,75,66,27,34,1240,1080,1125,901,36,42,0,30213100.994999997
BRENDAN.WOODS,20142015,CAR,12.066666666666666,0,0,0,0,0,0,0,0,0,3,4,2,1,0,0,6,15,6,15,0,1,0,15106513.2
BRENDEN.DILLON,20142015,DAL,412.29999999999995,0,0,0,0,0,0,0,0,0,16,64,27,27,7,9,370,419,346,334,11,15,0,30213051.82
BRENDEN.DILLON,20142015,S.J,1153.3833333333332,2,3,4,7,9,5,0,0,0,75,202,127,85,15,21,1110,1146,1031,955,32,46,0,30213107.05
BRENDEN.MORROW,20142015,T.B,860.9333333333334,3,4,1,5,8,7,0,1,1,41,81,163,17,21,31,686,669,660,652,19,22,0,30213093.235
BRENT.BURNS,20142015,S.J,1964.3666666666668,17,24,16,40,57,41,0,0,0,245,593,148,208,13,NA,2372,1818,1582,1375,57,63,0,NA
BRENT.SEABROOK,20142015,CHI,2423.2666666666664,15,12,14,26,41,27,0,0,0,225,509,206,176,10,17,2539,2234,1952,1769,69,65,0,30213185.55
BRETT.BELLEMORE,20142015,CAR,802.3833333333334,2,5,3,8,10,7,0,0,0,26,62,148,14,7,12,614,706,582,631,23,23,0,30213090.045
BRETT.CONNOLLY,20142015,BOS,71.81666666666666,0,0,2,2,2,0,0,1,1,9,14,12,2,2,5,86,50,62,47,1,2,0,30213027.42
BRETT.CONNOLLY,20142015,T.B,596.4333333333334,12,2,1,3,15,14,18,42,24,74,129,78,30,5,17,576,386,432,355,18,13,0.42857142857142855,30213063.845
BRETT.KULAK,20142015,CGY,19.516666666666666,0,0,0,0,0,0,0,0,0,0,1,0,1,0,1,16,10,14,9,1,1,0,15106511.75
BRETT.RITCHIE,20142015,DAL,433.56666666666666,6,1,2,3,9,7,1,4,3,78,139,89,32,6,7,514,316,364,291,13,12,0.25,30213051.25
BRETT.SUTTER,20142015,MIN,55.85,0,3,0,3,3,3,0,0,0,6,10,16,2,1,2,38,55,38,44,3,1,0,30213028.71
BRIAN.BOYLE,20142015,T.B,1406.9833333333333,16,7,3,10,26,23,599,1189,590,175,287,202,61,24,25,998,1441,876,916,28,34,0.503784693019344,30213154.275
BRIAN.CAMPBELL,20142015,FLA,1903.0833333333335,3,13,10,23,26,16,0,0,0,118,219,44,63,5,11,1851,1398,1355,1123,53,47,0,30213123.4
BRIAN.DUMOULIN,20142015,PIT,195.88333333333333,1,0,0,0,1,1,0,0,0,10,15,12,2,1,1,146,165,121,144,7,6,0,30213038.060000002
BRIAN.FERLIN,20142015,BOS,61.56666666666666,0,1,0,1,1,1,0,1,1,6,15,20,6,0,0,38,45,38,44,1,1,0,30213027.05
BRIAN.FLYNN,20142015,BUF,857.8499999999999,5,8,3,11,16,13,157,329,172,73,118,37,22,4,4,533,980,436,734,24,26,0.47720364741641336,30213123.345
BRIAN.FLYNN,20142015,MTL,147.6,1,2,0,2,3,3,23,41,18,19,30,11,6,4,0,118,156,109,137,3,7,0.5609756097560976,30213039.71
BRIAN.GIBBONS,20142015,CBJ,345.58333333333337,0,3,2,5,5,3,4,9,5,21,38,14,7,2,4,245,329,208,245,6,3,0.4444444444444444,30213050.58
BRIAN.GIONTA,20142015,BUF,1245.75,13,12,10,22,35,25,69,168,99,153,253,61,51,13,9,991,1358,712,1055,28,35,0.4107142857142857,30213163.14
BRIAN.LASHOFF,20142015,DET,145.86666666666667,0,0,2,2,2,0,0,0,0,7,12,7,2,0,3,116,132,112,110,6,2,0,30213033.15
BRIAN.MCGRATTAN,20142015,CGY,53.06666666666667,0,0,0,0,0,0,0,0,0,10,15,11,1,1,2,47,61,42,60,0,2,0,30213030.06
BRIAN.STRAIT,20142015,NYI,1087.0666666666666,2,0,4,4,6,2,0,1,1,63,124,137,37,4,17,917,1235,858,995,36,44,0,30213125.39
BROCK.NELSON,20142015,NYI,1388.4333333333334,22,10,11,21,43,32,374,846,472,198,332,105,73,26,11,1536,1169,1042,935,45,36,0.44208037825059104,30213146.345
BRODY.SUTTER,20142015,CAR,29.75,0,0,0,0,0,0,7,14,7,0,2,3,1,0,0,20,26,20,26,0,2,0.5,15106514.28
BROOKS.LAICH,20142015,WSH,1138.8166666666666,8,8,6,14,22,16,125,278,153,121,195,126,41,12,12,933,1219,812,832,28,29,0.44964028776978415,30213121.17
BROOKS.ORPIK,20142015,WSH,2011.0833333333333,0,8,12,20,20,8,0,0,0,82,199,380,89,18,36,1722,2249,1571,1597,69,65,0,30213174.78
BRYAN.ALLEN,20142015,ANA,109.25,0,1,0,1,1,1,0,0,0,4,22,11,9,0,2,107,106,95,78,4,5,0,30213028.55
BRYAN.ALLEN,20142015,MTL,63.7,0,0,1,1,1,0,0,0,0,2,8,9,6,0,1,52,64,50,54,1,3,0,30213027.375
BRYAN.BICKELL,20142015,CHI,1227.9166666666667,14,10,9,19,33,24,0,2,2,131,238,306,59,23,25,1255,1066,1136,1030,43,34,0,30213131.505000003
BRYAN.LERG,20142015,S.J,25.200000000000003,1,0,0,0,1,1,4,4,0,8,9,3,0,1,0,32,20,28,19,1,1,1,15106513.62
BRYAN.LITTLE,20142015,WPG,1471.4166666666667,26,15,12,27,53,41,809,1639,830,157,289,61,73,23,12,1587,1208,976,844,38,31,0.4935936546674802,30213154.29
BRYAN.RUST,20142015,PIT,168.26666666666665,1,0,1,1,2,1,0,0,0,34,48,21,9,4,1,167,141,147,138,5,8,0,30213036.415
BRYCE.SALVADOR,20142015,N.J,277.5333333333333,0,2,0,2,2,2,0,0,0,13,27,22,10,4,7,159,288,151,173,5,10,0,30213041.490000002
CAL.CLUTTERBUCK,20142015,NYI,1057.1166666666666,9,9,1,10,19,18,5,9,4,136,242,382,47,24,29,893,991,817,756,23,26,0.5555555555555556,30213107.415
CALLE.JARNKROK,20142015,NSH,1049.7333333333333,7,7,6,13,20,14,337,722,385,103,193,37,46,16,9,905,921,835,731,30,30,0.4667590027700831,30213110.740000002
CALVIN.DE HAAN,20142015,NYI,1322.4,1,5,6,11,12,6,0,0,0,95,218,154,76,11,13,1231,1296,1135,1035,40,43,0,30213114.31
CAM.ATKINSON,20142015,CBJ,1325.3000000000002,22,8,9,17,39,30,4,9,5,212,337,55,62,9,11,1320,1195,928,1001,34,36,0.4444444444444444,30213144.875
CAM.FOWLER,20142015,ANA,2060.3500000000004,8,14,21,35,43,22,0,0,0,114,240,56,81,3,8,1984,1824,1421,1416,60,60,0,30213164.505000003
CAMERON.SCHILLING,20142015,WSH,45.5,0,0,0,0,0,0,0,0,0,2,7,4,3,0,2,41,24,41,24,2,1,0,30213023.700000003
CARL.GUNNARSSON,20142015,STL,1209.0333333333333,2,3,5,8,10,5,0,0,0,56,124,45,42,7,0,1008,1064,900,898,43,37,0,30213105.744999997
CARL.HAGELIN,20142015,NYR,1564.9166666666665,19,11,10,21,40,30,6,17,11,219,389,113,88,30,25,1320,1517,1206,1171,53,44,0.35294117647058826,30213152.29
CARL.KLINGBERG,20142015,WPG,6.616666666666667,0,0,0,0,0,0,0,0,0,0,0,2,0,1,0,4,5,4,5,0,1,0,30213023.060000002
CARL.SODERBERG,20142015,BOS,1378.4166666666665,13,19,12,31,44,32,368,765,397,163,312,75,89,11,12,1430,1065,1024,972,42,34,0.48104575163398694,30213144.13
CARLO.COLAIACOVO,20142015,PHI,544,2,4,2,6,8,6,0,0,0,42,108,46,36,1,5,563,429,501,408,14,11,0,30213057.759999998
CARTER.ASHTON,20142015,TOR,43.56666666666666,0,0,0,0,0,0,1,5,4,4,7,6,2,1,0,28,45,28,43,0,3,0.2,30213027.65
CASEY.BAILEY,20142015,TOR,54.21666666666667,1,0,0,0,1,1,0,0,0,9,11,3,1,1,1,42,40,42,40,2,1,0,30213027.259999998
CASEY.CIZIKAS,20142015,NYI,972.0333333333333,10,4,5,9,19,14,489,946,457,101,185,160,46,17,10,781,913,722,692,24,29,0.5169133192389006,30213113.955
CEDRIC.PAQUETTE,20142015,T.B,1178.25,15,4,3,7,22,19,168,387,219,108,192,189,34,33,30,831,1177,766,800,20,28,0.43410852713178294,30213128.525
CHAD.RUHWEDEL,20142015,BUF,49.85,0,1,0,1,1,1,0,0,0,4,6,6,2,0,0,42,47,39,47,3,0,0,30213027.6
CHARLIE.COYLE,20142015,MIN,1337.1,12,13,12,25,37,25,377,822,445,134,233,169,47,20,16,1253,1150,1033,1047,53,45,0.4586374695863747,30213157.130000003
CHRIS.BROWN,20142015,WSH,32.3,1,0,0,0,1,1,1,3,2,4,4,6,0,0,1,18,36,18,36,1,0,0.3333333333333333,30213027.99
CHRIS.BUTLER,20142015,STL,567.3,3,3,3,6,9,6,0,0,0,54,91,31,27,9,10,514,485,468,457,31,26,0,30213067.215
CHRIS.CONNER,20142015,WSH,17.633333333333333,0,0,0,0,0,0,0,0,0,3,7,0,2,0,2,25,15,25,15,1,0,0,30213023.5
CHRIS.HIGGINS,20142015,VAN,1315.4666666666667,13,17,8,25,38,30,3,9,6,186,311,79,60,16,9,1215,1245,946,919,43,38,0.3333333333333333,30213127.73
CHRIS.KELLY,20142015,BOS,1211.2666666666664,7,9,10,19,26,16,262,539,277,112,188,126,34,18,17,978,1120,893,836,32,30,0.48608534322820035,30213123.509999998
CHRIS.KREIDER,20142015,NYR,1584.6,28,18,8,26,54,46,9,22,13,218,362,240,57,26,36,1679,1353,1251,1263,62,36,0.4090909090909091,30213178.770000003
CHRIS.KUNITZ,20142015,PIT,1413.2333333333333,18,17,8,25,43,35,7,13,6,176,325,234,80,14,22,1650,1003,1156,888,47,38,0.5384615384615384,30213113.87
CHRIS.MUELLER,20142015,NYR,73.16666666666666,1,0,1,1,2,1,37,63,26,10,16,3,3,1,0,77,61,50,55,2,3,0.5873015873015873,30213029.715
CHRIS.NEIL,20142015,OTT,384.45,4,2,1,3,7,6,3,5,2,24,49,148,12,18,19,297,343,280,337,10,8,0.6,30213064.025
CHRIS.PHILLIPS,20142015,OTT,752.2666666666667,0,2,1,3,3,2,0,0,0,29,69,70,28,3,7,530,847,473,594,17,20,0,30213084.905
CHRIS.PORTER,20142015,STL,253.83333333333331,1,1,1,2,3,2,4,10,6,26,49,69,6,1,3,210,191,210,184,4,7,0.4,30213041.445
CHRIS.STEWART,20142015,BUF,976.1,11,11,3,14,25,22,10,37,27,115,178,82,26,16,26,739,1076,531,979,22,43,0.2702702702702703,30213160.634999998
CHRIS.STEWART,20142015,MIN,437.95000000000005,3,7,3,10,13,10,1,7,6,48,77,43,17,9,9,390,332,311,320,13,14,0.14285714285714285,30213060.755
CHRIS.SUMMERS,20142015,ARI,233.15000000000003,0,1,1,2,2,1,0,0,0,13,27,40,10,1,4,166,279,161,222,2,13,0,30213047.835
CHRIS.SUMMERS,20142015,NYR,51.766666666666666,0,0,0,0,0,0,0,0,0,2,6,9,4,0,0,35,50,33,45,1,2,0,30213026.950000003
CHRIS.TANEV,20142015,VAN,1607.6666666666667,2,7,13,20,22,9,0,0,0,57,138,26,48,10,7,1349,1458,1172,1082,40,40,0,30213123.225
CHRIS.TERRY,20142015,CAR,725.15,11,7,2,9,20,18,6,11,5,71,133,44,29,7,7,737,600,615,572,21,22,0.5454545454545454,30213086.61
CHRIS.THORBURN,20142015,WPG,684.95,7,2,5,7,14,9,37,60,23,71,130,132,35,22,23,571,610,556,595,20,26,0.6166666666666667,30213090.075
CHRIS.TIERNEY,20142015,S.J,526.6500000000001,6,10,5,15,21,16,150,342,192,48,89,11,23,10,3,505,524,442,492,21,19,0.43859649122807015,30213088.725
CHRIS.VANDEVELDE,20142015,PHI,844.5333333333333,9,3,3,6,15,12,21,56,35,70,121,121,25,12,13,613,876,578,665,22,29,0.375,30213101.585
CHRIS.WAGNER,20142015,ANA,90.18333333333334,0,0,0,0,0,0,36,62,26,7,15,26,5,2,1,61,66,60,64,1,3,0.5806451612903226,30213029.66
CHRISTIAN.EHRHOFF,20142015,PIT,1066.1833333333334,3,6,5,11,14,9,0,0,0,110,225,73,58,11,14,998,968,783,740,38,28,0,30213093.435000002
CHRISTIAN.FOLIN,20142015,MIN,608,2,5,3,8,10,7,0,0,0,39,86,45,29,3,5,526,542,494,477,25,21,0,30213068.355
CHRISTIAN.THOMAS,20142015,MTL,163.71666666666667,1,0,0,0,1,1,0,1,1,26,46,7,13,3,2,152,116,149,115,1,3,0,30213032.58
CLARKE.MACARTHUR,20142015,OTT,1150.1666666666665,18,13,7,20,38,31,8,23,15,155,269,94,63,24,21,1272,992,844,830,35,35,0.34782608695652173,30213122.185000002
CLAUDE.GIROUX,20142015,PHI,1665.7666666666667,25,20,26,46,71,45,1063,1878,815,279,512,110,152,21,17,2002,1388,1246,1109,44,41,0.566027689030884,30213174.43
CLAYTON.STONER,20142015,ANA,1505.9333333333334,2,7,0,7,9,9,0,0,0,84,187,188,66,16,26,1321,1443,1205,1181,46,51,0,30213136.11
CODY.CECI,20142015,OTT,1670.45,5,10,8,18,23,15,0,0,0,135,256,100,77,5,3,1444,1680,1166,1239,46,50,0,30213148.450000003
CODY.EAKIN,20142015,DAL,1341.0833333333335,19,6,15,21,40,25,656,1290,634,142,268,62,62,15,13,1309,1368,1009,1001,48,49,0.5085271317829457,30213157.765
CODY.FRANSON,20142015,NSH,427.73333333333335,1,4,1,5,6,5,0,0,0,41,78,38,25,0,1,451,333,379,298,14,14,0,30213047.575
CODY.FRANSON,20142015,TOR,1176.2333333333333,6,11,14,25,31,17,0,0,0,92,187,153,57,0,9,1160,1157,764,851,43,43,0,30213114.2
CODY.GOLOUBEF,20142015,CBJ,560.35,0,5,3,8,8,5,0,0,0,23,67,44,20,3,8,468,486,439,435,23,12,0,30213064.705
CODY.HODGSON,20142015,BUF,1002.0333333333333,6,5,2,7,13,11,173,377,204,127,229,39,62,12,7,779,1023,608,963,18,41,0.4588859416445623,30213147.64
CODY.MCCORMICK,20142015,BUF,386.54999999999995,1,3,0,3,4,4,147,294,147,31,55,77,15,11,13,201,483,186,341,5,15,0.5,30213073.19
CODY.MCLEOD,20142015,COL,917.0666666666666,7,1,4,5,12,8,1,9,8,94,134,267,20,37,51,594,983,482,776,23,26,0.1111111111111111,30213127.21
COLBY.ROBAK,20142015,ANA,76.28333333333333,0,0,1,1,1,0,0,0,0,2,6,7,2,0,0,60,75,55,60,5,2,0,30213027.875
COLBY.ROBAK,20142015,FLA,90.73333333333333,0,0,0,0,0,0,0,0,0,6,10,9,2,1,1,73,70,73,70,2,3,0,30213029.21
COLIN.FRASER,20142015,STL,4.7,0,0,0,0,0,0,0,0,0,1,1,1,0,0,0,2,8,2,8,0,1,0,15106512.4
COLIN.GREENING,20142015,OTT,255.36666666666667,1,0,0,0,1,1,6,9,3,40,63,85,14,7,9,235,222,233,221,2,9,0.6666666666666666,30213045.810000002
COLIN.MCDONALD,20142015,NYI,212.63333333333333,2,4,2,6,8,6,2,4,2,30,52,84,10,4,1,202,206,194,204,9,11,0.5,30213046.07
COLIN.SMITH,20142015,COL,6.1,0,0,0,0,0,0,4,10,6,1,1,1,0,0,0,4,5,4,5,0,0,0.4,15106512.11
COLIN.WILSON,20142015,NSH,1366.6833333333334,25,17,5,22,47,42,75,187,112,191,309,56,66,15,10,1557,1095,1158,987,49,30,0.40106951871657753,30213138.674999997
COLTON.ORR,20142015,TOR,6.1,0,0,0,0,0,0,0,0,0,0,0,0,0,0,0,0,5,0,5,0,0,0,15106512
COLTON.SCEVIOUR,20142015,DAL,902.8666666666667,9,5,12,17,26,14,30,71,41,112,229,77,62,6,6,958,793,827,717,35,31,0.4225352112676056,30213092.41
CONNOR.MURPHY,20142015,ARI,1226.4499999999998,4,1,2,3,7,5,0,0,0,72,160,137,51,12,18,958,1354,872,1061,27,50,0,30213136.27
CONOR.ALLEN,20142015,NYR,48.8,0,0,0,0,0,0,0,0,0,2,4,6,2,0,2,47,36,42,34,1,2,0,30213025.45
CORBAN.KNIGHT,20142015,CGY,12.8,0,0,0,0,0,0,9,11,2,2,4,4,1,0,0,11,10,11,10,0,0,0.8181818181818182,30213023.41
COREY.PERRY,20142015,ANA,1531.25,43,20,9,29,72,63,3,14,11,257,456,93,100,33,35,1671,1238,1157,1078,66,50,0.21428571428571427,30213162.175
COREY.POTTER,20142015,CGY,67.46666666666667,0,0,0,0,0,0,0,0,0,3,6,6,1,0,0,63,55,61,53,1,3,0,30213027.25
COREY.TROPP,20142015,CBJ,533.9666666666667,1,4,3,7,8,5,1,2,1,22,46,80,10,12,22,331,536,328,528,11,23,0.5,30213089.835
CORY.CONACHER,20142015,NYI,202.2,1,0,2,2,3,1,1,3,2,23,32,19,3,5,3,187,183,170,173,8,9,0.3333333333333333,30213040.89
CRAIG.ADAMS,20142015,PIT,682.1833333333334,1,3,3,6,7,4,17,40,23,51,76,183,12,8,11,389,710,351,387,10,14,0.425,30213067.535
CRAIG.CUNNINGHAM,20142015,ARI,210.63333333333333,1,2,1,3,4,3,22,42,20,23,30,37,2,2,1,138,253,133,203,4,7,0.5238095238095238,30213049.375
CRAIG.CUNNINGHAM,20142015,BOS,323.5,2,1,0,1,3,3,47,94,47,31,46,70,8,2,1,225,292,210,247,5,9,0.5,30213052.65
CRAIG.SMITH,20142015,NSH,1413.5833333333335,25,11,13,24,49,36,17,44,27,284,469,95,90,21,20,1663,1123,1242,1035,64,43,0.38636363636363635,30213135.665
CURTIS.GLENCROSS,20142015,CGY,884.1,9,11,7,18,27,20,6,15,9,87,160,102,34,8,14,816,798,583,727,24,23,0.4,30213113.494999997
CURTIS.GLENCROSS,20142015,WSH,331.05,5,1,2,3,8,6,2,3,1,35,62,32,13,2,3,303,280,246,261,6,10,0.6666666666666666,30213052.950000003
CURTIS.HAMILTON,20142015,EDM,8.016666666666667,0,0,0,0,0,0,0,0,0,0,0,4,0,0,1,6,17,4,17,0,0,0,15106513.75
CURTIS.LAZAR,20142015,OTT,947.2666666666667,6,7,2,9,15,13,130,274,144,101,184,195,47,10,7,859,858,826,786,32,34,0.4744525547445255,30213107.549999997
CURTIS.MCKENZIE,20142015,DAL,415.20000000000005,4,1,0,1,5,5,3,8,5,41,77,85,11,14,14,397,388,393,385,8,16,0.375,30213065.61
DAINIUS.ZUBRUS,20142015,N.J,1084.7666666666667,4,4,2,6,10,8,37,86,49,72,105,99,13,12,20,705,982,661,770,24,31,0.43023255813953487,30213113.35
DALE.WEISE,20142015,MTL,1112.4833333333333,12,16,4,20,32,28,5,12,7,118,198,183,41,24,18,931,1151,897,1023,46,24,0.4166666666666667,30213144.689999998
DALTON.PROUT,20142015,CBJ,1160.1666666666667,0,4,4,8,8,4,0,0,0,64,130,166,50,22,27,815,1141,767,864,28,41,0,30213112.02
DAMIEN.BRUNNER,20142015,N.J,257.5,2,3,2,5,7,5,2,4,2,29,59,7,16,1,3,247,164,166,149,4,3,0.5,30213038.740000002
DAMON.SEVERSON,20142015,N.J,1120.1166666666666,5,2,10,12,17,7,0,1,1,93,205,19,65,2,11,972,899,754,752,23,32,0,30213096.119999997
DAN.BOYLE,20142015,NYR,1692.1833333333334,12,5,13,18,30,17,0,0,0,148,320,71,110,7,11,1785,1332,1315,1143,45,32,0,30213126.195
DAN.CARCILLO,20142015,CHI,319.3833333333333,4,3,1,4,8,7,0,1,1,42,72,36,11,18,13,293,296,293,295,11,8,0,30213057.604999997
DAN.CLEARY,20142015,DET,155.26666666666665,1,0,1,1,2,1,2,4,2,17,28,21,6,1,3,132,128,128,111,2,6,0.5,30213033.715
DAN.GIRARDI,20142015,NYR,2271.6833333333334,4,10,10,20,24,14,0,0,0,139,277,268,89,14,13,1919,2318,1519,1772,76,69,0,30213205.69
DAN.HAMHUIS,20142015,VAN,1388.3,1,11,11,22,23,12,0,0,0,87,192,87,72,15,23,1246,1218,967,900,40,49,0,30213107.875
DANA.TYRELL,20142015,CBJ,20.816666666666666,0,0,0,0,0,0,0,0,0,1,1,5,0,0,0,13,33,13,33,0,1,0,30213026.85
DANIEL.BRIERE,20142015,COL,690.95,8,1,3,4,12,9,13,24,11,69,113,19,17,9,9,559,655,437,617,14,22,0.5416666666666666,30213100.235
DANIEL.PAILLE,20142015,BOS,817.4333333333334,6,6,1,7,13,12,2,7,5,66,117,77,15,5,6,577,829,543,646,12,22,0.2857142857142857,30213100.255000003
DANIEL.SEDIN,20142015,VAN,1614.4166666666665,22,36,20,56,78,58,7,14,7,248,405,22,81,14,9,1710,1157,1122,933,42,41,0.5,30213138.77
DANIEL.WINNIK,20142015,PIT,407.6833333333333,2,5,2,7,9,7,19,45,26,29,51,31,12,5,5,328,435,302,265,12,11,0.4222222222222222,30213051.21
DANIEL.WINNIK,20142015,TOR,976.4166666666667,7,12,5,17,24,19,90,186,96,70,129,99,25,17,7,724,1085,668,701,29,17,0.4838709677419355,30213106.645
DANIIL.TARASOV,20142015,S.J,37.85,0,0,0,0,0,0,1,1,0,5,7,2,1,0,0,38,30,30,30,2,0,1,30213025.29
DANNY.BIEGA,20142015,CAR,161.41666666666666,0,0,2,2,2,0,0,0,0,7,25,27,11,2,0,156,124,150,114,5,8,0,30213030.22
DANNY.DEKEYSER,20142015,DET,1823.75,3,10,15,25,28,13,0,0,0,92,229,84,77,14,27,1510,1476,1191,1056,54,50,0,30213119.215
DANY.HEATLEY,20142015,ANA,72.75,0,0,0,0,0,0,0,0,0,8,13,5,2,0,0,59,67,48,64,1,4,0,30213029.65
DARNELL.NURSE,20142015,EDM,33.983333333333334,0,0,0,0,0,0,0,0,0,2,4,5,2,0,0,33,27,31,24,2,4,0,15106512.8
DARREN.HELM,20142015,DET,1322.5500000000002,15,13,8,21,36,28,224,421,197,169,296,155,65,23,8,1321,998,991,745,36,38,0.5320665083135392,30213105.29
DAVE.BOLLAND,20142015,FLA,865.55,6,11,6,17,23,17,413,929,516,76,128,88,22,6,22,709,782,565,571,26,25,0.4445640473627557,30213112.229999997
DAVID.BACKES,20142015,STL,1605.8833333333334,27,18,15,33,60,45,678,1250,572,193,320,247,47,31,38,1589,1457,1115,1094,58,45,0.5424,30213182.505000003
DAVID.BOOTH,20142015,TOR,704.5333333333333,7,5,1,6,13,12,6,13,7,106,180,86,36,13,11,544,702,503,561,14,23,0.46153846153846156,30213089.095
DAVID.CLARKSON,20142015,CBJ,36.9,0,0,0,0,0,0,5,10,5,2,9,9,4,1,3,37,36,30,36,0,1,0.5,30213026.56
DAVID.CLARKSON,20142015,TOR,804.8833333333333,10,1,4,5,15,11,20,63,43,93,160,124,22,16,33,727,716,563,668,24,27,0.31746031746031744,30213107.21
DAVID.DESHARNAIS,20142015,MTL,1593.1166666666668,15,17,19,36,51,32,709,1350,641,105,194,55,56,17,14,1705,1367,1274,1225,56,35,0.5251851851851852,30213179.505
DAVID.JONES,20142015,CGY,1114.9333333333334,16,10,8,18,34,26,19,43,24,136,235,161,50,15,11,1016,1167,873,1103,39,39,0.4418604651162791,30213157.86
DAVID.KREJCI,20142015,BOS,853.85,7,12,12,24,31,19,316,594,278,70,141,35,39,7,10,905,725,649,613,28,22,0.531986531986532,30213100.16
DAVID.LEGWAND,20142015,OTT,1141.3333333333333,9,10,7,17,26,19,468,997,529,92,162,47,42,8,15,1103,1009,669,695,22,23,0.46940822467402205,30213124.725
DAVID.MOSS,20142015,ARI,774.85,4,5,3,8,12,9,6,13,7,96,166,113,35,5,11,709,799,611,623,11,25,0.46153846153846156,30213091.064999998
DAVID.MUSIL,20142015,EDM,79.21666666666667,0,1,1,2,2,1,0,0,0,3,7,5,3,0,1,77,99,72,85,3,5,0,30213031.675
DAVID.PASTRNAK,20142015,BOS,642.7666666666667,10,8,9,17,27,18,5,17,12,93,175,20,40,10,4,751,522,585,478,27,14,0.29411764705882354,30213072.875
DAVID.PERRON,20142015,EDM,645.8666666666666,5,8,6,14,19,13,3,9,6,74,128,74,32,13,4,641,490,475,447,18,27,0.3333333333333333,30213071.35
DAVID.PERRON,20142015,PIT,844.1500000000001,12,6,4,10,22,18,0,3,3,134,213,108,49,14,25,949,573,688,517,25,28,0,30213077.29
DAVID.RUNDBLAD,20142015,CHI,664.5833333333333,3,6,3,9,12,9,0,0,0,60,145,29,59,4,5,708,521,658,499,35,18,0,30213059.765
DAVID.SAVARD,20142015,CBJ,1881.4,11,10,13,23,34,21,1,1,0,112,248,195,72,11,32,1539,1835,1166,1315,53,59,1,30213167.375
DAVID.SCHLEMKO,20142015,ARI,362.29999999999995,1,0,3,3,4,1,0,0,0,24,49,29,20,0,2,328,370,276,282,9,13,0,30213049.075
DAVID.SCHLEMKO,20142015,CGY,395.26666666666665,0,1,0,1,1,1,0,0,0,30,68,21,29,0,4,382,314,332,281,18,9,0,30213043.65
DAVID.SCHLEMKO,20142015,DAL,72.05000000000001,0,0,0,0,0,0,0,0,0,6,14,7,5,0,0,73,102,67,96,4,5,0,30213032.5
DAVID.VAN DER GULIK,20142015,L.A,5.25,0,0,0,0,0,0,0,0,0,1,1,1,0,0,0,5,3,5,3,0,0,0,15106511.5
DAVID.WARSOFSKY,20142015,BOS,71.03333333333333,0,0,0,0,0,0,0,0,0,7,14,2,6,0,0,71,49,57,41,2,1,0,30213024.950000003
DAVID.WOLF,20142015,CGY,38.56666666666667,0,0,0,0,0,0,1,2,1,1,5,9,2,0,1,25,29,25,28,0,0,0.5,30213025.39
DENNIS.EVERBERG,20142015,COL,649.05,3,4,5,9,12,7,0,3,3,62,108,73,21,12,6,484,706,415,623,15,25,0,30213098.744999997
DENNIS.SEIDENBERG,20142015,BOS,1812.2666666666667,3,3,7,10,13,6,0,0,0,102,208,212,73,9,18,1423,1812,1298,1390,49,58,0,30213159.965
DENNIS.WIDEMAN,20142015,CGY,2262.616666666667,15,20,25,45,60,35,0,0,0,191,461,103,179,28,19,2118,2401,1468,1959,74,70,0,30213241.055
DEREK.DORSETT,20142015,VAN,1027.2666666666667,7,10,8,18,25,17,9,20,11,94,178,183,31,55,57,780,1032,719,930,31,38,0.45,30213142.009999998
DEREK.MACKENZIE,20142015,FLA,1020.9666666666667,5,2,4,6,11,7,543,1022,479,72,125,273,24,20,22,712,1038,636,662,11,31,0.5313111545988258,30213115.270000003
DEREK.ROY,20142015,EDM,777.0999999999999,11,8,3,11,22,19,289,663,374,78,132,29,28,12,10,744,699,563,645,23,34,0.4358974358974359,30213117.105
DEREK.ROY,20142015,NSH,351.26666666666665,1,7,2,9,10,8,117,244,127,35,64,3,11,2,1,340,298,281,255,13,11,0.47950819672131145,30213054.9
DEREK.STEPAN,20142015,NYR,1607.1166666666668,21,29,17,46,67,50,673,1546,873,203,344,44,81,14,16,1582,1490,1020,1172,51,32,0.43531694695989653,30213209.035
DERICK.BRASSARD,20142015,NYR,1730,28,20,27,47,75,48,828,1713,885,223,368,143,84,23,26,1947,1340,1313,1183,69,49,0.48336252189141854,30213195.225
DERRICK.POULIOT,20142015,PIT,596.5833333333334,2,3,1,4,6,5,0,0,0,56,114,15,38,3,2,629,429,434,391,12,19,0,30213058.205
DERYK.ENGELLAND,20142015,CGY,1313.85,2,4,5,9,11,6,0,0,0,62,138,157,44,16,23,926,1482,883,1273,28,53,0,30213169.185000002
DEVANTE.SMITH-PELLY,20142015,ANA,790.1333333333334,5,3,7,10,15,8,23,82,59,75,133,147,19,10,6,694,791,544,612,23,24,0.2804878048780488,30213093.945
DEVANTE.SMITH-PELLY,20142015,MTL,413.65,2,2,2,4,6,4,1,3,2,50,72,104,11,4,6,313,342,268,310,10,12,0.3333333333333333,30213058.630000003
DEVIN.SETOGUCHI,20142015,CGY,145.78333333333333,0,0,0,0,0,0,1,2,1,12,26,12,8,0,2,133,143,102,138,2,9,0.5,30213037.54
DION.PHANEUF,20142015,TOR,1660.2333333333336,3,14,12,26,29,17,0,0,0,138,302,166,85,43,45,1547,1769,999,1208,49,57,0,30213158.43
DMITRIJ.JASKIN,20142015,STL,804.7,13,2,4,6,19,15,3,7,4,114,207,162,39,10,10,795,584,680,565,31,22,0.42857142857142855,30213080.72
DMITRY.KULIKOV,20142015,FLA,1555.7333333333333,3,7,12,19,22,10,0,0,0,83,183,114,65,8,17,1308,1432,1054,1005,46,42,0,30213117.53
DOMINIC.MOORE,20142015,NYR,1414.0666666666666,11,11,8,19,30,22,736,1344,608,149,265,75,58,18,19,1071,1445,972,1076,33,44,0.5476190476190477,30213169.52
DOMINIK.UHER,20142015,PIT,12.916666666666666,0,0,0,0,0,0,0,0,0,0,0,2,0,0,0,7,11,7,10,0,1,0,15106512.4
DOUGIE.HAMILTON,20142015,BOS,1536.1833333333334,10,11,20,31,41,21,0,0,0,188,393,106,130,11,19,1775,1245,1242,1018,49,51,0,30213113.16
DRAYSON.BOWMAN,20142015,MTL,19.53333333333333,0,0,0,0,0,0,0,0,0,0,1,3,0,0,0,11,21,11,21,1,1,0,15106513.7
DREW.DOUGHTY,20142015,L.A,2377.666666666667,7,21,18,39,46,28,0,1,1,219,488,151,165,12,28,2454,1948,1790,1374,70,58,0,30213136.97
DREW.MILLER,20142015,DET,1219.1833333333334,6,5,3,8,14,11,6,20,14,106,163,130,30,11,12,640,1384,579,794,20,29,0.3,30213120.175
DREW.MILLER,20142015,EDM,123.75,1,3,2,5,6,4,1,2,1,14,22,7,2,1,2,118,134,115,133,4,8,0.5,30213039.35
DREW.SHORE,20142015,CGY,131.58333333333331,1,2,0,2,3,3,30,59,29,15,25,11,8,3,1,104,151,101,145,4,10,0.5084745762711864,30213041.28
DREW.STAFFORD,20142015,BUF,799.1166666666667,9,8,7,15,24,17,80,160,80,91,130,58,19,12,14,582,817,382,689,20,31,0.5,30213122.095
DREW.STAFFORD,20142015,WPG,524.05,10,6,5,11,21,16,6,14,8,65,115,34,24,8,5,501,447,375,399,21,14,0.42857142857142855,30213071.945
DUNCAN.KEITH,20142015,CHI,2760.7333333333336,12,26,26,52,64,38,0,0,0,229,546,33,219,4,11,3030,2371,2213,1783,90,71,0,30213170.74
DUNCAN.SIEMENS,20142015,COL,14,0,0,0,0,0,0,0,0,0,0,0,2,0,0,0,8,10,8,10,1,1,0,15106512.2
DUSTIN.BROWN,20142015,L.A,1354.3833333333332,11,12,4,16,27,23,15,35,20,189,340,242,72,36,13,1287,1117,1025,854,30,37,0.42857142857142855,30213111.259999998
DUSTIN.BYFUGLIEN,20142015,WPG,1656.2666666666667,18,7,20,27,45,25,0,3,3,220,443,220,123,27,49,1760,1304,1105,1004,46,43,0,30213129.22
DWIGHT.KING,20142015,L.A,1166.0333333333333,13,9,3,12,25,22,3,5,2,127,199,124,34,7,9,1113,1002,1019,844,35,33,0.6,30213109.915
DYLAN.MCILRATH,20142015,NYR,8.033333333333333,0,0,0,0,0,0,0,0,0,0,0,2,0,2,3,11,7,11,6,0,0,0,15106512.07
DYLAN.OLSEN,20142015,FLA,699.65,2,2,4,6,8,4,0,0,0,44,91,77,31,6,10,563,671,492,531,18,26,0,30213076.759999998
DYLAN.REESE,20142015,ARI,19.966666666666665,0,0,0,0,0,0,0,0,0,3,6,2,2,0,0,27,19,25,15,1,2,0,15106511.95
ELIAS.LINDHOLM,20142015,CAR,1330.0166666666667,17,13,9,22,39,30,115,220,105,170,302,106,79,8,7,1504,1017,1061,921,31,48,0.5227272727272727,30213124.555
EMERSON.ETEM,20142015,ANA,691.4166666666666,8,3,2,5,13,11,4,8,4,100,170,97,40,11,2,648,623,606,571,17,22,0.5,30213082.27
EMILE.POIRIER,20142015,CGY,47.9,0,0,1,1,1,0,0,1,1,2,6,7,2,1,0,38,58,36,58,1,0,0,15106517.935
ERIAH.HAYES,20142015,S.J,39.88333333333333,0,0,0,0,0,0,1,1,0,10,10,7,0,0,1,25,32,25,31,0,2,1,30213026.54
ERIC.BOULTON,20142015,NYI,71.96666666666667,2,0,0,0,2,2,0,0,0,9,13,10,2,5,7,59,77,58,73,2,2,0,30213032.9
ERIC.BREWER,20142015,ANA,155.38333333333333,1,0,1,1,2,1,0,0,0,7,21,12,9,0,3,118,170,104,140,6,14,0,30213037.625
ERIC.BREWER,20142015,T.B,303.26666666666665,0,2,2,4,4,2,0,0,0,14,36,35,13,2,9,206,308,195,219,13,11,0,30213045.020000003
ERIC.BREWER,20142015,TOR,363.48333333333335,2,1,2,3,5,3,0,0,0,12,33,40,14,2,6,291,432,256,324,12,18,0,30213058.02
ERIC.FEHR,20142015,WSH,1153.3,19,9,5,14,33,28,462,889,427,144,253,91,60,16,11,996,1118,872,854,34,31,0.5196850393700787,30213137.265
ERIC.GELINAS,20142015,N.J,1004.1166666666666,6,10,3,13,19,16,0,0,0,112,244,82,86,8,19,907,779,665,703,28,22,0,30213096.055
ERIC.GRYBA,20142015,OTT,1270.8,0,7,4,11,11,7,0,0,0,68,161,184,60,18,35,942,1359,862,975,36,39,0,30213124.23
ERIC.NYSTROM,20142015,NSH,791.6833333333334,7,2,3,5,12,9,4,12,8,60,97,103,16,11,6,476,855,442,579,16,17,0.3333333333333333,30213093.045
ERIC.O'DELL,20142015,WPG,81.76666666666665,0,1,0,1,1,1,18,41,23,6,15,14,4,2,4,64,47,61,47,2,2,0.43902439024390244,30213028.04
ERIC.STAAL,20142015,CAR,1451.3,23,18,13,31,54,41,343,669,326,244,449,65,101,22,17,1763,1086,1248,930,36,41,0.5127055306427504,30213133.865000002
ERIC.TANGRADI,20142015,MTL,54.083333333333336,0,0,0,0,0,0,1,1,0,5,8,12,2,1,3,41,57,41,55,0,3,1,30213029.1
ERIK.COLE,20142015,DAL,827.9833333333333,18,13,2,15,33,31,4,15,11,98,177,116,47,15,6,821,743,649,647,32,23,0.26666666666666666,30213101.61
ERIK.COLE,20142015,DET,161.25,3,1,2,3,6,4,1,1,0,24,36,18,4,3,0,158,98,111,84,5,5,1,30213032.22
ERIK.CONDRA,20142015,OTT,1087.9166666666665,10,9,5,14,24,19,3,10,7,120,221,34,59,23,11,926,1099,842,809,32,24,0.3,30213108.625
ERIK.GUDBRANSON,20142015,FLA,1414.8833333333334,4,1,8,9,13,5,0,0,0,110,229,212,69,17,23,1175,1332,984,1006,41,43,0,30213120.77
ERIK.HAULA,20142015,MIN,896.8166666666666,8,5,2,7,15,13,265,593,328,96,161,35,25,13,16,660,892,603,639,21,27,0.4468802698145025,30213110.880000003
ERIK.JOHNSON,20142015,COL,1147.7166666666667,12,5,6,11,23,17,0,0,0,115,226,92,74,7,11,1019,1145,737,857,33,31,0,30213117.22
ERIK.KARLSSON,20142015,OTT,2408.75,22,25,23,48,70,47,0,0,0,309,705,108,242,20,22,2811,1922,1824,1616,76,69,0,30213175.825
EVANDER.KANE,20142015,WPG,714.5666666666667,10,7,5,12,22,17,30,67,37,126,244,119,58,12,19,702,603,507,450,20,21,0.44776119402985076,30213074.994999997
EVGENI.MALKIN,20142015,PIT,1404.3,28,21,20,41,69,49,349,808,459,222,407,29,89,26,26,1656,1041,1089,904,48,40,0.4319306930693069,30213150.47
EVGENY.KUZNETSOV,20142015,WSH,1299.1,16,17,10,27,43,33,384,847,463,169,301,56,68,13,15,1289,1116,999,1031,43,30,0.45336481700118064,30213161.990000002
FEDOR.TYUTIN,20142015,CBJ,1334.7666666666667,3,4,8,12,15,7,0,0,0,56,131,106,39,6,20,934,1367,810,963,38,39,0,30213125.66
FILIP.FORSBERG,20142015,NSH,1544.2,30,21,16,37,67,51,3,8,5,259,507,123,112,24,14,1881,1155,1351,1024,68,43,0.375,30213130.810000002
FRANCOIS.BEAUCHEMIN,20142015,ANA,1861.9,11,7,11,18,29,18,1,1,0,135,270,137,74,6,NA,1752,1749,1371,1308,64,45,1,NA
FRANK.CORRADO,20142015,VAN,156.68333333333334,1,0,0,0,1,1,0,0,0,8,16,15,3,2,0,118,123,112,114,2,6,0,30213034.369999997
FRANS.NIELSEN,20142015,NYI,1406.4833333333333,15,18,12,30,45,33,542,1128,586,166,334,52,91,16,6,1494,1298,971,921,36,33,0.4804964539007092,30213147.590000004
FREDDIE.HAMILTON,20142015,COL,127.93333333333334,1,0,0,0,1,1,23,59,36,11,22,22,8,1,0,78,118,74,112,3,3,0.3898305084745763,30213036.78
FREDDIE.HAMILTON,20142015,S.J,8.45,0,0,0,0,0,0,1,2,1,0,0,3,0,0,0,1,4,0,4,0,1,0.5,15106511.89
FRÉDÉRIC.ST-DENIS,20142015,CBJ,53.18333333333334,0,0,1,1,1,0,0,0,0,2,8,2,6,2,0,45,44,43,41,1,2,0,30213025.645
GABRIEL.BOURQUE,20142015,NSH,906.1333333333333,3,6,3,9,12,9,3,6,3,80,133,161,22,7,7,659,865,602,687,14,28,0.5,30213100.915
GABRIEL.DUMONT,20142015,MTL,27.366666666666667,0,0,0,0,0,0,11,13,2,4,5,8,1,0,0,19,22,19,21,0,1,0.8461538461538461,15106513.49
GABRIEL.LANDESKOG,20142015,COL,1517.1999999999998,23,21,14,35,58,44,16,44,28,214,349,169,69,26,30,1535,1338,1069,1153,52,48,0.36363636363636365,30213169.25
GARRETT.WILSON,20142015,FLA,17.683333333333334,0,0,0,0,0,0,0,0,0,5,8,5,2,0,0,19,16,16,16,0,2,0,30213024.05
GRANT.CLITSOME,20142015,WPG,392.75,0,3,1,4,4,3,0,0,0,22,56,46,27,1,4,372,331,320,281,6,6,0,30213047.135
GREG.MCKEGG,20142015,TOR,27.566666666666666,0,0,0,0,0,0,17,33,16,1,1,3,0,1,0,16,31,16,31,0,0,0.5151515151515151,30213027.04
GREG.PATERYN,20142015,MTL,291.85,0,2,1,3,3,2,0,0,0,16,30,62,10,1,3,249,236,239,222,10,9,0,30213043.285
GREGORY.CAMPBELL,20142015,BOS,849.45,6,3,3,6,12,9,339,632,293,64,106,119,25,10,14,540,921,495,703,16,18,0.5363924050632911,30213119.785
GRIFFIN.REINHART,20142015,NYI,126.08333333333334,0,0,0,0,0,0,0,0,0,5,12,16,3,2,3,103,135,95,115,4,6,0,30213034.67
GUSTAV.NYQUIST,20142015,DET,1475.4499999999998,28,14,14,28,56,42,1,10,9,210,366,55,95,28,14,1542,1009,988,873,37,43,0.1,30213125.92
HAMPUS.LINDHOLM,20142015,ANA,2069.15,9,17,14,31,40,26,0,5,5,127,276,75,99,12,NA,1969,1913,1555,1435,78,52,0,NA
HARRY.ZOLNIERCZYK,20142015,NYI,22.25,0,0,0,0,0,0,0,2,2,1,3,6,2,1,0,19,20,17,17,0,1,0,30213024.060000002
HENRIK.SAMUELSSON,20142015,ARI,39.8,0,0,0,0,0,0,2,2,0,4,5,5,0,0,1,46,42,36,41,0,2,1,15106515.93
HENRIK.SEDIN,20142015,VAN,1638.0333333333333,19,29,29,58,77,48,768,1694,926,115,187,27,42,13,12,1758,1182,1158,929,46,40,0.45336481700118064,30213168.475
HENRIK.ZETTERBERG,20142015,DET,1597.8166666666666,17,31,21,52,69,48,590,1156,566,244,452,65,111,17,20,1657,1066,1045,886,43,42,0.5103806228373703,30213148.345
IAN.COLE,20142015,PIT,484.65,1,3,6,9,10,4,0,0,0,40,85,36,27,8,6,488,390,409,332,14,14,0,30213051.479999997
IAN.COLE,20142015,STL,813.0166666666667,4,0,4,4,8,4,0,0,0,52,117,42,38,12,19,749,655,705,619,30,15,0,30213078.57
IIRO.PAKARINEN,20142015,EDM,172.3,1,0,2,2,3,1,1,1,0,34,53,51,15,2,1,165,147,131,142,1,5,1,30213037.560000002
J.T..BROWN,20142015,T.B,847.8,4,3,4,7,11,7,7,18,11,113,189,89,39,16,13,649,774,622,648,19,26,0.3888888888888889,30213092.89
J.T..MILLER,20142015,NYR,1014.8666666666667,11,13,7,20,31,24,123,260,137,124,215,135,43,13,9,1052,892,886,844,39,28,0.47307692307692306,30213121.174999997
JACK.HILLEN,20142015,CAR,55.75,0,0,0,0,0,0,0,0,0,4,13,5,7,0,0,56,51,56,48,2,4,0,30213025.75
JACK.HILLEN,20142015,WSH,432.91666666666663,0,1,4,5,5,1,0,0,0,20,58,33,29,3,5,374,418,363,406,13,12,0,30213061.58
JACK.JOHNSON,20142015,CBJ,1909.1000000000001,8,11,21,32,40,19,0,0,0,141,273,157,76,12,22,1632,1831,1141,1257,56,66,0,30213157.895
JACK.SKILLE,20142015,CBJ,563.55,6,2,0,2,8,8,3,8,5,95,146,96,21,9,5,465,559,454,546,12,27,0.375,30213087.86
JACOB.DE LA ROSE,20142015,MTL,607.3666666666667,4,1,1,2,6,5,71,175,104,52,94,92,27,1,8,416,588,383,488,10,17,0.4057142857142857,30213082.725
JACOB.JOSEFSON,20142015,N.J,770.7666666666667,6,2,3,5,11,8,289,586,297,61,111,55,24,6,9,548,685,481,469,13,15,0.4931740614334471,30213085.195
JACOB.TROUBA,20142015,WPG,1591.95,7,9,7,16,23,16,0,1,1,141,335,104,133,14,20,1522,1522,1151,988,37,39,0,30213108.265
JADEN.SCHWARTZ,20142015,STL,1476.5,29,24,12,36,65,53,70,154,84,199,322,59,69,10,7,1533,1210,1096,979,48,39,0.45454545454545453,30213146
JAKE.GARDINER,20142015,TOR,1656.9166666666667,4,6,13,19,23,10,0,0,0,100,253,109,97,7,10,1571,1378,1202,1214,39,52,0,30213137.744999997
JAKE.MCCABE,20142015,BUF,22.25,0,0,0,0,0,0,0,0,0,2,3,4,0,0,0,19,20,14,18,0,0,0,30213024.6
JAKE.MUZZIN,20142015,L.A,1725.1833333333334,10,11,17,28,38,21,0,0,0,173,385,186,133,12,11,1907,1274,1434,1031,49,47,0,30213102.895
JAKOB.SILFVERBERG,20142015,ANA,1571.5166666666667,17,26,14,40,57,43,24,56,32,230,412,62,82,17,18,1459,1458,1196,1119,56,43,0.42857142857142855,30213152.83
JAKUB.KINDL,20142015,DET,573.5,5,3,5,8,13,8,0,0,0,57,125,32,47,4,11,624,382,465,331,17,12,0,30213049.365000002
JAKUB.VORACEK,20142015,PHI,1524.6333333333332,22,31,28,59,81,53,6,9,3,221,424,55,133,28,28,1895,1182,1181,1023,48,35,0.6666666666666666,30213139.92
JAMES.NEAL,20142015,NSH,1335.6,27,9,6,15,42,36,8,21,13,246,460,92,116,24,25,1646,1017,1183,901,58,39,0.38095238095238093,30213113.560000002
JAMES.SHEPPARD,20142015,NYR,274.9,3,1,0,1,4,4,29,66,37,23,41,54,7,7,6,202,293,199,290,6,5,0.4393939393939394,30213060.43
JAMES.SHEPPARD,20142015,S.J,782.2,5,6,4,10,15,11,267,534,267,68,127,93,26,12,9,733,693,643,643,19,24,0.5,30213102.7
JAMES.VAN RIEMSDYK,20142015,TOR,1564.8833333333332,27,23,6,29,56,50,21,54,33,247,401,83,69,19,20,1662,1583,1053,1307,38,62,0.3888888888888889,30213198.83
JAMES.WISNIEWSKI,20142015,ANA,262.8333333333333,0,1,4,5,5,1,0,0,0,20,44,16,12,4,5,286,193,206,162,8,9,0,30213036.14
JAMES.WISNIEWSKI,20142015,CBJ,1199.3,8,12,9,21,29,20,0,0,0,127,266,99,97,17,18,1195,1106,787,868,34,43,0,30213115.795
JAMIE.BENN,20142015,DAL,1635.4833333333331,35,32,20,52,87,67,298,576,278,252,465,120,110,34,25,1944,1429,1253,1041,67,53,0.5173611111111112,30213160.66
JAMIE.MCBAIN,20142015,L.A,329.8666666666667,3,1,5,6,9,4,0,0,0,18,60,21,22,1,2,345,250,262,229,16,10,0,30213042.285
JAMIE.MCGINN,20142015,COL,280.6333333333333,4,0,2,2,6,4,1,1,0,36,51,29,2,2,3,239,280,169,256,8,13,1,30213056.16
JAMIE.OLEKSIAK,20142015,DAL,482.3666666666667,1,2,4,6,7,3,0,0,0,36,61,82,14,4,4,433,499,416,431,24,24,0,30213065.189999998
JAN.HEJDA,20142015,COL,1672.95,1,4,8,12,13,5,0,0,0,83,174,170,57,4,21,1250,1865,1126,1452,47,61,0,30213179.240000002
JANNIK.HANSEN,20142015,VAN,1230.4499999999998,18,15,3,18,36,33,1,6,5,153,280,85,66,16,11,1079,1171,914,960,38,48,0.16666666666666666,30213135.975
JARED.BOLL,20142015,CBJ,523.7833333333333,1,3,1,4,5,4,0,2,2,28,55,131,15,24,32,305,512,302,510,11,24,0,30213088.965
JARED.COWEN,20142015,OTT,980.1333333333333,3,2,3,5,8,5,0,0,0,47,104,159,38,11,18,820,989,726,779,29,45,0,30213101.585
JARED.SPURGEON,20142015,MIN,1706.35,10,12,7,19,29,22,0,0,0,139,285,52,85,8,5,1671,1538,1299,1150,53,45,0,30213131.255
JAROME.IGINLA,20142015,COL,1487.1166666666668,29,23,7,30,59,52,57,128,71,189,350,99,105,15,15,1381,1475,926,1290,54,49,0.4453125,30213194.155
JAROMIR.JAGR,20142015,FLA,345.01666666666665,6,7,5,12,18,13,1,1,0,50,101,17,31,3,3,386,252,288,231,16,8,1,30213047.095
JAROMIR.JAGR,20142015,N.J,1007.8833333333333,11,14,4,18,29,25,0,0,0,119,199,13,43,14,21,884,707,649,612,28,28,0,30213096.14
JARRED.TINORDI,20142015,MTL,156.86666666666667,0,1,1,2,2,1,0,0,0,5,16,20,6,3,5,141,152,139,139,2,7,0,30213036.855
JARRET.STOLL,20142015,L.A,1130.75,6,6,5,11,17,12,591,1160,569,83,135,166,22,15,28,953,1052,797,768,29,27,0.5094827586206897,30213129.115
JASON.AKESON,20142015,PHI,104.65,0,0,0,0,0,0,1,2,1,9,20,11,6,3,4,75,115,70,114,1,2,0.5,30213036.17
JASON.CHIMERA,20142015,WSH,1214.4333333333334,10,12,4,16,26,22,46,87,41,131,228,165,51,13,23,963,1246,884,974,35,34,0.5287356321839081,30213137.119999997
JASON.DEMERS,20142015,DAL,1185.3833333333332,5,6,10,16,21,11,0,0,0,79,186,88,58,11,21,1203,1002,996,769,38,36,0,30213088.41
JASON.DEMERS,20142015,S.J,363.8166666666667,0,1,1,2,2,1,0,0,0,20,65,30,29,1,4,354,339,287,282,5,10,0,30213047.585
JASON.GARRISON,20142015,T.B,1848.9,6,12,17,29,35,18,0,0,0,142,288,75,89,4,12,1560,1727,1251,1244,64,43,0,30213144.615000002
JASON.POMINVILLE,20142015,MIN,1673.7833333333333,21,26,13,39,60,47,43,94,51,285,484,54,108,15,4,1992,1315,1323,1153,59,43,0.4574468085106383,30213151.345
JASON.SPEZZA,20142015,DAL,1412,17,19,26,45,62,36,682,1261,579,204,412,16,99,16,14,1791,1105,1141,951,50,43,0.5408406026962728,30213144.64
JASON.ZUCKER,20142015,MIN,909.7833333333333,23,5,1,6,29,28,2,7,5,145,226,87,28,20,10,843,769,709,643,31,43,0.2857142857142857,30213102.755000003
JAY.BEAGLE,20142015,WSH,1015.3166666666666,11,10,4,14,25,21,336,571,235,108,162,98,24,8,12,799,1037,744,750,32,29,0.5884413309982487,30213118.57
JAY.BOUWMEESTER,20142015,STL,1754.6999999999998,2,6,5,11,13,8,0,0,0,97,213,49,56,2,13,1470,1669,1235,1199,58,46,0,30213135.395
JAY.HARRISON,20142015,CAR,329.56666666666666,1,3,0,3,4,4,0,0,0,23,61,35,23,4,14,319,330,275,252,7,9,0,30213047.689999998
JAY.HARRISON,20142015,WPG,546.2166666666667,2,1,2,3,5,3,0,0,0,27,69,41,28,1,10,453,526,396,405,16,14,0,30213061.810000002
JAY.MCCLEMENT,20142015,CAR,1113.3166666666666,7,7,6,13,20,14,549,990,441,68,NA,79,NA,5,7,NA,NA,NA,NA,33,39,0.5545454545454546,NA
JAYSON.MEGNA,20142015,PIT,132.41666666666669,0,0,1,1,1,0,0,0,0,13,23,40,6,4,7,98,127,95,114,2,4,0,30213035.465
JEAN-GABRIEL.PAGEAU,20142015,OTT,802.7333333333333,10,4,5,9,19,14,382,774,392,111,169,185,30,16,3,694,789,624,580,22,21,0.4935400516795866,30213102.015
JEFF.CARTER,20142015,L.A,1473.6,28,17,16,33,61,45,627,1193,566,218,420,76,89,14,13,1676,1184,1125,858,51,35,0.5255658005029338,30213139.12
JEFF.PETRY,20142015,EDM,1235.9333333333334,4,6,5,11,15,10,0,0,0,103,233,101,83,5,16,1093,1150,919,959,27,51,0,30213117.975
JEFF.PETRY,20142015,MTL,688.85,5,4,1,5,10,9,0,0,0,50,116,73,50,7,7,610,633,465,519,15,15,0,30213076.745
JEFF.SCHULTZ,20142015,L.A,150.71666666666667,0,1,0,1,1,1,0,0,0,7,16,10,5,0,2,116,105,112,86,4,3,0,30213029.65
JEFF.SKINNER,20142015,CAR,1235.5833333333335,18,9,4,13,31,27,21,46,25,235,452,47,117,22,10,1347,992,972,912,29,45,0.45652173913043476,30213121.16
JEREMY.MORIN,20142015,CBJ,322.56666666666666,2,4,0,4,6,6,1,4,3,45,68,32,12,4,5,277,268,262,262,13,13,0.25,30213051.729999997
JEREMY.MORIN,20142015,CHI,116,0,0,0,0,0,0,1,1,0,28,41,13,9,6,6,137,87,134,87,1,1,1,30213029.7
JERRY.D'AMIGO,20142015,BUF,87.56666666666666,0,0,0,0,0,0,0,0,0,7,9,8,1,1,1,60,109,58,88,1,5,0,30213033.009999998
JESPER.FAST,20142015,NYR,966.4333333333334,9,6,5,11,20,15,4,23,19,73,117,140,22,8,5,779,942,739,784,30,31,0.17391304347826086,30213110.715
JESSE.BLACKER,20142015,ANA,6.05,0,0,0,0,0,0,0,0,0,0,0,1,0,0,0,2,11,2,11,0,2,0,15106512.8
JESSE.JOENSUU,20142015,EDM,212.56666666666666,2,0,1,1,3,2,0,0,0,18,30,37,2,1,7,168,216,161,187,1,12,0,30213045.485
JIM.SLATER,20142015,WPG,793.4166666666667,5,6,2,8,13,11,464,787,323,53,93,146,12,16,22,493,963,451,567,17,22,0.5895806861499364,30213105.22
JIMMY.HAYES,20142015,FLA,1090.2666666666667,19,11,5,16,35,30,4,9,5,166,248,147,33,13,10,1129,872,858,799,39,34,0.4444444444444444,30213118.515
JIRI.HUDLER,20142015,CGY,1584.7166666666667,35,32,16,48,83,67,22,47,25,173,307,32,60,17,8,1682,1411,1058,1242,54,48,0.46808510638297873,30213193.15
JIRI.SEKAC,20142015,ANA,325.68333333333334,2,2,3,5,7,4,0,1,1,35,57,41,9,4,4,299,258,278,245,12,9,0,30213047.365
JIRI.SEKAC,20142015,MTL,690.45,7,1,8,9,16,8,0,1,1,56,116,49,27,13,9,577,632,513,582,19,20,0,30213087.630000003
JIRI.TLUSTY,20142015,CAR,894.6166666666666,13,4,6,10,23,17,5,15,10,97,186,64,44,8,8,968,700,702,572,22,31,0.3333333333333333,30213081.630000003
JIRI.TLUSTY,20142015,WPG,299.68333333333334,1,1,6,7,8,2,0,0,0,28,49,20,13,4,2,264,247,230,224,11,13,0,30213044.439999998
JOAKIM.ANDERSSON,20142015,DET,859.05,4,5,1,6,10,9,209,409,200,80,112,32,18,4,11,505,835,455,571,14,22,0.511002444987775,30213099.825000003
JOAKIM.LINDSTROM,20142015,STL,376.75,3,1,2,3,6,4,7,22,15,41,79,9,22,6,4,359,300,306,292,4,11,0.3181818181818182,30213053.29
JOAKIM.LINDSTROM,20142015,TOR,199.65,1,2,1,3,4,3,0,1,1,20,39,5,12,3,2,173,161,160,154,4,11,0,30213038.455
JOAKIM.NORDSTROM,20142015,CHI,456.51666666666665,0,1,2,3,3,1,4,12,8,45,93,82,27,5,2,366,433,345,369,4,14,0.3333333333333333,30213059.61
JOE.COLBORNE,20142015,CGY,1176.3,9,13,9,22,31,22,185,358,173,74,144,189,36,11,25,948,1137,718,967,31,30,0.5167597765363129,30213150.085
JOE.MORROW,20142015,BOS,250.35,1,0,0,0,1,1,0,0,0,20,48,18,18,3,2,206,219,202,200,6,3,0,30213040.83
JOE.PAVELSKI,20142015,S.J,1650.25,37,22,11,33,70,59,642,1147,505,261,440,97,81,29,12,2046,1347,1286,973,49,37,0.5597210113339146,30213157.445
JOE.PISKULA,20142015,NSH,16.45,0,0,0,0,0,0,0,0,0,0,4,0,3,0,1,15,12,15,11,0,1,0,15106511.85
JOE.THORNTON,20142015,S.J,1437.0833333333335,16,28,21,49,65,44,554,955,401,131,258,39,71,15,14,1939,1082,1240,880,42,44,0.5801047120418849,30213127.035
JOE.VITALE,20142015,ARI,786.05,3,4,2,6,9,7,354,733,379,55,95,104,17,11,14,535,1031,511,685,11,21,0.4829467939972715,30213120.32
JOE.WHITNEY,20142015,N.J,27.5,1,0,0,0,1,1,0,0,0,1,2,5,1,0,0,13,26,13,26,2,3,0,30213026.049999997
JOEL.ARMIA,20142015,BUF,14.783333333333333,0,0,0,0,0,0,0,0,0,0,0,4,0,0,0,4,11,4,11,0,0,0,15106512.7
JOEL.WARD,20142015,WSH,1649.3333333333335,22,12,9,21,43,34,64,134,70,176,299,70,48,20,14,1590,1512,1207,1129,43,45,0.47761194029850745,30213154.485
JOEY.HISHON,20142015,COL,131.46666666666667,1,0,1,1,2,1,35,78,43,19,29,3,5,3,1,98,129,69,112,1,2,0.44871794871794873,30213038.655
JOFFREY.LUPUL,20142015,TOR,851.9666666666667,10,7,4,11,21,17,4,6,2,97,170,77,31,8,14,777,845,593,753,34,35,0.6666666666666666,30213114.29
JOHAN.FRANZEN,20142015,DET,530.0166666666667,7,6,9,15,22,13,5,15,10,73,125,45,18,14,14,565,350,344,310,11,18,0.3333333333333333,30213062.665
JOHAN.LARSSON,20142015,BUF,566.1333333333333,6,3,6,9,15,9,150,341,191,50,88,59,16,10,7,470,566,375,512,14,13,0.4398826979472141,30213094.05
JOHN-MICHAEL.LILES,20142015,CAR,1091.4833333333333,2,6,14,20,22,8,0,0,0,89,193,71,59,10,7,1139,820,876,721,28,27,0,30213085.15
JOHN.CARLSON,20142015,WSH,2227.35,13,26,20,46,59,39,0,0,0,234,479,100,142,6,16,2231,2312,1660,1542,71,63,0,30213177.91
JOHN.KLINGBERG,20142015,DAL,1419.6999999999998,11,18,10,28,39,29,0,0,0,98,237,54,97,17,16,1692,1228,1232,1067,58,45,0,30213123.52
JOHN.MITCHELL,20142015,COL,1078.25,11,8,7,15,26,19,374,735,361,105,203,143,59,16,16,861,1117,701,955,33,41,0.508843537414966,30213151.645
JOHN.MOORE,20142015,ARI,355.65,1,1,3,4,5,2,0,0,0,21,69,26,33,2,3,339,354,237,302,3,9,0,30213053.545
JOHN.MOORE,20142015,NYR,573.8333333333334,1,2,3,5,6,3,0,0,0,56,112,51,32,5,4,568,456,517,424,25,17,0,30213057.174999997
JOHN.RAMAGE,20142015,CGY,18.166666666666664,0,0,0,0,0,0,0,0,0,4,4,2,0,0,0,13,10,13,10,1,2,0,15106512.15
JOHN.SCOTT,20142015,S.J,283.16666666666663,3,1,0,1,4,4,0,0,0,19,40,93,13,11,NA,227,270,225,266,8,9,0,NA
JOHN.TAVARES,20142015,NYI,1830.3833333333332,40,33,19,52,92,73,800,1558,758,295,509,57,108,20,25,2268,1470,1573,1308,70,61,0.5134788189987163,30213209.525
JOHNNY.BOYCHUK,20142015,NYI,1743.05,9,14,14,28,37,23,2,2,0,212,428,204,131,10,9,1924,1551,1444,1162,61,47,1,30213122.880000003
JOHNNY.GAUDREAU,20142015,CGY,1628.1833333333334,28,26,19,45,73,54,3,8,5,191,321,17,71,21,11,1709,1487,1142,1325,57,50,0.375,30213191.905
JOHNNY.ODUYA,20142015,CHI,2111.0666666666666,2,5,7,12,14,7,0,0,0,104,278,101,120,16,17,1844,2046,1712,1684,60,60,0,30213175.085
JON.MERRILL,20142015,N.J,1356.2833333333333,2,4,7,11,13,6,0,0,0,47,115,59,37,10,12,905,1138,764,916,28,39,0,30213120.325000003
JONAS.BRODIN,20142015,MIN,1932.4666666666667,3,3,10,13,16,6,0,0,0,98,199,39,69,6,4,1599,1772,1396,1393,62,46,0,30213152.060000002
JONATHAN.DROUIN,20142015,T.B,986.7833333333333,4,16,12,28,32,20,11,23,12,82,165,61,48,11,14,960,724,761,677,32,32,0.4782608695652174,30213093.3
JONATHAN.ERICSSON,20142015,DET,1744.5166666666669,3,10,5,15,18,13,0,0,0,87,190,132,63,21,35,1274,1691,1148,1149,41,53,0,30213139.634999998
JONATHAN.HUBERDEAU,20142015,FLA,1323.0833333333335,15,27,12,39,54,42,2,8,6,170,265,68,59,28,20,1351,1010,983,905,50,36,0.25,30213131.060000002
JONATHAN.MARCHESSAULT,20142015,T.B,46.8,1,0,0,0,1,1,1,3,2,6,12,5,4,0,0,39,41,36,40,2,1,0.3333333333333333,30213026.89
JONATHAN.TOEWS,20142015,CHI,2064.6833333333334,38,28,21,49,87,66,1240,2198,958,253,410,96,70,31,23,2406,1660,1583,1290,68,43,0.5641492265696088,30213211.635
JONATHON.BLUM,20142015,MIN,39.46666666666667,0,1,0,1,1,1,0,0,0,3,4,1,0,0,1,30,31,30,29,1,4,0,30213026.05
JORDAN.CARON,20142015,BOS,87.23333333333332,0,0,0,0,0,0,0,1,1,4,8,20,3,3,5,56,75,56,72,2,3,0,30213030.78
JORDAN.CARON,20142015,COL,153.83333333333334,0,0,0,0,0,0,0,0,0,8,19,21,7,1,2,88,168,87,163,2,2,0,30213041.96
JORDAN.EBERLE,20142015,EDM,1542.4166666666665,24,25,14,39,63,49,1,6,5,183,303,62,67,16,12,1649,1260,1158,1140,57,61,0.16666666666666666,30213159.95
JORDAN.LEOPOLD,20142015,CBJ,310.41666666666663,1,1,1,2,3,2,0,0,0,21,35,20,10,2,3,209,306,178,264,5,11,0,30213053.795
JORDAN.LEOPOLD,20142015,MIN,347.8,0,1,0,1,1,1,0,0,0,24,44,19,15,2,4,257,338,252,319,8,10,0,30213056.67
JORDAN.LEOPOLD,20142015,STL,91.51666666666667,0,0,0,0,0,0,0,0,0,1,8,3,7,0,1,89,71,87,68,2,2,0,30213027.2
JORDAN.MARTINOOK,20142015,ARI,93.58333333333333,0,0,1,1,1,0,0,0,0,8,22,14,2,2,0,109,92,108,80,3,6,0,30213028.845
JORDAN.NOLAN,20142015,L.A,597.8666666666667,6,2,1,3,9,8,1,6,5,44,89,102,22,19,17,477,504,471,500,14,20,0.16666666666666666,30213079.105
JORDAN.OESTERLE,20142015,EDM,88.16666666666667,0,1,0,1,1,1,0,0,0,6,15,2,5,1,0,81,74,68,69,1,3,0,30213029.41
JORDAN.SCHROEDER,20142015,MIN,305.01666666666665,3,3,2,5,8,6,0,0,0,53,73,26,7,3,1,283,251,279,240,13,4,0,30213048.28
JORDAN.STAAL,20142015,CAR,853.4,6,10,8,18,24,16,499,884,385,92,175,85,41,6,7,1008,620,776,531,20,25,0.5644796380090498,30213084.47
JORDAN.SZWARZ,20142015,ARI,121.21666666666667,1,0,0,0,1,1,0,0,0,8,10,5,2,0,1,69,179,68,131,2,4,0,30213039.4
JORDIE.BENN,20142015,DAL,1317.25,2,7,6,13,15,9,0,1,1,70,185,92,63,6,19,1246,1219,1124,942,44,53,0,30213103.71
JORDIN.TOOTOO,20142015,N.J,711.1166666666667,10,4,1,5,15,14,1,1,0,75,118,127,19,17,23,549,598,467,576,21,20,1,30213096.185
JORI.LEHTERA,20142015,STL,1290.2333333333333,14,21,11,32,46,35,569,1105,536,106,181,44,45,11,24,1288,975,919,841,53,33,0.5149321266968325,30213140.295
JOSH.ANDERSON,20142015,CBJ,80.69999999999999,0,0,1,1,1,0,0,0,0,10,19,24,6,1,1,74,71,74,71,3,4,0,30213028.835
JOSH.BAILEY,20142015,NYI,1296.6333333333332,17,16,12,28,45,33,30,68,38,152,287,73,83,12,6,1447,1192,1195,1095,58,52,0.4411764705882353,30213137.67
JOSH.GORGES,20142015,BUF,1028.7166666666667,0,1,4,5,5,1,0,0,0,28,63,75,15,5,8,579,1219,468,895,17,38,0,30213132.05
JOSH.JOORIS,20142015,CGY,971.5166666666667,12,6,6,12,24,18,304,619,315,97,173,74,33,11,10,837,947,707,771,32,33,0.4911147011308562,30213124.37
JOSH.LEIVO,20142015,TOR,68.88333333333333,1,0,0,0,1,1,0,2,2,10,16,5,3,1,2,68,60,65,60,3,4,0,30213028.96
JOSH.MANSON,20142015,ANA,516.1333333333333,0,1,2,3,3,1,0,0,0,25,54,44,21,2,13,478,465,439,361,15,13,0,30213053.22
JULIEN.BROUILLETTE,20142015,WPG,9.55,0,0,0,0,0,0,0,0,0,0,0,1,0,0,0,2,10,2,10,0,0,0,15106512.65
JUSSI.JOKINEN,20142015,FLA,1355.7833333333333,8,19,17,36,44,27,126,250,124,134,217,51,47,14,17,1232,1169,860,831,38,41,0.504,30213123.055
JUSTIN.ABDELKADER,20142015,DET,1355.2333333333333,23,16,6,22,45,39,7,15,8,160,248,182,39,39,36,1342,892,879,685,39,31,0.4666666666666667,30213109.07
JUSTIN.BRAUN,20142015,S.J,1472.25,1,7,13,20,21,8,0,0,0,94,211,79,75,15,20,1303,1502,1146,1108,44,44,0,30213126.924999997
JUSTIN.FALK,20142015,CBJ,76.08333333333333,1,0,1,1,2,1,0,0,0,8,12,6,2,1,2,51,65,46,55,2,4,0,30213029.335
JUSTIN.FALK,20142015,MIN,118.31666666666666,0,0,0,0,0,0,0,0,0,10,19,6,6,2,2,104,138,98,120,5,9,0,30213034.77
JUSTIN.FAULK,20142015,CAR,2002.9333333333334,15,16,17,33,48,31,0,0,0,238,463,157,138,9,15,2188,1747,1626,1322,55,68,0,30213145.365000002
JUSTIN.FONTAINE,20142015,MIN,913.35,10,13,9,22,32,23,1,2,1,107,191,10,42,10,7,759,766,707,681,39,24,0.5,30213098.515
JUSTIN.HODGMAN,20142015,ARI,56.983333333333334,1,0,0,0,1,1,25,46,21,3,4,8,0,1,1,49,36,42,36,0,2,0.5434782608695652,30213027.61
JUSTIN.SCHULTZ,20142015,EDM,1831.5166666666667,6,14,10,24,30,20,1,1,0,122,301,41,108,6,6,1884,1547,1380,1375,64,72,1,30213153.65
JUSTIN.SHUGG,20142015,CAR,17.083333333333336,0,0,0,0,0,0,0,0,0,3,4,3,0,0,1,12,14,11,12,0,0,0,30213024.049999997
JUSTIN.WILLIAMS,20142015,L.A,1279.9166666666667,18,10,13,23,41,28,3,6,3,174,307,29,67,20,14,1368,952,1113,835,49,35,0.5,30213104.895
JYRKI.JOKIPAKKA,20142015,DAL,842.05,0,4,6,10,10,4,0,0,0,40,101,42,38,1,4,798,877,740,747,33,34,0,30213092.16
KAEL.MOUILLIERAT,20142015,NYI,52.06666666666666,1,0,1,1,2,1,16,34,18,1,4,8,1,0,3,42,54,41,53,2,4,0.47058823529411764,30213029.965
KARL.ALZNER,20142015,WSH,1876.65,7,7,9,16,23,14,0,0,0,85,202,156,71,7,13,1539,1769,1427,1366,55,51,0,30213152.845
KARL.STOLLERY,20142015,COL,57.1,0,0,0,0,0,0,0,0,0,3,6,5,3,1,1,60,41,50,41,3,0,0,30213025.560000002
KARL.STOLLERY,20142015,S.J,90.18333333333334,0,0,0,0,0,0,0,0,0,6,17,18,9,0,2,112,101,104,72,1,4,0,30213027.2
KEATON.ELLERBY,20142015,WPG,16.96666666666667,0,0,0,0,0,0,0,0,0,0,1,1,1,0,0,9,12,9,12,0,1,0,15106512.45
KEEGAN.LOWE,20142015,CAR,27.683333333333334,0,0,0,0,0,0,0,0,0,0,4,3,4,2,2,17,37,17,35,0,1,0,30213026.62
KEITH.AULIE,20142015,EDM,443.4166666666667,0,0,0,0,0,0,0,0,0,25,59,59,19,10,20,349,474,341,438,17,20,0,30213070.1
KEITH.BALLARD,20142015,MIN,168.76666666666665,0,0,1,1,1,0,0,0,0,5,10,15,3,7,10,131,176,123,158,7,11,0,30213040.445
KEITH.YANDLE,20142015,ARI,1506.2333333333333,4,12,25,37,41,16,0,0,0,185,421,39,134,12,16,1719,1317,1119,1162,35,57,0,30213138.545
KEITH.YANDLE,20142015,NYR,760.6333333333333,4,7,10,17,21,11,0,0,0,79,173,23,60,6,9,858,622,612,580,27,15,0,30213078.61
KERBY.RYCHEL,20142015,CBJ,53.46666666666667,0,3,0,3,3,3,0,0,0,3,9,11,3,0,1,36,50,36,49,3,0,0,30213029.1
KEVAN.MILLER,20142015,BOS,739.3666666666667,2,1,3,4,6,3,0,0,0,36,86,87,31,3,6,552,722,522,534,25,11,0,30213073.005000003
KEVIN.BIEKSA,20142015,VAN,1359.65,4,4,5,9,13,8,0,0,0,104,218,115,73,13,33,1218,1348,1002,1064,46,52,0,30213129.805
KEVIN.CONNAUTON,20142015,CBJ,908.6833333333333,9,7,3,10,19,16,0,0,0,86,180,75,60,6,13,889,840,692,782,35,39,0,30213107.634999998
KEVIN.CONNAUTON,20142015,DAL,96.71666666666667,0,0,2,2,2,0,0,0,0,10,19,8,5,1,3,106,89,102,86,7,3,0,30213029.61
KEVIN.FIALA,20142015,NSH,22.5,0,0,0,0,0,0,0,0,0,5,6,1,1,0,0,25,24,25,24,0,2,0,30213024.95
KEVIN.HAYES,20142015,NYR,1300.2333333333333,19,30,3,33,52,49,292,797,505,136,224,76,49,11,11,1266,1104,1069,1012,47,37,0.36637390213299875,30213167.365000002
KEVIN.KLEIN,20142015,NYR,1469.0333333333333,9,8,10,18,27,17,0,1,1,97,216,160,81,7,9,1221,1466,1130,1201,60,43,0,30213142.770000003
KEVIN.SHATTENKIRK,20142015,STL,1400.8333333333333,8,20,21,41,49,28,0,0,0,148,290,47,86,8,16,1497,1054,1019,841,53,28,0,30213104.905
KIMMO.TIMONEN,20142015,CHI,347.48333333333335,0,0,0,0,0,0,0,0,0,16,30,33,12,1,6,308,341,290,337,7,8,0,30213057.41
KLAS.DAHLBECK,20142015,ARI,364.5833333333333,0,2,1,3,3,2,0,0,0,16,44,58,15,2,3,270,467,251,328,7,15,0,30213058.295
KLAS.DAHLBECK,20142015,CHI,41.56666666666666,1,0,0,0,1,1,0,0,0,4,10,6,0,1,1,43,53,42,52,3,4,0,15106517.56
KORBINIAN.HOLZER,20142015,TOR,581.5,0,5,1,6,6,5,0,0,0,32,50,117,8,4,7,415,664,388,500,20,19,0,30213079.415
KRIS.LETANG,20142015,PIT,1759.2833333333333,11,20,20,40,51,31,0,1,1,197,382,131,126,19,30,1854,1505,1269,1012,51,41,0,30213119.09
KRIS.RUSSELL,20142015,CGY,2186.1833333333334,6,12,21,33,39,18,0,0,0,124,290,72,115,12,9,1921,2370,1428,1939,77,68,0,30213233.195
KRIS.VERSTEEG,20142015,CHI,1127.1166666666668,15,14,7,21,36,29,16,51,35,157,266,44,62,18,18,1217,929,993,851,40,25,0.3137254901960784,30213116.245
KYLE.BAUN,20142015,CHI,37.61666666666667,0,0,0,0,0,0,0,0,0,4,8,12,0,0,0,29,26,29,26,0,1,0,30213025.15
KYLE.BRODZIAK,20142015,MIN,1076.1166666666668,9,6,5,11,20,15,382,802,420,98,167,69,32,10,17,716,1162,670,809,28,41,0.4763092269326683,30213136.055
KYLE.CHIPCHURA,20142015,ARI,937.9833333333333,4,4,6,10,14,8,473,916,443,81,128,130,28,21,22,842,961,780,787,14,30,0.5163755458515283,30213125.68
KYLE.CLIFFORD,20142015,L.A,859.0666666666666,6,6,3,9,15,12,2,6,4,117,192,200,39,16,25,777,664,764,648,31,25,0.3333333333333333,30213088.665
KYLE.CUMISKEY,20142015,CHI,178.28333333333333,0,0,0,0,0,0,0,0,0,6,19,5,6,2,0,169,154,162,146,2,6,0,30213035.42
KYLE.OKPOSO,20142015,NYI,1302.85,20,20,14,34,54,40,90,185,95,211,392,64,89,18,7,1582,1046,1082,944,44,45,0.4864864864864865,30213131.73
KYLE.PALMIERI,20142015,ANA,1014.6833333333334,15,10,8,18,33,25,6,13,7,146,278,133,57,11,15,1066,865,832,794,34,29,0.46153846153846156,30213112.9
KYLE.QUINCEY,20142015,DET,1559.4666666666667,3,12,4,16,19,15,0,0,0,98,230,114,89,20,33,1223,1353,1128,1004,50,42,0,30213114.9
KYLE.TURRIS,20142015,OTT,1694.95,25,26,14,40,65,51,810,1605,795,236,448,63,125,30,21,1880,1518,1232,1213,56,53,0.5046728971962616,30213195.450000003
LADISLAV.SMID,20142015,CGY,432.93333333333334,0,0,1,1,1,0,0,0,0,21,42,51,10,4,4,318,492,303,426,7,20,0,30213070.465
LANCE.BOUMA,20142015,CGY,1121.3166666666666,16,12,6,18,34,28,29,74,45,106,182,268,30,22,17,787,1343,724,1025,39,32,0.3918918918918919,30213157.98
LANDON.FERRARO,20142015,DET,106.95,1,0,0,0,1,1,1,1,0,14,23,17,7,2,1,67,109,64,101,2,3,1,30213034.66
LARS.ELLER,20142015,MTL,1385.2833333333333,16,9,5,14,30,25,502,953,451,176,287,97,56,24,23,1158,1325,1000,1059,35,42,0.5267576075550892,30213164.244999997
LAURI.KORPIKOSKI,20142015,ARI,1052.1333333333332,6,8,7,15,21,14,11,33,22,82,163,141,42,9,5,875,1187,701,892,14,39,0.3333333333333333,30213127.905
LEE.STEMPNIAK,20142015,NYR,659.25,9,1,8,9,18,10,11,25,14,86,156,58,47,10,9,630,567,514,518,21,16,0.44,30213078.09
LEE.STEMPNIAK,20142015,WPG,294.93333333333334,7,4,0,4,11,11,1,8,7,37,64,28,15,3,1,256,244,228,222,13,9,0.125,30213049.67
LEO.KOMAROV,20142015,TOR,911.3833333333333,8,11,6,17,25,19,95,192,97,84,138,250,29,12,9,682,992,606,684,29,32,0.4947916666666667,30213107.77
LEON.DRAISAITL,20142015,EDM,469.7333333333333,2,6,1,7,9,8,128,315,187,49,77,21,10,9,2,488,378,397,365,11,25,0.40634920634920635,30213069.935
LIAM.O'BRIEN,20142015,WSH,98.06666666666666,1,1,0,1,2,2,1,2,1,16,22,35,3,4,7,87,74,87,74,4,0,0.5,30213031.38
LINDEN.VEY,20142015,VAN,997.7333333333333,10,7,7,14,24,17,216,507,291,62,128,15,39,10,10,946,819,712,772,26,34,0.4260355029585799,30213121.415
LOGAN.COUTURE,20142015,S.J,1561.9499999999998,27,23,16,39,66,50,477,990,513,264,497,85,118,18,NA,1845,1470,1122,1101,46,51,0.4818181818181818,NA
LOUI.ERIKSSON,20142015,BOS,1496.6333333333332,22,16,9,25,47,38,4,12,8,169,264,29,34,14,6,1620,1200,1019,914,39,40,0.3333333333333333,30213132.424999997
LUBOMIR.VISNOVSKY,20142015,NYI,1100.2666666666667,5,10,6,16,21,15,0,1,1,90,193,39,66,8,4,1244,842,942,780,44,43,0,30213090.58
LUCA.SBISA,20142015,VAN,1531.7166666666667,4,1,7,8,12,5,0,0,0,85,187,164,72,16,18,1219,1647,1133,1278,52,69,0,30213149.935000002
LUCAS.LESSIO,20142015,ARI,331.65,2,1,2,3,5,3,0,2,2,44,63,58,9,6,4,294,294,276,290,7,17,0,30213054.86
LUKE.ADAM,20142015,CBJ,19.333333333333332,0,0,0,0,0,0,0,0,0,0,1,2,1,0,1,11,9,9,9,0,0,0,30213023.4
LUKE.GAZDIC,20142015,EDM,295.65,2,0,1,1,3,2,0,0,0,26,46,76,8,10,11,212,286,211,286,6,10,0,30213057.275
LUKE.GLENDENING,20142015,DET,1315.7,14,3,4,7,21,17,540,1052,512,114,164,154,23,16,21,745,1481,663,850,29,26,0.5133079847908745,30213150.009999998
LUKE.SCHENN,20142015,PHI,1048.05,3,5,6,11,14,8,0,0,0,67,154,194,66,6,6,894,1089,845,830,34,37,0,30213099.36
LUKE.WITKOWSKI,20142015,T.B,242.98333333333332,0,0,0,0,0,0,0,0,0,10,28,37,12,5,6,208,223,198,192,10,9,0,30213039.55
MAGNUS.PAAJARVI,20142015,STL,97.96666666666667,0,0,1,1,1,0,1,1,0,9,16,8,2,1,3,87,68,80,68,1,3,1,30213029.225
MANNY.MALHOTRA,20142015,MTL,629.4833333333333,1,1,2,3,4,2,537,906,369,46,79,37,16,6,6,311,784,290,521,8,11,0.5927152317880795,30213100.29
MARC-ANDRE.CLICHE,20142015,COL,784.85,2,4,1,5,7,6,376,734,358,68,101,27,23,7,7,429,943,381,616,14,19,0.5122615803814714,30213112.634999998
MARC-EDOUARD.VLASIC,20142015,S.J,1547.8166666666666,9,5,8,13,22,14,0,0,0,98,237,51,92,11,10,1454,1495,1193,1090,45,43,0,30213121.96
MARC.METHOT,20142015,OTT,1162.7833333333333,1,2,7,9,10,3,0,1,1,57,104,121,26,6,12,1110,1112,1009,863,42,25,0,30213098.384999998
MARC.STAAL,20142015,NYR,2083.8166666666666,5,4,12,16,21,9,1,2,1,109,236,115,78,9,26,1647,2125,1509,1722,64,61,0.5,30213200.130000003
MARCEL.GOC,20142015,PIT,535.0333333333333,2,1,3,4,6,3,236,437,201,43,74,56,13,3,2,352,553,295,299,9,11,0.540045766590389,30213061.645
MARCEL.GOC,20142015,STL,363.18333333333334,1,0,2,2,3,1,156,283,127,38,63,31,11,0,2,254,305,249,241,4,6,0.5512367491166078,30213051.79
MARCO.SCANDELLA,20142015,MIN,1597.25,13,7,6,13,26,20,0,0,0,128,282,105,92,7,21,1346,1483,1187,1114,53,46,0,30213131.52
MARCUS.FOLIGNO,20142015,BUF,924.8333333333333,8,9,3,12,20,17,57,132,75,66,108,193,17,14,14,634,1060,514,853,25,30,0.4318181818181818,30213137.945
MARCUS.JOHANSSON,20142015,WSH,1597.8833333333332,21,11,19,30,51,32,8,17,9,156,300,103,88,19,6,1820,1253,1190,1110,46,42,0.47058823529411764,30213140.835
MARCUS.KRUGER,20142015,CHI,1406.65,9,7,5,12,21,16,472,899,427,153,243,38,51,18,18,1158,1429,1077,986,26,39,0.525027808676307,30213142.685000002
MAREK.ZIDLICKY,20142015,DET,469.9833333333333,3,4,4,8,11,7,0,0,0,35,82,28,33,2,8,512,290,348,262,13,10,0,30213045.07
MAREK.ZIDLICKY,20142015,N.J,1381.3833333333332,4,8,11,19,23,12,0,1,1,103,231,76,77,12,21,1154,1049,857,901,35,33,0,30213114.494999997
MARIAN.GABORIK,20142015,L.A,1167.1333333333332,27,13,6,19,46,40,1,1,0,174,288,39,55,7,9,1371,783,973,660,45,31,1,30213094.46
MARIAN.HOSSA,20142015,CHI,1978.3333333333335,26,32,20,52,78,58,7,10,3,316,572,100,163,16,20,2123,1627,1551,1266,70,47,0.7,30213156.240000002
MARK.ALT,20142015,PHI,9.416666666666666,0,0,0,0,0,0,0,0,0,0,6,1,3,0,0,12,5,12,5,0,1,0,15106510.95
MARK.ARCOBELLO,20142015,ARI,423.3333333333333,9,3,4,7,16,12,215,403,188,59,103,34,21,2,3,476,389,392,346,13,15,0.533498759305211,30213068.62
MARK.ARCOBELLO,20142015,EDM,553.5833333333333,7,3,2,5,12,10,252,526,274,54,107,54,26,5,6,487,481,409,399,14,22,0.4790874524714829,30213077.43
MARK.ARCOBELLO,20142015,NSH,42.333333333333336,1,0,0,0,1,1,2,3,1,3,8,3,4,0,0,27,29,27,27,1,1,0.6666666666666666,30213025.33
MARK.ARCOBELLO,20142015,PIT,120.86666666666667,0,1,1,2,2,1,2,7,5,13,25,20,6,3,1,122,77,108,77,3,2,0.2857142857142857,30213028.985
MARK.BARBERIO,20142015,T.B,881.4333333333334,1,2,2,4,5,3,0,0,0,54,125,35,43,5,8,797,772,765,686,24,31,0,30213083
MARK.BOROWIECKI,20142015,OTT,1101,1,4,6,10,11,5,0,0,0,35,87,261,31,19,37,830,1198,780,889,35,28,0,30213117.79
MARK.FAYNE,20142015,EDM,1327.2833333333333,2,1,5,6,8,3,0,0,0,78,185,81,78,0,7,965,1381,873,1015,29,50,0,30213122.325000003
MARK.FISTRIC,20142015,ANA,133.05,0,0,0,0,0,0,0,0,0,1,10,28,3,0,2,114,136,110,124,5,8,0,30213034.75
MARK.FRASER,20142015,N.J,553.35,0,2,2,4,4,2,0,0,0,19,50,85,17,9,20,339,543,317,454,13,17,0,30213075.54
MARK.GIORDANO,20142015,CGY,1535.55,11,17,18,35,46,28,0,0,0,157,361,59,131,20,17,1487,1364,985,1054,42,39,0,30213134.4
MARK.LETESTU,20142015,CBJ,720.2666666666667,7,4,2,6,13,11,319,603,284,63,101,51,23,5,0,445,768,363,490,16,23,0.5290215588723052,30213093.46
MARK.PYSYK,20142015,BUF,127.25,2,0,0,0,2,2,0,0,0,4,10,1,3,0,1,79,134,64,121,6,3,0,30213037.85
MARK.SCHEIFELE,20142015,WPG,1593.4333333333334,15,16,18,34,49,31,526,1227,701,172,313,103,77,34,14,1645,1294,1205,1082,53,43,0.4286878565607172,30213166.53
MARK.STONE,20142015,OTT,1476.95,26,24,16,40,66,50,10,21,11,166,275,54,42,15,8,1571,1373,1090,1010,57,43,0.47619047619047616,30213147.35
MARK.STREIT,20142015,PHI,1811.8000000000002,9,24,18,42,51,33,0,0,0,144,316,63,120,10,17,2012,1489,1267,1286,50,51,0,30213157.25
MARK.STUART,20142015,WPG,1416.0833333333335,3,7,5,12,15,10,0,1,1,54,162,188,79,10,33,1174,1531,1084,1012,38,40,0,30213116.675
MARKO.DANO,20142015,CBJ,464,8,8,5,13,21,16,16,37,21,84,129,94,25,8,7,438,367,414,351,24,13,0.43243243243243246,30213063.695
MARKUS.GRANLUND,20142015,CGY,664.9333333333334,8,5,5,10,18,13,199,539,340,67,123,45,38,11,6,519,727,455,636,24,27,0.3692022263450835,30213113.945
MARTIN.ERAT,20142015,ARI,1253.3833333333332,9,14,9,23,32,23,0,6,6,91,180,96,51,11,25,1355,1057,1028,900,37,48,0,30213116.285
MARTIN.HANZAL,20142015,ARI,656.2333333333333,8,10,6,16,24,18,346,612,266,85,144,105,27,12,14,676,588,473,429,22,25,0.565359477124183,30213083.71
MARTIN.HAVLAT,20142015,N.J,591.3666666666667,5,5,4,9,14,10,0,0,0,49,84,11,12,4,4,451,475,357,436,12,20,0,30213076.09
MARTIN.MARINCIN,20142015,EDM,764.5166666666667,1,2,1,3,4,3,1,1,0,38,114,17,47,2,8,652,774,606,638,18,22,1,30213083.134999998
MARTIN.ST. LOUIS,20142015,NYR,1613.15,22,24,13,37,59,46,56,121,65,176,306,25,57,22,12,1681,1378,1125,1243,55,45,0.4628099173553719,30213178.985
MASON.RAYMOND,20142015,CGY,921.8,12,9,4,13,25,21,1,4,3,132,231,12,71,10,4,873,914,650,833,28,35,0.25,30213121.189999998
MAT.CLARK,20142015,ANA,89.39999999999999,0,1,0,1,1,1,0,0,0,2,7,10,4,2,3,78,100,69,79,4,2,0,30213030.82
MATHIEU.PERREAULT,20142015,WPG,1057.3666666666668,17,20,5,25,42,37,226,441,215,136,230,83,54,17,18,1232,697,813,624,33,29,0.5124716553287982,30213103.835
MATS.ZUCCARELLO,20142015,NYR,1419.1333333333332,15,21,14,35,50,36,16,38,22,167,312,130,77,27,20,1458,1139,1118,1011,61,43,0.42105263157894735,30213133.21
MATT.BARTKOWSKI,20142015,BOS,796.2333333333333,0,4,0,4,4,4,0,0,0,67,143,88,33,7,10,654,694,598,601,22,28,0,30213081.619999997
MATT.BELESKEY,20142015,ANA,1196.9166666666667,30,5,6,11,41,35,9,21,12,190,393,221,99,12,16,1284,982,1004,883,50,36,0.42857142857142855,30213119.130000003
MATT.CALVERT,20142015,CBJ,895.65,13,6,4,10,23,19,6,10,4,93,156,92,32,17,10,713,838,577,643,26,28,0.6,30213100.560000002
MATT.CARLE,20142015,T.B,1620.6999999999998,4,7,9,16,20,11,0,0,0,96,195,55,66,8,15,1346,1497,1186,1126,48,47,0,30213129.455
MATT.COOKE,20142015,MIN,443.35,4,4,3,7,11,8,3,9,6,32,63,54,21,11,7,292,485,275,348,12,13,0.3333333333333333,30213064.255
MATT.CULLEN,20142015,NSH,910.75,8,7,12,19,27,15,205,379,174,101,176,16,33,10,10,873,815,781,694,36,26,0.5408970976253298,30213100.85
MATT.DONOVAN,20142015,NYI,233.56666666666666,0,3,0,3,3,3,0,0,0,13,43,23,16,4,1,222,207,188,202,8,5,0,30213042.29
MATT.DUCHENE,20142015,COL,1522.8833333333332,21,19,15,34,55,40,634,1216,582,207,344,43,62,24,8,1376,1496,975,1277,58,51,0.5213815789473685,30213208.125
MATT.DUMBA,20142015,MIN,1031.4666666666667,10,4,6,10,20,14,0,0,0,101,223,66,76,9,11,1000,831,802,750,43,30,0,30213093.490000002
MATT.ELLIS,20142015,BUF,324.6333333333333,1,1,0,1,2,2,100,205,105,29,40,10,5,2,2,199,408,189,316,5,16,0.4878048780487805,30213066.22
MATT.FRASER,20142015,BOS,252.55,3,0,0,0,3,3,0,4,4,29,46,42,9,2,2,202,196,195,193,5,11,0,30213043.67
MATT.FRASER,20142015,EDM,420.5333333333333,5,1,3,4,9,6,3,3,0,63,95,69,17,11,5,354,409,305,401,11,21,1,30213071.455
MATT.FRATTIN,20142015,TOR,63.5,0,0,0,0,0,0,1,1,0,6,11,4,4,1,2,54,60,54,59,0,0,1,30213028.65
MATT.GREENE,20142015,L.A,1295.6833333333334,3,2,3,5,8,5,0,0,0,69,175,209,59,6,20,1136,1232,1071,907,38,39,0,30213100.384999998
MATT.HALISCHUK,20142015,WPG,467.29999999999995,3,1,4,5,8,4,1,1,0,60,84,55,11,7,3,376,414,364,378,16,12,1,30213063.409999996
MATT.HENDRICKS,20142015,EDM,933.8,8,6,2,8,16,14,98,198,100,103,172,220,32,15,26,662,1012,598,727,15,33,0.494949494949495,30213116.869999997
MATT.HUNWICK,20142015,NYR,940.5666666666666,2,5,4,9,11,7,0,0,0,74,146,61,46,3,8,922,804,826,737,44,26,0,30213087.630000003
MATT.IRWIN,20142015,S.J,902.0333333333333,8,5,5,10,18,13,0,0,0,93,191,55,68,9,9,919,794,785,735,33,33,0,30213093.165
MATT.LINDBLAD,20142015,BOS,15.516666666666667,0,0,0,0,0,0,0,5,5,3,5,2,1,0,0,12,4,11,2,0,0,0,15106511.25
MATT.MARTIN,20142015,NYI,962.4166666666667,8,4,3,7,15,12,5,10,5,98,156,433,26,29,29,857,776,818,753,27,30,0.5,30213104.365000002
MATT.MOULSON,20142015,BUF,1361.9333333333334,13,17,11,28,41,30,13,22,9,155,NA,34,NA,6,2,NA,NA,NA,NA,39,42,0.5909090909090909,NA
MATT.NIETO,20142015,S.J,1098.3833333333332,10,10,7,17,27,20,0,1,1,135,221,24,41,11,9,1118,1066,958,860,33,48,0,30213113.785
MATT.NISKANEN,20142015,WSH,2166.083333333333,4,18,11,29,33,22,0,0,0,139,341,178,113,5,22,1898,1963,1566,1478,56,56,0,30213164.375
MATT.PUEMPEL,20142015,OTT,104.41666666666666,2,0,1,1,3,2,0,1,1,14,26,9,5,0,3,105,86,104,86,7,1,0,30213031.075
MATT.READ,20142015,PHI,1405.3166666666666,8,12,10,22,30,20,11,21,10,142,256,108,55,12,7,1134,1337,879,992,36,36,0.5238095238095238,30213135.31
MATT.STAJAN,20142015,CGY,885.1666666666667,8,8,5,13,21,16,397,773,376,57,118,101,38,13,18,664,981,617,765,27,21,0.5135834411384217,30213127.535
MATT.TENNYSON,20142015,S.J,474.31666666666666,2,2,3,5,7,4,0,0,0,37,85,48,20,1,7,428,438,339,364,10,9,0,30213061.285
MATTIAS.EKHOLM,20142015,NSH,1679.15,8,3,7,10,18,11,0,0,0,92,213,65,92,13,28,1530,1357,1351,1107,66,49,0,30213114.005
MAX.FRIBERG,20142015,ANA,8.783333333333333,0,0,0,0,0,0,0,0,0,0,1,2,1,0,0,7,14,7,14,0,0,0,15106512.85
MAX.PACIORETTY,20142015,MTL,1769.85,42,18,13,31,73,60,2,10,8,348,646,117,170,14,20,1925,1611,1361,1245,60,31,0.2,30213167.895
MAX.REINHART,20142015,CGY,32.35,0,0,0,0,0,0,6,29,23,3,11,1,2,0,0,29,38,29,38,0,3,0.20689655172413793,30213027.689999998
MAX.TALBOT,20142015,BOS,219.93333333333334,0,3,0,3,3,3,4,11,7,24,29,46,3,3,1,157,220,150,183,2,8,0.36363636363636365,30213045.04
MAX.TALBOT,20142015,COL,882.5166666666667,5,6,4,10,15,11,72,147,75,73,116,86,24,17,10,610,1032,547,694,30,27,0.4897959183673469,30213106.6
MAXIM.LAPIERRE,20142015,PIT,460.8,0,2,0,2,2,2,218,414,196,51,77,117,10,7,8,291,513,260,303,5,18,0.5265700483091788,30213065.240000002
MAXIM.LAPIERRE,20142015,STL,465.8666666666667,2,4,3,7,9,6,134,244,110,43,68,48,13,2,8,270,478,263,355,11,14,0.5491803278688525,30213070.355
MELKER.KARLSSON,20142015,S.J,818.05,13,5,6,11,24,18,13,33,20,100,174,51,33,9,9,846,688,747,617,29,29,0.3939393939393939,30213088.009999998
MICHAEL.BOURNIVAL,20142015,MTL,228.75,3,1,1,2,5,4,4,5,1,27,46,26,13,4,2,192,210,187,201,10,7,0.8,30213044.275
MICHAEL.CHAPUT,20142015,CBJ,336.56666666666666,1,2,2,4,5,3,143,294,151,23,40,59,5,5,8,190,368,179,309,5,13,0.48639455782312924,30213068.87
MICHAEL.DEL ZOTTO,20142015,PHI,1403.15,10,11,11,22,32,21,0,0,0,118,223,153,64,7,15,1289,1392,1024,1079,40,42,0,30213139.645
MICHAEL.FROLIK,20142015,WPG,1503.5500000000002,19,11,12,23,42,30,15,43,28,212,384,69,102,14,9,1428,1238,1137,913,45,42,0.3488372093023256,30213114.14
MICHAEL.GRABNER,20142015,NYI,463.2833333333333,8,1,5,6,14,9,0,2,2,63,123,63,29,5,3,439,501,399,401,15,13,0,30213066.375
MICHAEL.KOSTKA,20142015,NYR,107.7,0,0,1,1,1,0,0,0,0,7,13,6,5,1,0,97,95,90,83,6,5,0,30213029.235
MICHAEL.LATTA,20142015,WSH,471.75,0,4,2,6,6,4,175,359,184,24,51,98,16,14,15,379,396,372,374,12,9,0.48746518105849584,30213069.189999998
MICHAEL.PALIOTTA,20142015,CHI,12.75,0,0,1,1,1,0,0,0,0,2,3,0,0,0,0,11,11,11,11,1,1,0,15106512.375
MICHAEL.RAFFL,20142015,PHI,951.1166666666667,21,2,5,7,28,23,44,97,53,134,222,172,42,12,14,965,841,880,715,37,35,0.4536082474226804,30213101.205
MICHAEL.RYDER,20142015,N.J,680.5833333333333,6,9,4,13,19,15,2,6,4,89,156,52,28,10,14,586,562,450,522,21,19,0.3333333333333333,30213087.23
MICHAEL.SGARBOSSA,20142015,COL,21.28333333333333,0,0,1,1,1,0,9,20,11,2,6,0,3,2,1,19,27,18,27,3,3,0.45,30213025.555
MICHAEL.STONE,20142015,ARI,1690.3000000000002,3,10,4,14,17,13,1,1,0,142,330,202,115,8,29,1582,1760,1334,1379,35,56,1,30213159.57
MICHAL.JORDAN,20142015,CAR,605.9166666666667,2,0,3,3,5,2,0,0,0,44,85,35,33,8,2,568,487,488,465,14,23,0,30213065.005000003
MICHAL.ROZSIVAL,20142015,CHI,1280.25,1,5,8,13,14,6,0,0,0,61,154,127,65,6,14,1268,1114,1171,1013,42,46,0,30213109.11
MICHEAL.FERLAND,20142015,CGY,386.6833333333334,5,5,0,5,10,10,1,2,1,46,82,116,15,10,10,318,382,293,367,11,8,0.5,30213069.189999998
MICHEAL.HALEY,20142015,S.J,30.03333333333333,0,0,0,0,0,0,2,2,0,1,2,6,1,5,3,17,31,17,27,0,1,1,30213026.08
MIIKKA.SALOMAKI,20142015,NSH,10.816666666666666,1,0,0,0,1,1,0,0,0,4,4,7,0,1,0,10,7,10,4,1,0,0,15106512.11
MIKA.ZIBANEJAD,20142015,OTT,1409.25,21,17,12,29,50,38,648,1354,706,163,320,162,79,24,10,1550,1165,1025,1038,43,40,0.47858197932053176,30213172.310000002
MIKAEL.BACKLUND,20142015,CGY,1130.2666666666667,11,8,10,18,29,19,493,1030,537,133,240,52,60,6,10,976,1085,719,854,33,35,0.4786407766990291,30213143.68
MIKAEL.GRANLUND,20142015,MIN,1394.15,10,18,17,35,45,28,545,1125,580,117,229,65,64,16,10,1501,1228,1140,1053,55,37,0.48444444444444446,30213154.835
MIKE.ANGELIDIS,20142015,T.B,22.03333333333333,0,0,0,0,0,0,7,19,12,0,0,5,0,3,3,16,14,16,14,0,0,0.3684210526315789,30213024.810000002
MIKE.BLUNDEN,20142015,T.B,19.566666666666666,0,0,0,0,0,0,0,0,0,0,1,7,1,0,1,12,15,12,15,0,1,0,15106512.9
MIKE.BROWN,20142015,S.J,98.45,0,0,0,0,0,0,4,7,3,11,24,42,4,3,7,73,89,70,89,1,1,0.5714285714285714,30213033.34
MIKE.CAMMALLERI,20142015,N.J,1246.5166666666667,27,7,8,15,42,34,119,282,163,156,258,30,55,9,14,972,1063,681,834,32,28,0.4219858156028369,30213140.8
MIKE.FISHER,20142015,NSH,1122.2,19,16,5,21,40,35,617,1182,565,113,196,129,38,13,15,1167,1007,803,745,40,25,0.5219966159052454,30213134.985
MIKE.GREEN,20142015,WSH,1633.2166666666667,10,23,14,37,47,33,0,0,0,186,359,98,100,18,26,1755,1315,1233,1154,46,36,0,30213146.13
MIKE.HOFFMAN,20142015,OTT,1227.9,28,16,7,23,51,44,7,15,8,215,399,49,112,13,9,1318,999,975,907,53,37,0.4666666666666667,30213126.534999996
MIKE.RIBEIRO,20142015,NSH,1677.3666666666668,16,29,21,50,66,45,626,1444,818,107,185,57,29,16,16,2034,1276,1485,1144,74,53,0.43351800554016623,30213175.674999997
MIKE.RICHARDS,20142015,L.A,708.3833333333333,5,8,3,11,16,13,289,593,304,63,126,62,25,15,14,648,595,536,503,18,27,0.4873524451939292,30213090.535
MIKE.SANTORELLI,20142015,NSH,337.3833333333333,2,2,1,3,5,4,10,21,11,50,78,12,13,1,3,309,316,296,302,8,13,0.47619047619047616,30213055.835
MIKE.SANTORELLI,20142015,TOR,852.5833333333333,11,8,10,18,29,19,77,166,89,102,153,47,27,8,4,713,838,646,730,34,32,0.463855421686747,30213112.86
MIKE.SISLO,20142015,N.J,122.11666666666667,0,1,0,1,1,1,0,0,0,13,19,12,3,0,1,78,114,78,87,1,3,0,30213032.4
MIKE.WEAVER,20142015,MTL,439.08333333333337,0,0,3,3,3,0,0,0,0,8,33,35,15,2,3,310,523,292,345,15,15,0,30213056.244999997
MIKE.WEBER,20142015,BUF,1199.5,1,1,4,5,6,2,0,0,0,41,NA,172,NA,11,28,NA,NA,NA,NA,20,44,0,NA
MIKHAIL.GRABOVSKI,20142015,NYI,771.3,9,3,7,10,19,12,60,124,64,86,180,15,44,13,3,842,626,704,583,22,19,0.4838709677419355,30213080.805
MIKHAIL.GRIGORENKO,20142015,BUF,379.23333333333335,3,0,3,3,6,3,153,331,178,35,57,28,12,2,1,310,396,248,380,9,16,0.4622356495468278,30213075.564999998
MIKKEL.BOEDKER,20142015,ARI,786.7666666666667,14,6,8,14,28,20,0,2,2,79,150,66,43,12,2,817,665,546,600,23,31,0,30213093.47
MIKKO.KOIVU,20142015,MIN,1722.2833333333333,15,18,19,37,52,33,1120,2036,916,192,324,47,73,6,19,1744,1344,1114,970,47,43,0.550098231827112,30213163.235
MILAN.LUCIC,20142015,BOS,1324.9666666666667,18,17,9,26,44,35,34,76,42,141,275,258,61,16,22,1381,1141,1072,1022,48,36,0.4473684210526316,30213140.745
MILAN.MICHALEK,20142015,OTT,1180.9,14,12,9,21,35,26,12,24,12,144,258,68,55,19,17,1113,1133,789,826,31,35,0.5,30213121.545
MIRCO.MUELLER,20142015,S.J,661.4833333333333,1,1,2,3,4,2,0,0,0,30,68,49,25,6,5,610,635,562,558,17,27,0,30213075.509999998
MORGAN.RIELLY,20142015,TOR,1647.35,8,11,9,20,28,19,0,0,0,148,312,98,103,9,7,1620,1533,1234,1328,44,54,0,30213158.814999998
NAIL.YAKUPOV,20142015,EDM,1250.8833333333332,14,12,7,19,33,26,0,1,1,191,337,97,80,20,7,1198,1131,915,1062,29,57,0,30213147.475
NATE.GUENIN,20142015,COL,1279.4666666666667,2,2,11,13,15,4,0,0,0,38,85,94,36,8,13,808,1496,746,1115,45,44,0,30213147.555
NATE.PROSSER,20142015,MIN,810.1666666666667,2,3,2,5,7,5,0,0,0,38,73,34,20,8,14,580,860,549,627,30,33,0,30213088.88
NATE.SCHMIDT,20142015,WSH,541.5666666666667,1,0,3,3,4,1,0,0,0,40,87,34,33,3,4,530,448,504,426,18,19,0,30213057.105
NATE.THOMPSON,20142015,ANA,1251.6166666666668,7,10,6,16,23,17,654,1222,568,100,174,236,32,15,NA,946,1304,847,946,33,31,0.5351882160392799,NA
NATHAN.BEAULIEU,20142015,MTL,1069.3666666666668,1,3,5,8,9,4,0,0,0,65,152,55,51,10,13,980,986,862,903,30,22,0,30213110.725
NATHAN.GERBE,20142015,CAR,1282.35,10,10,8,18,28,20,9,15,6,235,382,73,81,27,17,1292,1045,1002,865,30,38,0.6,30213113.380000003
NATHAN.MACKINNON,20142015,COL,1091.0666666666666,14,15,9,24,38,29,201,428,227,192,323,43,66,25,14,1162,968,817,853,36,33,0.4696261682242991,30213134.314999998
NAZEM.KADRI,20142015,TOR,1284.9833333333333,18,11,10,21,39,29,527,1143,616,176,327,118,80,39,14,1333,1143,982,991,42,45,0.46106736657917763,30213159.97
NICK.BJUGSTAD,20142015,FLA,1193.9166666666667,24,8,11,19,43,32,486,994,508,207,325,148,54,19,20,1189,971,845,834,36,35,0.48893360160965793,30213147.955
NICK.BONINO,20142015,VAN,1368.5666666666666,16,14,11,25,41,30,632,1333,701,162,269,33,55,11,13,1257,1314,953,927,40,38,0.4741185296324081,30213158.265
NICK.COUSINS,20142015,PHI,96.98333333333333,0,0,0,0,0,0,23,52,29,6,9,13,2,0,1,82,90,79,88,3,1,0.4423076923076923,30213032.67
NICK.FOLIGNO,20142015,CBJ,1487.55,31,22,20,42,73,53,124,262,138,182,273,193,48,28,21,1432,1250,976,966,58,44,0.4732824427480916,30213156.19
NICK.HOLDEN,20142015,COL,1543.3000000000002,5,5,4,9,14,10,0,0,0,94,198,156,60,4,14,1208,1629,877,1221,33,44,0,30213161.240000002
NICK.LEDDY,20142015,NYI,1760.85,10,10,21,31,41,20,0,0,0,135,275,87,86,5,7,1947,1457,1527,1229,63,45,0,30213130.075
NICK.SCHULTZ,20142015,PHI,1523.75,2,4,9,13,15,6,0,0,0,69,155,113,47,7,22,1157,1578,1035,1140,34,39,0,30213140.695
NICK.SHORE,20142015,L.A,376.95000000000005,1,2,4,6,7,3,127,236,109,33,57,51,8,7,5,322,305,302,268,10,9,0.538135593220339,30213053.65
NICK.SPALING,20142015,PIT,1317.9,10,6,11,17,27,16,84,176,92,95,183,144,50,8,15,1055,1185,948,892,35,38,0.4772727272727273,30213118.115000002
NICKLAS.BACKSTROM,20142015,WSH,1985.8166666666666,21,30,33,63,84,51,1044,1920,876,177,335,116,67,17,20,2313,1735,1544,1325,60,60,0.54375,30213204.055
NICKLAS.GROSSMANN,20142015,PHI,1200.6166666666668,5,1,7,8,13,6,0,0,0,43,104,132,41,8,16,897,1284,834,967,38,30,0,30213123.205
NICKLAS.JENSEN,20142015,VAN,47.78333333333333,0,0,0,0,0,0,0,0,0,7,9,7,2,0,0,42,42,40,42,1,2,0,30213026.7
NICOLAS.DESLAURIERS,20142015,BUF,973.4833333333333,5,6,4,10,15,11,0,1,1,76,143,261,33,16,21,547,1132,520,1002,18,40,0,30213153.41
NIKITA.KUCHEROV,20142015,T.B,1667.5333333333333,39,26,22,48,87,65,0,2,2,248,436,104,88,20,16,1798,1229,1366,1103,90,47,0,30213151.3
NIKITA.NESTEROV,20142015,T.B,616.6166666666666,3,4,5,9,12,7,0,0,0,55,118,58,40,4,12,639,472,528,435,31,20,0,30213059.965
NIKITA.NIKITIN,20142015,EDM,824.8333333333334,4,3,3,6,10,7,0,0,0,79,148,21,46,5,6,717,742,571,601,17,32,0,30213084.225
NIKITA.ZADOROV,20142015,BUF,1062.45,3,6,6,12,15,9,1,1,0,52,104,134,28,6,18,773,1088,630,972,35,37,1,30213138.549999997
NIKLAS.HJALMARSSON,20142015,CHI,2393.366666666667,4,8,11,19,23,12,0,0,0,121,295,55,121,7,25,2063,2275,1895,1764,75,53,0,30213180.845
NIKLAS.KRONWALL,20142015,DET,2048.55,9,15,20,35,44,24,1,1,0,105,228,101,81,4,22,1770,1816,1123,1144,40,49,1,30213144.43
NIKOLAY.KULEMIN,20142015,NYI,1329.3166666666666,16,8,9,17,33,24,7,25,18,120,227,151,51,7,6,1211,1322,1102,1026,40,42,0.28,30213131.725
NINO.NIEDERREITER,20142015,MIN,1313.8,28,8,6,14,42,36,2,9,7,168,305,178,64,22,17,1203,1030,981,924,41,42,0.2222222222222222,30213132.25
OLIVER.EKMAN-LARSSON,20142015,ARI,2067.45,23,12,7,19,42,35,0,0,0,263,569,167,180,16,20,2081,1878,1343,1259,45,55,0,30213149.985
OLIVER.LAURIDSEN,20142015,PHI,10.433333333333334,0,0,0,0,0,0,0,0,0,2,3,2,0,1,1,10,12,10,7,0,1,0,15106512.06
OLLI.JOKINEN,20142015,NSH,648.6166666666666,3,3,0,3,6,6,74,187,113,83,131,52,23,9,13,522,603,487,479,13,9,0.39572192513368987,30213079.45
OLLI.JOKINEN,20142015,STL,88,1,2,0,2,3,3,12,35,23,17,29,5,6,0,0,83,69,81,60,3,0,0.34285714285714286,30213029.78
OLLI.JOKINEN,20142015,TOR,85.75,0,1,0,1,1,1,48,108,60,10,22,7,5,1,1,73,82,59,57,0,0,0.4444444444444444,30213031.08
OLLI.MAATTA,20142015,PIT,414.1666666666667,1,3,2,5,6,4,0,0,0,27,56,18,18,6,5,384,382,306,293,15,12,0,30213050.86
ONDREJ.PALAT,20142015,T.B,1805.6833333333334,24,31,24,55,79,55,34,102,68,182,349,204,87,22,18,1735,1519,1287,1067,78,41,0.3333333333333333,30213144.18
OSCAR.KLEFBOM,20142015,EDM,1319.9333333333334,2,7,10,17,19,9,0,0,0,98,227,45,73,4,3,1141,1270,1016,1023,39,61,0,30213119.740000002
OSCAR.LINDBERG,20142015,NYR,8.3,0,0,0,0,0,0,2,5,3,2,3,3,1,0,0,10,6,10,6,0,0,0.4,15106511.73
P.K..SUBBAN,20142015,MTL,2469.7333333333336,16,24,27,51,67,40,0,0,0,206,496,121,188,25,41,2613,2169,1806,1650,77,62,0,30213183.075
PASCAL.DUPUIS,20142015,PIT,266.35,6,3,2,5,11,9,1,1,0,44,65,20,11,1,2,253,234,193,159,10,7,1,30213042.05
PATRIC.HORNQVIST,20142015,PIT,1221.5666666666666,27,15,12,27,54,42,2,7,5,237,399,103,82,23,18,1412,868,932,772,53,33,0.2857142857142857,30213114.509999998
PATRICE.BERGERON,20142015,BOS,1468.6166666666668,23,22,10,32,55,45,1173,1948,775,234,428,57,104,16,19,1755,1138,1137,824,41,44,0.6021560574948666,30213138.18
PATRICE.CORMIER,20142015,WPG,4.9,0,0,0,0,0,0,3,5,2,0,0,1,0,0,0,4,3,4,3,0,0,0.6,15106511.57
PATRICK.BORDELEAU,20142015,COL,6.766666666666667,0,0,0,0,0,0,0,0,0,0,0,2,0,0,0,3,8,3,8,0,0,0,15106512.3
PATRICK.BROWN,20142015,CAR,62.166666666666664,0,0,0,0,0,0,0,2,2,4,10,11,3,1,2,43,54,35,43,0,5,0,30213027.36
PATRICK.DWYER,20142015,CAR,906.8166666666666,5,4,3,7,12,9,5,19,14,77,NA,145,NA,6,5,NA,NA,NA,NA,17,28,0.2631578947368421,NA
PATRICK.EAVES,20142015,DAL,644.7166666666667,14,6,7,13,27,20,2,5,3,91,182,69,40,12,3,784,553,578,493,30,18,0.4,30213075.924999997
PATRICK.KALETA,20142015,BUF,372.43333333333334,0,2,1,3,3,2,3,8,5,25,40,88,10,15,11,182,465,176,358,3,15,0.375,30213069.895
PATRICK.KANE,20142015,CHI,1680.5833333333335,38,34,15,49,87,72,3,8,5,250,451,33,118,20,5,1983,1324,1303,1196,61,46,0.375,30213169.995
PATRICK.MARLEAU,20142015,S.J,1604.4499999999998,19,21,17,38,57,40,171,356,185,231,408,85,102,9,6,1880,1489,1156,1128,41,51,0.4803370786516854,30213158.655
PATRICK.MAROON,20142015,ANA,1300.9,16,22,6,28,44,38,10,29,19,162,263,174,34,22,30,1434,1016,1046,946,53,46,0.3448275862068966,30213136.47
PATRICK.SHARP,20142015,CHI,1501.4333333333334,21,20,17,37,58,41,58,121,63,294,525,120,131,20,19,1735,1148,1258,1042,51,53,0.4793388429752066,30213135.895
PATRICK.WIERCIOCH,20142015,OTT,1126.9,5,5,7,12,17,10,0,0,0,90,208,58,76,4,17,1257,883,914,784,34,31,0,30213091.765
PATRIK.BERGLUND,20142015,STL,1206.1833333333334,14,9,8,17,31,23,163,338,175,156,253,109,42,8,12,1109,937,974,802,40,35,0.4822485207100592,30213113.950000003
PATRIK.ELIAS,20142015,N.J,1216.3666666666668,13,12,9,21,34,25,263,673,410,114,196,23,35,8,6,947,974,641,688,22,34,0.39078751857355126,30213126.025
PATRIK.NEMETH,20142015,DAL,356.6333333333333,0,1,2,3,3,1,0,0,0,16,41,28,18,2,3,350,327,324,283,10,12,0,30213046.52
PAUL.BYRON,20142015,CGY,824.6833333333334,6,6,7,13,19,12,34,97,63,62,114,101,29,10,4,684,792,562,643,22,27,0.35051546391752575,30213097.835
PAUL.CAREY,20142015,COL,78.78333333333333,0,1,0,1,1,1,0,3,3,5,14,12,3,0,0,62,63,60,63,3,1,0,30213029
PAUL.GAUSTAD,20142015,NSH,1003.2666666666667,4,5,5,10,14,9,682,1211,529,59,110,162,30,19,25,566,1087,505,717,20,14,0.5631709331131296,30213129.745
PAUL.MARTIN,20142015,PIT,1807.9833333333331,3,10,8,18,21,13,0,0,0,66,177,65,66,7,11,1644,1595,1265,1130,56,40,0,30213123.67
PAUL.POSTMA,20142015,WPG,593.4166666666667,2,1,3,4,6,3,0,0,0,40,109,17,49,3,8,579,448,493,416,18,17,0,30213055.605
PAUL.STASTNY,20142015,STL,1409.2333333333333,17,17,13,30,47,34,731,1262,531,151,253,25,38,10,22,1523,1122,1094,913,46,38,0.5792393026941363,30213144.564999998
PAVEL.DATSYUK,20142015,DET,1334.1166666666666,29,26,14,40,69,55,655,1246,591,182,313,65,71,19,6,1523,815,1028,702,42,36,0.5256821829855538,30213128.29
PETER.HARROLD,20142015,N.J,655.4666666666667,3,1,1,2,5,4,0,0,0,31,62,40,16,7,2,401,608,368,474,13,20,0,30213075.495
PETER.HOLLAND,20142015,TOR,900.3166666666666,11,9,5,14,25,20,312,684,372,93,148,99,28,12,13,680,938,543,693,30,28,0.45614035087719296,30213125.825000003
PETER.REGIN,20142015,CHI,33.33333333333333,0,0,1,1,1,0,1,2,1,3,5,3,0,2,0,34,23,32,23,1,0,0.5,30213024.485
PETR.STRAKA,20142015,PHI,28.366666666666667,0,2,0,2,2,2,0,0,0,2,5,4,2,0,0,29,20,29,20,2,1,0,15106513.4
PETTER.GRANBERG,20142015,TOR,80.1,0,0,0,0,0,0,0,0,0,1,2,16,1,0,3,48,83,40,56,1,1,0,30213029.1
PETTERI.LINDBOHM,20142015,STL,358.1333333333333,2,1,0,1,3,3,0,0,0,32,53,26,13,7,10,301,294,279,273,9,12,0,30213051.32
PHIL.KESSEL,20142015,TOR,1541.0500000000002,25,17,19,36,61,42,2,5,3,280,508,18,138,11,16,1713,1450,1083,1278,41,63,0.4,30213178.115000002
PHILIP.SAMUELSSON,20142015,ARI,67.53333333333333,0,0,0,0,0,0,0,0,0,4,5,2,1,0,0,44,75,43,56,0,3,0,30213028.8
PHILIP.VARONE,20142015,BUF,376.43333333333334,3,1,1,2,5,4,147,326,179,28,45,30,9,2,5,277,430,232,407,8,19,0.450920245398773,30213081.775
PHILLIP.DANAULT,20142015,CHI,19,0,0,0,0,0,0,6,20,14,2,4,3,1,2,0,22,13,19,12,1,0,0.3,15106512.56
PIERRE-ALEX.PARENTEAU,20142015,MTL,954.25,9,9,6,15,24,18,11,28,17,112,201,42,48,13,11,943,759,720,700,30,23,0.39285714285714285,30213099.619999997
PIERRE-EDOUARD.BELLEMARE,20142015,PHI,1039.3833333333332,6,4,2,6,12,10,360,761,401,113,204,121,45,14,6,744,1123,688,796,25,27,0.4730617608409987,30213126.689999998
R.J..UMBERGER,20142015,PHI,925.85,9,5,1,6,15,14,9,22,13,96,176,114,39,12,8,757,879,638,734,20,28,0.4090909090909091,30213107.655
RADIM.VRBATA,20142015,VAN,1409.3166666666666,33,20,14,34,67,53,5,9,4,288,482,45,101,6,14,1530,1087,1016,960,41,38,0.5555555555555556,30213146.259999998
RADKO.GUDAS,20142015,T.B,526.3666666666666,2,1,2,3,5,3,0,0,0,63,132,115,33,4,12,518,522,488,446,16,19,0,30213064.740000002
RAMAN.HRABARENKA,20142015,N.J,11.916666666666666,0,0,0,0,0,0,0,0,0,0,0,1,0,0,0,8,12,8,8,1,0,0,15106511.9
RAPHAEL.DIAZ,20142015,CGY,696.9333333333334,2,1,1,2,4,3,0,0,0,53,134,24,47,4,5,614,607,511,580,20,21,0,30213079.365000002
RASMUS.RISSANEN,20142015,CAR,89.86666666666667,0,0,0,0,0,0,0,0,0,3,9,25,5,0,2,75,87,72,74,0,5,0,30213029.700000003
RASMUS.RISTOLAINEN,20142015,BUF,1607.8666666666668,8,6,5,11,19,14,1,1,0,121,NA,118,NA,10,12,NA,NA,NA,NA,27,52,1,NA
REID.BOUCHER,20142015,N.J,122.53333333333333,1,0,0,0,1,1,0,0,0,20,37,9,6,2,0,112,99,105,97,3,6,0,30213032.17
REILLY.SMITH,20142015,BOS,1247.4333333333334,13,17,10,27,40,30,2,8,6,143,293,74,92,13,11,1415,937,1065,876,46,40,0.25,30213108.36
RENE.BOURQUE,20142015,ANA,363.96666666666664,2,4,1,5,7,6,1,5,4,44,91,36,22,3,7,353,338,295,329,10,13,0.2,30213059.445
RENE.BOURQUE,20142015,CBJ,119.83333333333334,4,0,0,0,4,4,0,0,0,23,35,17,5,1,2,118,131,99,123,3,6,0,30213039.060000002
RENE.BOURQUE,20142015,MTL,160.45,0,2,0,2,2,2,3,5,2,18,40,18,13,2,3,157,151,146,131,5,13,0.6,30213034.689999998
RICH.CLUNE,20142015,NSH,5.5,0,0,0,0,0,0,0,0,0,0,0,3,0,0,0,1,6,1,6,0,0,0,15106512.1
RICHARD.PANIK,20142015,TOR,885,11,4,2,6,17,15,2,7,5,87,152,101,33,19,18,745,803,647,708,23,29,0.2857142857142857,30213105.47
RICK.NASH,20142015,NYR,1730.3666666666668,47,23,12,35,82,70,3,5,2,373,612,85,138,19,19,1859,1509,1240,1205,71,40,0.6,30213178.11
RICKARD.RAKELL,20142015,ANA,1075.6666666666665,10,11,11,22,32,21,384,830,446,124,238,111,54,2,6,1105,866,927,828,36,33,0.46265060240963857,30213126.305
RILEY.NASH,20142015,CAR,1107.8333333333335,8,11,5,16,24,19,487,955,468,94,172,88,48,6,6,1030,900,774,693,26,32,0.5099476439790576,30213112.865000002
RILEY.SHEAHAN,20142015,DET,1334.6999999999998,15,15,8,23,38,30,506,1027,521,131,237,27,53,11,8,1342,923,900,729,35,34,0.49269717624148,30213121.85
ROB.KLINKHAMMER,20142015,ARI,219.5,3,0,0,0,3,3,0,1,1,23,40,44,6,7,3,205,181,198,179,6,4,0,30213041.47
ROB.KLINKHAMMER,20142015,EDM,443.25,1,2,0,2,3,3,9,35,26,31,63,156,16,13,10,328,411,317,399,8,17,0.2571428571428571,30213069.09
ROB.KLINKHAMMER,20142015,PIT,111.26666666666668,1,1,1,2,3,2,1,1,0,10,15,36,2,5,0,99,83,96,83,3,3,1,30213031.265
ROB.SCUDERI,20142015,PIT,1680.1833333333334,1,4,5,9,10,5,0,0,0,54,125,42,52,6,7,1243,1696,1140,1103,43,38,0,30213123.784999996
ROBERT.BORTUZZO,20142015,PIT,587.45,2,2,2,4,6,4,1,1,0,37,85,116,30,15,20,488,508,444,421,16,19,1,30213064.189999998
ROBERT.BORTUZZO,20142015,STL,183.36666666666667,1,1,0,1,2,2,0,0,0,19,39,41,12,2,7,180,142,179,131,4,7,0,30213034.07
ROBYN.REGEHR,20142015,L.A,1361.1666666666665,3,3,5,8,11,6,0,0,0,63,129,203,36,6,21,1097,1352,1003,953,41,34,0,30213114.235
ROCCO.GRIMALDI,20142015,FLA,88.26666666666667,1,0,0,0,1,1,6,14,8,18,26,7,4,4,3,85,62,70,54,0,1,0.42857142857142855,30213028.93
ROMAN.JOSI,20142015,NSH,2334.0833333333335,16,22,15,37,53,38,0,1,1,222,426,65,148,19,13,2280,2282,1666,1674,71,51,0,30213195.165
ROMAN.POLAK,20142015,TOR,1180.95,5,1,2,3,8,6,1,1,0,61,129,225,36,10,19,897,1373,828,1004,27,52,1,30213132.439999998
RON.HAINSEY,20142015,CAR,1708.8333333333335,2,5,3,8,10,7,1,1,0,83,NA,110,NA,4,8,NA,NA,NA,NA,42,55,1,NA
RONALDS.KENINS,20142015,VAN,422.3833333333333,5,5,2,7,12,10,0,1,1,43,83,81,25,0,6,359,390,354,387,17,17,0,30213066.049999997
RYAN.BOURQUE,20142015,NYR,11.816666666666666,0,0,0,0,0,0,0,0,0,1,3,0,0,0,0,13,5,12,4,0,1,0,15106511.3
RYAN.CALLAHAN,20142015,T.B,1787.6833333333334,26,25,10,35,61,51,18,39,21,247,388,267,76,29,27,1832,1345,1316,1188,62,43,0.46153846153846156,30213164.46
RYAN.CARTER,20142015,MIN,539.9333333333334,3,5,5,10,13,8,29,70,41,47,89,78,16,21,22,376,518,350,390,14,12,0.4142857142857143,30213071.845
RYAN.CRAIG,20142015,CBJ,14.55,0,0,0,0,0,0,0,0,0,2,3,2,0,0,0,12,21,12,21,1,1,0,15106513.75
RYAN.ELLIS,20142015,NSH,1258.4,9,13,7,20,29,22,0,0,0,130,244,60,67,15,9,1304,975,996,834,50,35,0,30213102.225
RYAN.GARBUTT,20142015,DAL,908.9166666666667,8,11,6,17,25,19,16,25,9,143,264,81,50,19,24,844,963,769,772,32,44,0.64,30213110.880000003
RYAN.GETZLAF,20142015,ANA,1905.7166666666667,27,39,20,59,86,66,807,1592,785,238,452,133,98,16,30,1996,1650,1303,1200,70,54,0.5069095477386935,30213201.740000002
RYAN.HAMILTON,20142015,EDM,211.35,1,1,0,1,2,2,1,4,3,12,20,27,4,0,3,159,203,133,190,3,9,0.25,30213045.740000002
RYAN.HARTMAN,20142015,CHI,41.43333333333333,0,0,0,0,0,0,0,0,0,8,11,11,1,1,1,43,34,43,34,0,1,0,15106514.61
RYAN.JOHANSEN,20142015,CBJ,1599.1833333333334,26,24,21,45,71,50,851,1638,787,202,354,84,83,15,19,1557,1481,1033,1139,51,56,0.5195360195360196,30213198.515
RYAN.KESLER,20142015,ANA,1908.15,27,21,11,32,59,48,1153,2042,889,238,453,222,109,32,38,1925,1822,1287,1250,50,51,0.5646425073457395,30213203.915
RYAN.MALONE,20142015,NYR,60.16666666666667,0,0,0,0,0,0,1,1,0,6,8,14,0,2,2,66,38,49,36,0,4,1,30213026.060000002
RYAN.MCDONAGH,20142015,NYR,2089.2,11,11,18,29,40,22,0,0,0,181,354,113,106,14,17,1944,1940,1416,1472,71,59,0,30213172.79
RYAN.MURPHY,20142015,CAR,676.75,4,8,1,9,13,12,0,0,0,61,NA,20,NA,4,4,NA,NA,NA,NA,17,24,0,NA
RYAN.MURRAY,20142015,CBJ,226.9,1,1,1,2,3,2,0,0,0,8,17,5,5,0,4,186,193,154,156,7,7,0,30213038.725
RYAN.NUGENT-HOPKINS,20142015,EDM,1568.6833333333334,24,15,17,32,56,39,620,1355,735,189,359,92,108,26,11,1580,1376,1077,1077,53,60,0.4575645756457565,30213174.285
RYAN.O'REILLY,20142015,COL,1615.8833333333332,17,25,13,38,55,42,710,1329,619,171,273,38,53,14,6,1484,1526,975,1129,50,44,0.5342362678705794,30213187.715
RYAN.REAVES,20142015,STL,742.3999999999999,7,3,3,6,13,10,0,0,0,57,100,294,20,22,33,531,614,527,608,17,20,0,30213096.595
RYAN.SPOONER,20142015,BOS,421.6,8,4,6,10,18,12,99,219,120,73,113,17,21,2,1,550,356,321,320,12,12,0.4520547945205479,30213066.58
RYAN.STANTON,20142015,VAN,864.2833333333333,3,4,2,6,9,7,0,0,0,59,108,93,27,5,16,680,918,624,762,31,25,0,30213106.75
RYAN.STROME,20142015,NYI,1370.0666666666666,19,26,8,34,53,45,154,333,179,190,307,108,69,12,23,1538,1191,1142,1012,64,45,0.4624624624624625,30213145.93
RYAN.SUTER,20142015,MIN,2504.45,2,12,26,38,40,14,0,0,0,163,399,84,150,11,22,2466,2158,1746,1681,68,68,0,30213176.16
RYAN.WHITE,20142015,PHI,398.3666666666667,6,4,2,6,12,10,65,123,58,45,71,108,13,5,12,371,344,316,311,13,10,0.5284552845528455,30213062.35
RYAN.WILSON,20142015,COL,33.61666666666667,0,0,0,0,0,0,0,0,0,3,8,6,3,1,0,25,30,19,23,0,3,0,30213024.71
RYANE.CLOWE,20142015,N.J,203.73333333333335,1,2,1,3,4,3,0,1,1,15,26,21,8,1,2,176,157,126,147,6,5,0,30213039.134999998
SAM.BENNETT,20142015,CGY,170.23333333333335,3,1,1,2,5,4,9,22,13,21,39,15,10,4,4,152,147,125,140,6,9,0.4090909090909091,30213039.825000003
SAM.CARRICK,20142015,TOR,103.75,1,0,1,1,2,1,38,91,53,17,24,30,2,2,3,84,96,83,91,3,2,0.4175824175824176,30213035.615000002
SAM.GAGNER,20142015,ARI,1396.6,15,19,7,26,41,34,361,771,410,183,322,63,64,9,13,1584,1185,1133,1055,40,57,0.4682230869001297,30213158.055
SAM.REINHART,20142015,BUF,93.26666666666667,0,0,1,1,1,0,21,86,65,3,6,3,3,2,1,56,97,52,97,1,2,0.2441860465116279,30213037.285
SAMI.VATANEN,20142015,ANA,1777.4666666666667,15,9,22,31,46,24,1,2,1,156,308,94,91,19,23,1815,1550,1218,1189,59,52,0.5,30213146.03
SCOTT.GOMEZ,20142015,N.J,957.7666666666667,7,13,14,27,34,20,367,788,421,70,111,23,18,13,6,848,813,642,722,26,26,0.46573604060913704,30213127.11
SCOTT.HANNAN,20142015,S.J,946.1166666666666,2,3,2,5,7,5,0,0,0,53,96,32,27,3,NA,787,1012,735,797,29,29,0,NA
SCOTT.HARRINGTON,20142015,PIT,158,0,0,0,0,0,0,0,0,0,9,17,12,4,1,2,142,142,127,112,3,13,0,30213032.66
SCOTT.HARTNELL,20142015,CBJ,1331.8666666666668,28,21,11,32,60,49,7,14,7,204,308,160,51,21,42,1435,1076,1041,980,54,49,0.5,30213150.665
SCOTT.LAUGHTON,20142015,PHI,394.3,2,3,1,4,6,5,134,283,149,51,89,58,24,5,7,302,375,266,325,8,12,0.4734982332155477,30213066.035
SCOTT.MAYFIELD,20142015,NYI,24.833333333333336,0,0,0,0,0,0,0,0,0,1,2,9,1,0,0,18,32,18,32,0,1,0,30213026.3
SCOTT.WILSON,20142015,PIT,24.533333333333335,0,0,0,0,0,0,0,0,0,3,7,6,4,0,0,22,12,22,12,0,0,0,30213022.75
SCOTTIE.UPSHALL,20142015,FLA,798.9666666666667,8,4,3,7,15,12,33,64,31,93,163,128,38,19,14,650,732,578,559,16,24,0.515625,30213085.535
SEAN.BERGENHEIM,20142015,FLA,551.9333333333334,8,6,4,10,18,14,2,5,3,84,146,49,23,9,13,527,417,483,385,22,18,0.4,30213064.92
SEAN.BERGENHEIM,20142015,MIN,213.10000000000002,1,0,0,0,1,1,0,1,1,25,46,28,11,4,3,167,184,166,182,4,10,0,30213041.740000002
SEAN.COLLINS,20142015,CBJ,82.66666666666666,0,0,2,2,2,0,2,5,3,4,7,18,2,1,1,58,69,58,69,3,3,0.4,30213029.84
SEAN.COUTURIER,20142015,PHI,1507.8333333333335,15,13,9,22,37,28,643,1330,687,148,271,72,70,20,11,1244,1430,936,1001,41,34,0.48345864661654137,30213164.695
SEAN.MONAHAN,20142015,CGY,1807.0166666666667,34,23,11,34,68,57,995,2055,1060,215,388,44,85,14,7,1788,1769,1179,1451,47,49,0.48418491484184917,30213253.665
SERGEI.GONCHAR,20142015,DAL,39.083333333333336,0,1,0,1,1,1,0,0,0,1,2,3,0,0,1,47,43,40,43,2,3,0,15106516.15
SERGEI.GONCHAR,20142015,MTL,809.95,1,5,6,11,12,6,1,1,0,45,121,42,47,1,8,750,751,563,657,20,13,1,30213090.200000003
SETH.GRIFFITH,20142015,BOS,403.3,6,1,3,4,10,7,3,9,6,33,69,14,16,1,3,390,331,304,311,10,12,0.3333333333333333,30213057.405
SETH.HELGESON,20142015,N.J,296.20000000000005,0,1,1,2,2,1,0,0,0,11,28,42,10,3,6,193,267,184,235,10,7,0,30213047.655
SETH.JONES,20142015,NSH,1798.6166666666668,8,11,12,23,31,19,0,0,0,131,284,87,104,13,13,1718,1484,1308,1161,49,49,0,30213129.48
SHANE.DOAN,20142015,ARI,1491.7666666666669,14,16,6,22,36,30,3,11,8,189,315,189,59,18,26,1568,1358,1109,1130,36,53,0.2727272727272727,30213155.25
SHANE.O'BRIEN,20142015,FLA,121.31666666666666,0,1,0,1,1,1,0,0,0,4,5,36,1,1,1,84,118,79,110,3,7,0,30213035.36
SHANE.PRINCE,20142015,OTT,20.95,0,0,1,1,1,0,0,0,0,2,6,2,2,0,0,22,13,22,13,1,0,0,15106511.825
SHAWN.HORCOFF,20142015,DAL,989.4833333333333,11,10,8,18,29,21,237,472,235,82,150,80,34,3,12,962,828,763,688,31,23,0.5021186440677966,30213106.91
SHAWN.MATTHIAS,20142015,VAN,1095.4333333333334,19,8,2,10,29,27,85,191,106,136,225,76,34,14,9,892,1046,804,884,29,41,0.44502617801047123,30213136.04
SHAWN.THORNTON,20142015,FLA,440.8666666666667,1,1,3,4,5,2,3,12,9,53,85,93,17,9,16,357,365,352,362,7,20,0.25,30213062.634999998
SHAYNE.GOSTISBEHERE,20142015,PHI,25.116666666666667,0,0,0,0,0,0,0,0,0,2,6,0,1,0,0,18,29,15,28,0,2,0,15106514.65
SHEA.WEBER,20142015,NSH,2108.416666666667,15,10,19,29,44,25,0,0,0,239,485,173,143,13,30,2086,2048,1520,1497,63,42,0,30213174.155
SIDNEY.CROSBY,20142015,PIT,1637.1999999999998,30,32,26,58,88,62,858,1704,846,246,400,71,69,30,18,1917,1198,1261,994,57,43,0.5035211267605634,30213179.22
SIMON.DESPRES,20142015,ANA,630.8666666666667,2,7,3,10,12,9,0,0,0,44,84,91,25,3,14,555,571,502,465,21,19,0,30213070.055
SIMON.DESPRES,20142015,PIT,966.6166666666667,2,7,6,13,15,9,0,1,1,76,167,184,59,17,27,853,784,744,691,35,30,0,30213088.62
SIMON.GAGNE,20142015,BOS,260.06666666666666,3,0,1,1,4,3,1,9,8,27,46,20,15,3,2,208,247,206,222,8,8,0.1111111111111111,30213046.295
SLATER.KOEKKOEK,20142015,T.B,49.75,0,0,0,0,0,0,0,0,0,6,8,2,1,0,1,44,44,42,41,1,1,0,15106515.45
SLAVA.VOYNOV,20142015,L.A,139.11666666666667,0,0,1,1,1,0,0,0,0,5,19,11,8,0,1,116,148,86,106,2,2,0,30213033.075
STANISLAV.GALIEV,20142015,WSH,18.766666666666666,1,0,0,0,1,1,0,0,0,2,4,3,1,0,0,25,12,25,12,1,0,0,15106512.3
STEFAN.ELLIOTT,20142015,COL,69.66666666666666,0,0,0,0,0,0,0,0,0,10,19,2,6,0,1,61,58,43,49,1,3,0,30213027.3
STEFAN.MATTEAU,20142015,N.J,83.1,1,0,0,0,1,1,0,0,0,8,13,17,3,1,3,49,68,49,67,1,2,0,30213031.060000002
STEFAN.NOESEN,20142015,ANA,6.9,0,0,0,0,0,0,0,0,0,0,1,0,0,1,0,4,5,4,5,0,0,0,15106511.81
STEPHANE.ROBIDAS,20142015,TOR,887.6166666666666,1,1,4,5,6,2,0,0,0,34,88,141,31,4,17,633,965,585,746,27,20,0,30213102.29
STEPHANE.VEILLEUX,20142015,MIN,92.33333333333334,1,0,1,1,2,1,0,1,1,9,12,9,2,3,4,67,87,64,61,2,3,0,30213029.755000003
STEPHEN.GIONTA,20142015,N.J,804.2833333333333,5,6,2,8,13,11,159,394,235,84,127,92,21,14,5,493,756,457,499,17,16,0.4035532994923858,30213091
STEPHEN.WEISS,20142015,DET,610.7833333333333,9,7,9,16,25,16,10,21,11,53,92,19,21,3,11,617,429,419,382,19,16,0.47619047619047616,30213068.455
STEVE.BERNIER,20142015,N.J,866.75,16,10,6,16,32,26,1,2,1,107,160,123,28,16,7,746,715,595,662,30,23,0.5,30213107.1
STEVE.DOWNIE,20142015,PIT,948.5333333333333,14,10,6,16,30,24,4,8,4,108,164,118,36,34,63,876,741,693,698,29,21,0.5,30213113.9
STEVE.OLEKSY,20142015,WSH,12.183333333333334,0,0,0,0,0,0,0,0,0,1,2,2,1,0,0,9,11,9,11,0,1,0,15106512.35
STEVE.OTT,20142015,STL,974.95,3,4,5,9,12,7,181,322,141,55,115,196,34,27,39,659,870,632,691,16,25,0.562111801242236,30213105.835
STEVEN.KAMPFER,20142015,FLA,429.91666666666663,2,1,1,2,4,3,0,0,0,28,66,49,20,3,6,357,404,319,336,8,13,0,30213057.104999997
STEVEN.PINIZZOTTO,20142015,EDM,142.71666666666667,2,1,1,2,4,3,0,0,0,15,17,32,1,6,9,113,132,110,125,5,5,0,30213039.035
STEVEN.STAMKOS,20142015,T.B,2070.55,50,27,13,40,90,77,584,1169,585,333,635,153,156,39,32,2133,1562,1476,1333,74,62,0.49957228400342174,30213210.225
STU.BICKEL,20142015,MIN,48.95,0,1,0,1,1,1,0,0,0,3,5,10,1,3,7,28,50,28,50,2,1,0,30213029.93
STUART.PERCY,20142015,TOR,162.7,0,3,0,3,3,3,0,0,0,13,24,14,7,1,1,139,163,103,131,4,8,0,30213037.810000002
SVEN.ANDRIGHETTO,20142015,MTL,112.96666666666667,2,1,0,1,3,3,3,15,12,12,21,5,8,0,0,89,88,64,80,5,3,0.2,30213032.47
SVEN.BAERTSCHI,20142015,CGY,138.16666666666666,0,4,0,4,4,4,0,0,0,11,18,8,4,2,3,108,133,101,132,5,8,0,30213039.119999997
SVEN.BAERTSCHI,20142015,VAN,55.416666666666664,2,0,0,0,2,2,0,0,0,4,10,1,4,1,2,47,60,46,58,3,3,0,30213029.76
T.J..OSHIE,20142015,STL,1470.8166666666666,20,23,14,37,57,43,3,14,11,178,315,104,63,26,22,1515,1235,1098,1017,57,45,0.21428571428571427,30213142.83
TANNER.GLASS,20142015,NYR,853.5833333333333,1,3,3,6,7,4,7,22,15,65,112,283,28,20,30,612,885,585,750,17,33,0.3181818181818182,30213110.205
TANNER.PEARSON,20142015,L.A,558.2666666666667,12,2,2,4,16,14,5,8,3,68,131,46,25,6,7,648,450,504,395,23,11,0.625,30213063.61
TAYLOR.BECK,20142015,NSH,804.2666666666667,8,6,0,6,14,14,5,10,5,84,153,75,34,13,9,621,716,545,636,17,18,0.5,30213097.78
TAYLOR.CHORNEY,20142015,PIT,168.08333333333334,0,0,0,0,0,0,0,0,0,7,21,8,4,2,1,151,126,121,116,0,1,0,30213033.77
TAYLOR.FEDUN,20142015,S.J,118.91666666666666,0,1,3,4,4,1,0,0,0,12,26,0,9,4,2,121,97,98,93,2,3,0,30213031.615000002
TAYLOR.HALL,20142015,EDM,1017.5166666666667,14,16,6,22,36,30,45,97,52,158,312,67,96,14,20,1111,864,791,774,38,34,0.4639175257731959,30213111.189999998
TEDDY.PURCELL,20142015,EDM,1407.1666666666665,12,16,6,22,34,28,4,7,3,146,270,24,73,8,6,1393,1250,1008,1040,31,57,0.5714285714285714,30213138.54
TEEMU.PULKKINEN,20142015,DET,355.75,5,1,2,3,8,6,0,0,0,67,135,3,38,1,5,434,229,276,214,11,5,0,30213041.759999998
TEUVO.TERAVAINEN,20142015,CHI,677.1,8,8,2,10,18,16,30,72,42,92,157,15,43,3,1,676,551,591,528,19,14,0.4166666666666667,30213079.58
THOMAS.HICKEY,20142015,NYI,1682.9833333333336,2,11,9,20,22,13,1,2,1,96,207,133,75,13,14,1545,1646,1377,1284,53,67,0.5,30213142.245
THOMAS.VANEK,20142015,MIN,1438.6,21,27,8,35,56,48,10,22,12,190,317,41,65,6,17,1474,1169,945,1045,42,49,0.45454545454545453,30213158.71
TIM.ERIXON,20142015,CBJ,322.2833333333333,1,1,3,4,5,2,0,0,0,20,51,14,24,1,3,368,262,251,250,8,10,0,30213045.585
TIM.ERIXON,20142015,CHI,79.86666666666667,0,0,0,0,0,0,0,0,0,6,13,0,6,0,2,82,60,81,60,4,4,0,30213026.55
TIM.ERIXON,20142015,TOR,236.98333333333335,1,0,0,0,1,1,0,0,0,10,25,20,7,1,3,178,264,143,193,3,6,0,30213044.46
TIM.GLEASON,20142015,CAR,915.7666666666667,1,2,2,4,5,3,0,0,0,43,84,133,22,19,15,717,904,683,710,21,37,0,30213094.939999998
TIM.GLEASON,20142015,WSH,443.55,0,2,1,3,3,2,0,0,0,17,43,58,17,8,5,392,462,384,422,12,10,0,30213065.105
TIM.JACKMAN,20142015,ANA,519.8166666666666,5,0,2,2,7,5,10,14,4,58,108,127,19,22,NA,452,452,442,437,12,17,0.7142857142857143,NA
TIM.SCHALLER,20142015,BUF,204.28333333333333,1,1,0,1,2,2,74,186,112,19,26,44,4,1,1,112,229,108,196,3,7,0.3978494623655914,30213052.67
TIM.SESTITO,20142015,N.J,148.31666666666666,0,2,0,2,2,2,48,106,58,10,16,22,3,4,8,75,132,69,87,4,5,0.4528301886792453,30213036.310000002
TJ.BRENNAN,20142015,TOR,100.86666666666667,0,0,1,1,1,0,0,0,0,11,23,2,9,2,3,126,85,81,71,1,6,0,30213028.695
TJ.BRODIE,20142015,CGY,2340.116666666667,12,16,17,33,45,28,0,0,0,146,329,34,121,28,15,2019,2262,1508,1786,62,60,0,30213215.854999997
TJ.GALIARDI,20142015,WPG,397.5,1,0,0,0,1,1,2,11,9,35,55,38,9,6,1,271,442,246,285,5,12,0.18181818181818182,30213053.939999998
TOBIAS.ENSTROM,20142015,WPG,1497.25,4,11,9,20,24,15,0,0,0,61,138,27,45,10,18,1388,1187,961,927,53,40,0,30213114.175
TOBIAS.RIEDER,20142015,ARI,1216.5666666666666,13,2,6,8,21,15,1,5,4,189,318,123,63,18,7,1179,1204,926,947,27,38,0.2,30213126.27
TOM.GILBERT,20142015,MTL,1627.25,6,4,6,10,16,10,0,0,0,83,179,69,60,8,16,1311,1683,1129,1305,49,41,0,30213158.93
TOM.SESTITO,20142015,VAN,18.71666666666667,0,0,1,1,1,0,0,0,0,1,2,10,0,4,2,11,28,11,28,1,0,0,30213026.465
TOM.WILSON,20142015,WSH,832.5,4,7,6,13,17,11,2,11,9,86,164,242,42,61,63,795,726,765,721,23,25,0.18181818181818182,30213104.54
TOMAS.FLEISCHMANN,20142015,ANA,262.2166666666667,1,4,2,6,7,5,9,21,12,30,57,13,11,2,2,296,189,233,176,11,11,0.42857142857142855,30213039.33
TOMAS.FLEISCHMANN,20142015,FLA,772.0166666666667,7,12,2,14,21,19,2,9,7,107,187,53,46,11,4,654,673,542,542,31,18,0.2222222222222222,30213083.189999998
TOMAS.HERTL,20142015,S.J,1193.3000000000002,13,6,12,18,31,19,38,83,45,145,289,106,78,15,8,1332,1021,1114,938,39,40,0.4578313253012048,30213113.72
TOMAS.JURCO,20142015,DET,784.8666666666667,4,9,7,16,20,13,0,2,2,96,177,101,36,20,9,755,527,615,505,25,18,0,30213073.075
TOMAS.KOPECKY,20142015,FLA,825.6333333333333,2,5,1,6,8,7,3,4,1,105,183,88,40,16,14,588,810,531,576,10,27,0.75,30213086.605
TOMAS.PLEKANEC,20142015,MTL,1815.4166666666665,27,20,16,36,63,47,919,1833,914,285,454,64,90,19,20,1864,1781,1310,1330,49,45,0.5013638843426077,30213220.700000003
TOMAS.TATAR,20142015,DET,1440.5666666666666,32,17,11,28,60,49,6,13,7,229,441,98,106,22,14,1612,877,1148,793,44,38,0.46153846153846156,30213108.185
TOMAS.VINCOUR,20142015,COL,50.21666666666667,0,1,0,1,1,1,0,0,0,2,6,5,1,1,1,42,47,41,46,1,2,0,30213027.86
TOMMY.WINGELS,20142015,S.J,1235.3166666666666,15,14,7,21,36,29,70,153,83,158,264,262,41,33,17,1198,1238,924,979,30,39,0.45751633986928103,30213145.455
TOREY.KRUG,20142015,BOS,1528.3333333333335,12,14,13,27,39,26,0,0,0,205,421,75,128,11,7,1712,1189,1183,1058,52,38,0,30213123.535
TORREY.MITCHELL,20142015,BUF,782.1166666666667,6,4,3,7,13,10,311,660,349,45,80,46,23,9,12,476,921,440,666,22,24,0.4712121212121212,30213118.755
TORREY.MITCHELL,20142015,MTL,290.95000000000005,1,4,1,5,6,5,156,293,137,19,33,19,5,2,6,187,300,179,232,8,8,0.5324232081911263,30213056.535
TRAVIS.HAMONIC,20142015,NYI,1546.7333333333333,5,14,14,28,33,19,0,0,0,132,306,212,119,12,30,1545,1569,1273,1233,49,41,0,30213142.07
TRAVIS.MOEN,20142015,DAL,307.8333333333333,3,4,2,6,9,7,0,2,2,25,43,46,6,4,4,241,286,240,275,15,15,0,30213055.04
TRAVIS.MOEN,20142015,MTL,104.96666666666667,0,0,0,0,0,0,0,2,2,9,12,16,3,1,2,46,135,45,86,0,0,0,30213033.56
TRAVIS.MORIN,20142015,DAL,72.58333333333334,0,0,0,0,0,0,28,60,32,10,21,3,6,0,0,89,47,77,44,1,0,0.4666666666666667,30213026.02
TRAVIS.ZAJAC,20142015,N.J,1409.75,11,9,5,14,25,20,641,1200,559,112,202,69,54,12,13,1050,1166,771,862,29,33,0.5341666666666667,30213143.035
TREVOR.DALEY,20142015,DAL,1555.5166666666667,16,14,8,22,38,30,0,0,0,113,244,29,70,11,17,1459,1685,1012,1201,48,53,0,30213162.16
TREVOR.LEWIS,20142015,L.A,1029.8,9,8,8,16,25,17,76,177,101,143,221,192,38,13,7,910,873,850,650,29,21,0.4293785310734463,30213091.37
TREVOR.SMITH,20142015,TOR,597.45,2,2,1,3,5,4,293,561,268,46,85,75,20,3,6,434,631,407,478,13,22,0.5222816399286988,30213085.175
TREVOR.VAN RIEMSDYK,20142015,CHI,271.8,0,1,0,1,1,1,0,0,0,22,45,7,18,2,1,277,205,264,190,6,6,0,30213036.020000003
TROY.BODIE,20142015,TOR,23.083333333333332,0,0,0,0,0,0,0,0,0,1,2,4,1,1,1,25,24,25,24,0,0,0,30213024.91
TROY.BROUWER,20142015,WSH,1688.6166666666668,21,11,14,25,46,32,276,490,214,166,312,239,69,14,26,1723,1491,1031,1006,45,40,0.563265306122449,30213146.83
TUOMO.RUUTU,20142015,N.J,836.5999999999999,7,2,4,6,13,9,4,9,5,74,122,174,20,14,12,618,672,592,619,15,15,0.4444444444444444,30213092.65
TY.RATTIE,20142015,STL,100.1,0,1,1,2,2,1,0,0,0,8,18,15,6,0,1,85,70,73,67,2,2,0,30213028.875
TYE.MCGINN,20142015,ARI,173.98333333333332,1,1,0,1,2,2,0,1,1,25,46,32,14,7,5,166,175,155,168,3,3,0,30213040.770000003
TYE.MCGINN,20142015,S.J,341.25,1,2,2,4,5,3,1,1,0,35,73,39,22,4,4,287,326,282,322,8,9,1,30213056.53
TYLER.BOZAK,20142015,TOR,1570.1,23,16,10,26,49,39,944,1775,831,152,245,83,42,19,14,1686,1545,1047,1238,38,62,0.5318309859154929,30213211.5
TYLER.ENNIS,20142015,BUF,1490.95,20,21,5,26,46,41,67,183,116,185,NA,87,NA,32,11,NA,NA,NA,NA,34,45,0.366120218579235,NA
TYLER.GAUDET,20142015,ARI,19.15,0,0,0,0,0,0,9,17,8,1,1,2,0,0,0,9,29,8,28,0,1,0.5294117647058824,30213026.66
TYLER.GRAOVAC,20142015,MIN,27.666666666666664,0,0,0,0,0,0,6,22,16,4,6,0,1,2,0,18,24,18,24,0,0,0.2727272727272727,30213026.009999998
TYLER.JOHNSON,20142015,T.B,1808.7,42,39,14,53,95,81,713,1457,744,263,442,108,100,37,19,1756,1573,1299,1115,82,45,0.48936170212765956,30213195.84
TYLER.KENNEDY,20142015,NYI,179.66666666666669,2,3,0,3,5,5,5,10,5,38,58,17,11,2,2,194,169,185,161,5,10,0.5,30213040.47
TYLER.KENNEDY,20142015,S.J,276.2833333333333,4,3,2,5,9,7,8,18,10,48,95,37,29,2,3,313,263,307,261,11,11,0.4444444444444444,30213048.189999998
TYLER.MYERS,20142015,BUF,1177.7666666666667,4,4,4,8,12,8,0,0,0,72,127,46,32,10,25,763,1347,501,983,23,35,0,30213149.4
TYLER.MYERS,20142015,WPG,669.1333333333333,4,8,4,12,16,12,0,0,0,58,113,28,36,6,9,584,571,412,425,24,17,0,30213068.46
TYLER.PITLICK,20142015,EDM,211.53333333333333,2,0,0,0,2,2,5,9,4,18,40,55,9,3,2,195,186,186,183,6,9,0.5555555555555556,30213041.18
TYLER.SEGUIN,20142015,DAL,1388.1,37,33,7,40,77,70,275,510,235,280,529,63,139,16,10,1729,1121,1107,941,58,46,0.5392156862745098,30213147.985
TYLER.TOFFOLI,20142015,L.A,1108.7666666666667,23,17,9,26,49,40,4,9,5,200,345,86,75,14,13,1241,886,965,709,51,28,0.4444444444444444,30213100.125
TYLER.WOTHERSPOON,20142015,CGY,60.16666666666667,0,0,0,0,0,0,0,0,0,3,9,2,5,0,0,47,57,46,48,1,4,0,30213026.65
TYSON.BARRIE,20142015,COL,1709.2333333333333,12,18,20,38,50,30,0,0,0,139,312,80,110,9,13,1650,1547,1112,1341,71,57,0,30213169.689999998
TYSON.STRACHAN,20142015,BUF,873.2833333333333,0,1,1,2,2,1,0,0,0,38,74,67,20,8,12,524,1074,497,828,14,42,0,30213121.155
VALERI.NICHUSHKIN,20142015,DAL,110.18333333333334,0,0,1,1,1,0,0,0,0,6,19,7,7,1,1,92,96,85,87,3,4,0,30213030.335
VALTTERI.FILPPULA,20142015,T.B,2058.9333333333334,16,22,22,44,60,38,831,1592,761,122,213,40,56,28,13,1913,1700,1302,1289,53,62,0.5219849246231156,30213197.42
VERNON.FIDDLER,20142015,DAL,1050.1166666666668,13,12,4,16,29,25,569,1096,527,132,227,43,45,27,14,871,1127,765,775,32,41,0.5191605839416058,30213134.58
VICTOR.BARTLEY,20142015,NSH,542.4833333333333,0,6,3,9,9,6,0,0,0,31,72,87,24,2,11,493,542,480,493,22,19,0,30213072.295
VICTOR.HEDMAN,20142015,T.B,1961.3166666666666,11,20,21,41,52,31,0,0,0,179,365,87,124,15,19,1877,1647,1372,1138,73,48,0,30213127.275
VICTOR.RASK,20142015,CAR,1306.65,11,10,12,22,33,21,468,916,448,172,296,42,69,14,9,1485,1015,1005,864,33,39,0.5109170305676856,30213128.46
VIKTOR.ARVIDSSON,20142015,NSH,61.53333333333333,0,0,0,0,0,0,0,0,0,9,18,3,4,1,0,51,55,51,55,1,1,0,30213027.91
VIKTOR.STALBERG,20142015,NSH,381.95000000000005,3,7,3,10,13,10,1,1,0,45,73,85,15,10,9,348,360,334,340,16,15,1,30213062.015
VINCENT.LECAVALIER,20142015,PHI,720.9000000000001,8,9,3,12,20,17,95,191,96,103,187,40,43,6,11,698,611,488,566,22,27,0.4973821989528796,30213094.735
VINCENT.TROCHECK,20142015,FLA,700.2666666666667,7,12,3,15,22,19,233,480,247,89,147,93,25,12,10,707,568,601,524,31,22,0.48541666666666666,30213090.465
VLADIMIR.TARASENKO,20142015,STL,1460.8166666666666,43,18,19,37,80,61,0,3,3,278,563,36,162,25,16,1671,1082,1185,963,66,38,0,30213131.625
VLADISLAV.NAMESTNIKOV,20142015,T.B,610.0999999999999,9,4,4,8,17,13,82,181,99,49,77,51,12,13,7,476,503,415,451,19,19,0.4530386740331492,30213081.31
WAYNE.SIMMONDS,20142015,PHI,1260.5833333333335,28,11,11,22,50,39,4,5,1,188,323,168,67,22,23,1470,962,867,850,32,31,0.8,30213131.355
WILL.ACTON,20142015,EDM,32.13333333333333,0,0,0,0,0,0,4,8,4,2,3,3,1,1,1,22,33,21,26,1,3,0.5,15106514.22
WILLIAM.KARLSSON,20142015,ANA,218.55,2,1,0,1,3,3,80,164,84,24,47,14,8,3,0,224,167,161,151,7,6,0.4878048780487805,30213041.43
WILLIAM.KARLSSON,20142015,CBJ,38.31666666666666,1,1,0,1,2,2,13,33,20,5,5,4,0,1,0,22,40,22,40,3,1,0.3939393939393939,30213029.33
WILLIE.MITCHELL,20142015,FLA,1430.8,3,2,3,5,8,5,0,0,0,78,183,99,74,7,11,1105,1467,1020,1007,44,42,0,30213113.895
XAVIER.OUELLET,20142015,DET,344.2,2,1,0,1,3,3,0,0,0,27,66,11,23,1,1,309,246,290,212,14,8,0,30213037.71
YANNICK.WEBER,20142015,VAN,1232.2333333333333,10,5,4,9,19,15,0,0,0,130,276,71,91,5,17,1212,1071,959,921,40,43,0,30213112.2
ZAC.DALPE,20142015,BUF,194.81666666666666,1,0,2,2,3,1,20,33,13,29,43,15,8,2,2,144,212,140,210,4,14,0.6060606060606061,30213048.270000003
ZAC.RINALDO,20142015,PHI,517.25,1,4,1,5,6,5,1,3,2,45,76,216,13,19,28,385,487,373,464,11,19,0.3333333333333333,30213079.555
ZACH.BOGOSIAN,20142015,BUF,559.7,0,1,5,6,6,1,0,0,0,51,96,83,31,6,16,426,619,300,444,15,20,0,30213073.134999998
ZACH.BOGOSIAN,20142015,WPG,908.9166666666667,3,5,5,10,13,8,0,0,0,74,151,106,51,11,19,787,783,623,608,27,21,0,30213082.735
ZACH.BOYCHUK,20142015,CAR,329.4,3,2,1,3,6,5,0,0,0,35,57,39,12,1,2,300,309,283,298,10,11,0,30213055.085
ZACH.PARISE,20142015,MIN,1607.25,37,19,15,34,71,56,2,13,11,279,446,108,74,22,17,1857,1340,1250,1124,56,35,0.15384615384615385,30213163.825
ZACH.REDMOND,20142015,COL,1011.5999999999999,5,9,5,14,19,14,0,0,0,93,177,59,58,5,12,922,955,697,855,34,33,0,30213117.425
ZACH.SILL,20142015,PIT,348.3666666666667,1,2,0,2,3,3,0,1,1,26,46,114,8,11,12,231,311,219,280,5,8,0,30213056.66
ZACH.SILL,20142015,TOR,179.75,0,1,0,1,1,1,46,92,46,17,32,59,8,8,6,118,174,108,120,2,4,0.5,30213037.82
ZACH.TROTMAN,20142015,BOS,443.01666666666665,1,0,4,4,5,1,0,0,0,46,109,44,39,0,0,445,372,377,335,14,14,0,30213049.25
ZACK.KASSIAN,20142015,VAN,529.9666666666667,10,4,2,6,16,14,0,6,6,55,92,88,21,13,23,493,461,442,437,23,26,0,30213075.33
ZACK.SMITH,20142015,OTT,474.8833333333333,2,0,1,1,3,2,117,260,143,41,71,81,17,11,9,352,443,321,362,3,13,0.45,30213068.715
ZBYNEK.MICHALEK,20142015,ARI,1117.6,2,2,4,6,8,4,0,0,0,67,151,73,56,5,6,888,1130,808,748,31,39,0,30213088.35
ZBYNEK.MICHALEK,20142015,STL,392.25,2,2,0,2,4,4,1,1,0,23,53,16,21,3,6,332,349,310,283,9,13,1,30213049.52
ZDENO.CHARA,20142015,BOS,1470.9166666666665,8,5,6,11,19,13,1,1,0,138,254,125,76,10,21,1417,1358,1109,938,35,39,1,30213110.04
ZEMGUS.GIRGENSONS,20142015,BUF,1163.85,15,5,9,14,29,20,440,999,559,115,NA,127,NA,22,11,NA,NA,NA,NA,25,40,0.44044044044044045,NA
AARON.EKBLAD,20152016,FLA,1844.5333333333333,15,8,13,21,36,23,0,0,0,196,355,101,95,10,19,1686,1361,1204,1149,59,45,0,30228141.675
AARON.NESS,20152016,WSH,99.1,0,0,2,2,2,0,0,0,0,8,18,4,5,1,1,96,87,96,86,6,2,0,30228031.16
ADAM.CLENDENING,20152016,EDM,310.9,1,1,4,5,6,2,0,0,0,32,62,15,15,2,5,297,316,256,300,13,9,0,30228055.92
ADAM.CLENDENING,20152016,PIT,118.18333333333334,0,0,1,1,1,0,0,0,0,11,21,4,8,2,5,105,87,98,85,5,2,0,30228031.295
ADAM.CRACKNELL,20152016,EDM,90.41666666666666,0,0,0,0,0,0,4,13,9,13,19,30,3,2,3,84,84,78,75,0,2,0.3076923076923077,30228032.43
ADAM.CRACKNELL,20152016,VAN,545.6,5,4,1,5,10,9,152,382,230,55,101,94,25,10,7,406,520,394,459,11,12,0.39790575916230364,30228087.405
ADAM.HENRIQUE,20152016,N.J,1585.4166666666667,30,7,13,20,50,37,616,1379,763,149,237,66,43,15,10,1166,1379,738,881,46,37,0.4467005076142132,30228172.815
ADAM.LARSSON,20152016,N.J,1846.1,3,6,8,14,17,9,0,0,0,65,154,163,51,11,27,1041,1736,950,1171,42,33,0,30228151.61
ADAM.LOWRY,20152016,WPG,1037.3666666666666,7,6,4,10,17,13,391,844,453,73,121,187,27,14,17,732,1097,685,777,24,33,0.46327014218009477,30228132.23
ADAM.MCQUAID,20152016,BOS,1154.5666666666666,1,3,3,6,7,4,0,0,0,42,107,142,48,19,33,923,1204,861,904,30,31,0,30228114.665
ADAM.PARDY,20152016,EDM,182.01666666666668,0,3,0,3,3,3,0,0,0,12,22,12,5,3,3,156,194,154,152,5,9,0,30228040.33
ADAM.PARDY,20152016,WPG,183.31666666666666,0,0,0,0,0,0,0,0,0,10,21,20,6,2,4,127,177,119,135,2,7,0,30228038.22
ADAM.PELECH,20152016,NYI,158.21666666666667,0,2,0,2,2,2,0,0,0,8,18,16,8,0,0,106,165,90,124,3,7,0,30228037.95
ALAN.QUINE,20152016,NYI,189.28333333333333,2,2,2,4,6,4,39,79,40,17,37,27,6,0,1,161,162,141,148,5,6,0.4936708860759494,30228042.759999998
ALEC.MARTINEZ,20152016,L.A,1661.4666666666667,10,13,8,21,31,23,0,0,0,124,313,163,116,9,20,1703,1572,1277,1150,44,34,0,30228132.69
ALEKSANDER.BARKOV,20152016,FLA,1437.8000000000002,30,19,12,31,61,49,648,1306,658,199,298,54,43,17,5,1299,1238,925,929,52,36,0.49617151607963245,30228172.490000002
ALES.HEMSKY,20152016,DAL,1182.7333333333333,14,19,10,29,43,33,2,7,5,196,331,30,84,10,11,1330,979,1064,883,43,41,0.2857142857142857,30228116.98
ALEX.BIEGA,20152016,VAN,854.8833333333333,0,3,3,6,6,3,0,0,0,61,116,124,40,8,11,681,859,655,747,26,33,0,30228100.055
ALEX.BURMISTROV,20152016,WPG,1309.9833333333333,7,6,7,13,20,13,205,512,307,102,204,125,51,22,16,995,1229,851,908,26,40,0.400390625,30228135.845
ALEX.BURROWS,20152016,VAN,1198.4166666666667,9,7,6,13,22,16,10,22,12,135,221,80,37,21,22,1063,1065,747,803,19,28,0.45454545454545453,30228120.060000002
ALEX.CHIASSON,20152016,OTT,1050.0833333333335,8,5,1,6,14,13,3,5,2,88,142,103,21,8,18,809,1049,631,806,25,23,0.6,30228122.125
ALEX.EDLER,20152016,VAN,1271.5333333333333,6,2,11,13,19,8,0,0,0,111,248,84,77,7,23,1123,1134,714,803,35,35,0,30228107.145
ALEX.FRIESEN,20152016,VAN,11.716666666666667,0,0,0,0,0,0,0,1,1,1,2,1,1,0,0,11,9,11,9,0,2,0,15114012.75
ALEX.GALCHENYUK,20152016,MTL,1333.2666666666667,30,16,10,26,56,46,359,749,390,201,360,62,79,18,10,1520,1093,1076,950,51,45,0.47930574098798395,30228151.39
ALEX.GOLIGOSKI,20152016,DAL,2256.25,9,16,16,32,41,25,0,0,0,149,343,123,131,13,21,2373,2141,1920,1607,84,76,0,30228163.83
ALEX.GRANT,20152016,ARI,66.16666666666666,0,0,0,0,0,0,0,0,0,4,10,7,5,1,2,54,69,48,58,1,2,0,30228029.91
ALEX.GRENIER,20152016,VAN,68.85,0,0,0,0,0,0,1,2,1,9,13,5,1,0,1,68,75,64,74,2,6,0.5,30228032.09
ALEX.KHOKHLACHEV,20152016,BOS,51.266666666666666,0,0,0,0,0,0,0,2,2,4,10,1,4,1,0,50,44,50,44,0,2,0,30228027.810000002
ALEX.KILLORN,20152016,T.B,1671.8333333333333,19,22,12,34,53,41,33,87,54,189,342,126,74,29,35,1707,1333,1280,1127,64,46,0.3793103448275862,30228152.009999998
ALEX.OVECHKIN,20152016,WSH,1860.25,55,11,17,28,83,66,0,0,0,460,918,284,260,23,25,2364,1417,1440,1239,66,38,0,30228161.755000003
ALEX.PETROVIC,20152016,FLA,1238.6,3,12,6,18,21,15,0,0,0,59,133,173,42,19,32,978,1145,903,920,51,33,0,30228119.990000002
ALEX.PIETRANGELO,20152016,STL,2496.3500000000004,9,21,14,35,44,30,0,0,0,218,407,71,120,22,14,2200,2426,1737,1721,67,53,0,30228199.369999997
ALEX.SEMIN,20152016,MTL,185.03333333333333,1,1,2,3,4,2,1,1,0,18,41,6,12,1,6,214,142,157,123,7,5,1,30228034.95
ALEX.STEEN,20152016,STL,1791.6999999999998,21,23,17,40,61,44,188,455,267,211,383,72,98,26,30,1701,1654,1151,1201,44,39,0.41318681318681316,30228180.705
ALEX.TANGUAY,20152016,ARI,272.8333333333333,4,4,5,9,13,8,2,2,0,22,38,8,10,3,4,266,242,178,221,13,4,1,30228051.884999998
ALEX.TANGUAY,20152016,COL,832.5,4,12,6,18,22,16,1,3,2,49,86,14,19,8,13,815,849,611,729,27,25,0.3333333333333333,30228110.32
ALEX.WENNBERG,20152016,CBJ,1094.3833333333332,8,23,8,31,39,31,400,922,522,97,170,32,32,17,1,1103,968,784,804,37,32,0.43383947939262474,30228141.17
ALEXEI.EMELIN,20152016,MTL,1475.85,0,3,9,12,12,3,0,0,0,71,195,256,82,10,27,1274,1415,1141,1066,34,47,0,30228119.475
ALEXEY.MARCHENKO,20152016,DET,1158.9,2,5,4,9,11,7,0,0,0,44,115,48,43,8,6,902,1131,856,829,30,34,0,30228102.23
ANDERS.LEE,20152016,NYI,1166.1666666666667,15,13,7,20,35,28,1,6,5,183,282,163,42,5,21,1335,937,925,868,29,29,0.16666666666666666,30228128.064999998
ANDRE.BENOIT,20152016,STL,27.166666666666664,0,0,0,0,0,0,0,0,0,0,1,1,0,0,0,12,28,12,28,1,0,0,30228027.450000003
ANDRE.BURAKOVSKY,20152016,WSH,1179.3166666666666,18,8,12,20,38,26,19,41,22,142,285,47,76,11,11,1225,1027,1096,986,46,44,0.4634146341463415,30228126.47
ANDREAS.ATHANASIOU,20152016,DET,377.01666666666665,10,2,3,5,15,12,53,129,76,63,98,22,16,17,2,342,351,323,308,16,15,0.4108527131782946,30228064.465
ANDREAS.MARTINSEN,20152016,COL,610.35,4,4,3,7,11,8,1,4,3,52,90,155,15,13,17,450,590,424,569,19,21,0.25,30228093.695
ANDREI.MARKOV,20152016,MTL,1954.5333333333333,5,23,16,39,44,28,0,0,0,117,287,57,112,10,14,1933,1762,1314,1285,55,53,0,30228151.4
ANDREJ.NESTRASIL,20152016,CAR,789.3000000000001,9,8,5,13,22,17,8,25,17,105,198,27,49,6,4,815,576,675,551,27,25,0.32,30228079.255000003
ANDREJ.SEKERA,20152016,EDM,1766.75,6,13,10,23,29,19,0,0,0,153,375,60,161,7,6,1691,1625,1252,1315,43,58,0,30228148.770000003
ANDREJ.SUSTR,20152016,T.B,1590.4333333333334,5,7,9,16,21,12,0,0,0,82,177,41,56,5,20,1256,1594,1188,1222,56,51,0,30228146.275
ANDREW.AGOZZINO,20152016,COL,77.05000000000001,0,0,2,2,2,0,24,45,21,3,11,8,6,0,0,62,75,59,73,1,2,0.5333333333333333,30228032.060000002
ANDREW.BODNARCHUK,20152016,CBJ,232.64999999999998,0,1,1,2,2,1,0,0,0,5,18,21,11,1,4,175,243,170,225,7,15,0,30228048.035
ANDREW.BODNARCHUK,20152016,COL,223.91666666666669,0,2,0,2,2,2,0,0,0,4,15,23,8,2,3,171,243,168,240,8,9,0,30228050.97
ANDREW.CAMPBELL,20152016,TOR,69.5,0,0,1,1,1,0,0,0,0,1,3,5,0,1,1,61,77,61,75,2,2,0,30228032.185000002
ANDREW.COGLIANO,20152016,ANA,1284.1833333333334,11,13,10,23,34,24,7,18,11,137,238,136,52,11,13,1102,1207,1006,933,36,39,0.3888888888888889,30228125.44
ANDREW.COPP,20152016,WPG,616.25,7,4,2,6,13,11,224,486,262,55,90,87,21,6,3,449,568,425,465,19,10,0.4609053497942387,30228087.87
ANDREW.DESJARDINS,20152016,CHI,1083.3,8,4,1,5,13,12,47,100,53,100,190,112,53,15,12,870,1098,806,804,15,28,0.47,30228111.105
ANDREW.FERENCE,20152016,EDM,78.35,0,0,0,0,0,0,0,0,0,4,11,10,5,0,3,61,76,59,65,2,6,0,30228030.4
ANDREW.LADD,20152016,CHI,452.06666666666666,9,2,3,5,14,11,1,4,3,66,109,65,27,6,7,467,400,324,334,10,14,0.25,30228064.525
ANDREW.LADD,20152016,WPG,1147.1333333333332,17,8,8,16,33,25,7,10,3,142,282,126,81,15,14,1188,1023,764,717,30,27,0.7,30228103.03
ANDREW.MACDONALD,20152016,PHI,673,2,5,2,7,9,7,0,0,0,24,69,16,27,6,4,580,706,517,546,25,18,0,30228078.41
ANDREW.SHAW,20152016,CHI,1226.2333333333333,18,9,13,22,40,27,169,357,188,165,294,160,69,31,35,1309,1009,998,961,39,26,0.4733893557422969,30228142.095
ANDREY.PEDAN,20152016,VAN,142.38333333333333,0,0,0,0,0,0,0,0,0,11,27,40,10,3,6,120,153,120,142,1,4,0,30228039.130000003
ANDY.ANDREOFF,20152016,L.A,537.45,8,2,0,2,10,10,138,273,135,48,92,83,22,17,17,502,484,488,477,15,14,0.5054945054945055,30228082.79
ANDY.GREENE,20152016,N.J,1881.6333333333334,4,5,3,8,12,9,0,0,0,63,148,73,43,8,14,1074,1816,926,1197,39,35,0,30228156.055
ANTHONY.BITETTO,20152016,NSH,500.6333333333333,1,1,3,4,5,2,0,0,0,29,67,97,18,6,11,435,473,427,469,15,14,0,30228072.685000002
ANTHONY.DUCLAIR,20152016,ARI,1164.7333333333333,20,13,11,24,44,33,0,1,1,105,185,27,29,25,22,1267,942,849,861,46,28,0,30228130.275
ANTHONY.MANTHA,20152016,DET,117,2,0,1,1,3,2,0,0,0,18,28,4,5,1,1,143,90,105,87,4,10,0,30228032.985
ANTHONY.PELUSO,20152016,WPG,223.4,1,1,3,4,5,2,0,0,0,16,33,81,7,7,16,155,182,150,182,8,4,0,30228046.295
ANTOINE.ROUSSEL,20152016,DAL,1294.0333333333333,15,10,6,16,31,25,18,48,30,127,236,142,47,47,52,1256,1315,1136,1059,37,34,0.375,30228145.84
ANTOINE.VERMETTE,20152016,ARI,1264.6166666666668,17,11,10,21,38,28,754,1351,597,123,191,55,36,11,31,1252,1179,808,938,33,42,0.5581051073279053,30228165.869999997
ANTON.LANDER,20152016,EDM,736.6666666666666,1,1,1,2,3,2,376,691,315,54,93,58,23,14,8,592,800,484,541,8,19,0.5441389290882779,30228093.655
ANTON.SLEPYSHEV,20152016,EDM,95.6,0,1,0,1,1,1,1,1,0,5,16,13,7,2,1,68,74,68,73,2,7,1,30228031.16
ANTON.STRALMAN,20152016,T.B,1733.0333333333333,10,10,15,25,35,20,0,0,0,134,259,108,76,5,11,1602,1458,1202,1011,46,33,0,30228119.275
ANZE.KOPITAR,20152016,L.A,1802.4,27,25,26,51,78,52,1019,1896,877,187,330,92,72,25,8,1983,1483,1355,999,64,37,0.5374472573839663,30228164.759999998
ARTEM.ANISIMOV,20152016,CHI,1516.9833333333331,23,9,13,22,45,32,549,1253,704,135,237,57,56,10,7,1419,1370,1092,1081,49,49,0.4381484437350359,30228175.435000002
ARTEMI.PANARIN,20152016,CHI,1622.0333333333333,32,33,19,52,84,65,1,1,0,210,371,53,91,18,20,1715,1250,1248,1146,58,56,1,30228166.795
AUSTIN.WATSON,20152016,NSH,570.15,3,4,3,7,10,7,6,13,7,55,92,74,21,3,9,382,526,370,444,14,20,0.46153846153846156,30228075.795
BARCLAY.GOODROW,20152016,S.J,143.78333333333333,0,2,1,3,3,2,4,6,2,7,12,8,0,5,5,104,146,96,119,3,4,0.6666666666666666,30228038.985
BARRET.JACKMAN,20152016,NSH,1190.1,1,1,3,4,5,2,0,0,0,70,153,120,46,13,32,1078,993,1052,873,34,31,0,30228100.255000003
BEAU.BENNETT,20152016,PIT,403.85,6,1,5,6,12,7,2,6,4,54,96,65,25,1,5,411,338,333,311,13,16,0.3333333333333333,30228057.064999998
BEN.CHIAROT,20152016,WPG,1012.05,1,2,6,8,9,3,0,0,0,75,167,130,52,11,16,881,1000,844,867,32,41,0,30228107.76
BEN.HARPUR,20152016,OTT,68.3,0,1,0,1,1,1,0,0,0,3,4,9,0,0,1,57,73,57,72,3,2,0,30228032.35
BEN.HUTTON,20152016,VAN,1490.5,1,10,12,22,23,11,0,0,0,104,237,42,90,13,7,1306,1339,960,1123,32,43,0,30228139.63
BEN.LOVEJOY,20152016,PIT,1671.4166666666667,6,5,5,10,16,11,0,0,0,119,226,199,56,8,24,1390,1681,1310,1286,53,44,0,30228152.005000003
BEN.SMITH,20152016,S.J,35.93333333333334,0,0,0,0,0,0,5,17,12,1,3,5,1,0,0,25,45,25,44,0,1,0.29411764705882354,30228029.799999997
BEN.SMITH,20152016,TOR,230.10000000000002,2,2,2,4,6,4,95,168,73,16,31,13,7,0,0,188,245,172,180,7,7,0.5654761904761905,30228046.450000003
BEN.STREET,20152016,COL,51.41666666666667,0,0,0,0,0,0,26,47,21,8,10,6,1,1,2,47,68,47,67,2,3,0.5531914893617021,30228032.75
BENOIT.POULIOT,20152016,EDM,882.6166666666667,14,12,9,21,35,26,20,49,29,109,174,35,24,15,15,937,703,657,632,29,36,0.40816326530612246,30228104.175
BLAKE.COMEAU,20152016,COL,1427.8,12,11,13,24,36,23,276,566,290,142,251,172,69,16,25,1163,1391,858,1001,31,34,0.4876325088339223,30228154.425
BLAKE.PIETILA,20152016,N.J,84.23333333333333,1,1,0,1,2,2,0,0,0,10,15,19,4,2,1,55,81,49,68,1,2,0,30228032.92
BLAKE.WHEELER,20152016,WPG,1621.8166666666666,26,37,15,52,78,63,10,28,18,256,458,92,96,27,23,1834,1337,1228,1003,61,44,0.35714285714285715,30228146.494999997
BO.HORVAT,20152016,VAN,1404.85,16,13,11,24,40,29,759,1491,732,155,245,69,47,16,9,1113,1463,832,984,35,54,0.5090543259557344,30228175.145
BOBBY.FARNHAM,20152016,N.J,473.53333333333336,8,1,1,2,10,9,2,4,2,48,84,83,13,24,22,294,377,292,362,12,14,0.5,30228072.195
BOBBY.FARNHAM,20152016,PIT,20.066666666666666,0,0,0,0,0,0,0,0,0,2,2,10,0,1,1,10,24,10,21,0,0,0,30228026.91
BOBBY.RYAN,20152016,OTT,1391.1666666666665,22,23,11,34,56,45,3,11,8,183,341,106,93,27,13,1436,1201,906,1055,46,48,0.2727272727272727,30228156.715
BOONE.JENNER,20152016,CBJ,1345.5500000000002,30,12,7,19,49,42,156,294,138,225,344,213,63,22,26,1303,1263,994,1135,41,51,0.5306122448979592,30228177.784999996
BORNA.RENDULIC,20152016,COL,22.583333333333332,0,0,0,0,0,0,0,3,3,1,3,1,1,0,0,11,30,10,30,0,2,0,15114016.05
BOYD.GORDON,20152016,ARI,793.1166666666667,2,1,1,2,4,3,526,909,383,53,80,21,12,5,5,439,847,414,534,7,16,0.5786578657865786,30228099.915
BRACKEN.KEARNS,20152016,NYI,31.78333333333333,0,1,0,1,1,1,8,12,4,0,0,5,0,0,2,18,18,17,14,0,0,0.6666666666666666,15114014.22
BRAD.BOYES,20152016,TOR,718.2166666666667,8,9,7,16,24,17,9,14,5,85,169,20,43,7,6,904,491,546,446,20,26,0.6428571428571429,30228070.604999997
BRAD.HUNT,20152016,EDM,99.25,0,0,0,0,0,0,0,0,0,12,26,7,10,0,1,100,84,73,79,1,2,0,30228031.3
BRAD.MALONE,20152016,CAR,544.0833333333334,2,3,1,4,6,5,40,61,21,31,74,124,21,14,24,386,461,368,379,11,22,0.6557377049180327,30228066.715
BRAD.MARCHAND,20152016,BOS,1432.2166666666667,37,15,9,24,61,52,21,56,35,250,395,65,74,32,34,1534,1317,1169,961,54,37,0.375,30228144.785
BRAD.RICHARDS,20152016,DET,1080.85,11,14,3,17,28,25,138,280,142,176,331,20,94,3,6,1189,755,802,688,24,24,0.4928571428571429,30228100.475
BRAD.RICHARDSON,20152016,ARI,1280.9666666666667,11,12,8,20,31,23,523,961,438,117,210,57,54,18,18,1033,1379,913,1087,39,29,0.5442247658688866,30228167.75
BRAD.STUART,20152016,COL,84,0,0,0,0,0,0,0,0,0,0,4,11,1,0,0,50,74,49,66,1,3,0,30228031.15
BRADY.SKJEI,20152016,NYR,216.45,0,0,2,2,2,0,0,0,0,12,31,22,13,0,3,167,221,150,161,5,4,0,30228039.15
BRANDON.BOLLIG,20152016,CGY,501.65,2,0,2,2,4,2,2,3,1,56,95,117,16,8,24,372,477,363,464,10,20,0.6666666666666666,30228079.61
BRANDON.DAVIDSON,20152016,EDM,979.0166666666667,4,2,4,6,10,6,0,0,0,63,166,74,64,3,10,820,975,714,658,26,24,0,30228082.38
BRANDON.DUBINSKY,20152016,CBJ,1407.2333333333333,17,22,9,31,48,39,780,1484,704,158,288,235,81,25,26,1356,1364,986,990,41,53,0.5256064690026954,30228169.025
BRANDON.GORMLEY,20152016,COL,316.5333333333333,0,0,1,1,1,0,0,0,0,11,32,18,11,1,4,258,300,246,291,13,16,0,30228052.985
BRANDON.MANNING,20152016,PHI,1035.9333333333334,1,3,4,7,8,4,0,1,1,80,173,104,64,22,24,1001,1021,954,884,23,24,0,30228106.369999997
BRANDON.MASHINTER,20152016,CHI,324.26666666666665,4,0,1,1,5,4,0,0,0,26,41,70,8,6,8,253,304,248,296,6,12,0,30228059.335
BRANDON.PIRRI,20152016,ANA,114.58333333333334,3,2,0,2,5,5,0,2,2,17,36,11,12,0,0,120,96,87,93,4,4,0,30228035.35
BRANDON.PIRRI,20152016,FLA,770.9166666666667,11,8,5,13,24,19,66,141,75,111,235,55,67,14,16,712,599,506,561,20,22,0.46808510638297873,30228093.455
BRANDON.PRUST,20152016,VAN,447.45,1,4,2,6,7,5,6,11,5,19,37,39,7,9,11,327,432,320,400,8,12,0.5454545454545454,30228071.68
BRANDON.SAAD,20152016,CBJ,1343.0333333333333,31,11,11,22,53,42,19,34,15,233,396,43,84,20,7,1341,1176,996,1005,51,39,0.5588235294117647,30228146.735
BRANDON.SUTTER,20152016,VAN,359.5333333333333,5,0,4,4,9,5,146,278,132,45,71,12,10,5,1,324,277,205,204,11,5,0.5251798561151079,30228052.59
BRANDON.TANEV,20152016,WPG,36.13333333333333,0,0,0,0,0,0,0,0,0,4,11,7,5,0,1,29,46,29,38,0,0,0,15114015.85
BRAYDEN.MCNABB,20152016,L.A,1608.4833333333333,2,5,6,11,13,7,0,0,0,97,249,220,92,19,37,1563,1308,1473,1059,48,42,0,30228103.39
BRAYDEN.SCHENN,20152016,PHI,1465.35,26,20,15,35,61,46,68,149,81,189,343,208,80,20,14,1775,1228,1081,1092,45,32,0.4563758389261745,30228160.445
BRAYDON.COBURN,20152016,T.B,1656.8333333333335,1,5,5,10,11,6,0,0,0,106,229,132,69,14,24,1288,1590,1214,1182,55,51,0,30228134.865
BRENDAN.GALLAGHER,20152016,MTL,878.5333333333333,19,12,9,21,40,31,12,29,17,173,275,43,60,25,10,1078,685,749,598,36,23,0.41379310344827586,30228093.555
BRENDAN.GAUNCE,20152016,VAN,255.16666666666669,1,0,0,0,1,1,49,107,58,34,52,34,9,0,0,216,251,203,213,2,10,0.45794392523364486,30228048.96
BRENDAN.LEIPSIC,20152016,TOR,85.41666666666666,1,2,0,2,3,3,2,3,1,11,19,12,4,1,1,105,67,78,63,2,3,0.6666666666666666,30228031.189999998
BRENDAN.SMITH,20152016,DET,1157.6999999999998,3,6,6,12,15,9,0,0,0,88,182,103,60,18,27,1100,897,966,728,40,32,0,30228084.38
BRENDAN.WOODS,20152016,CAR,43.53333333333333,0,0,0,0,0,0,0,1,1,5,5,3,0,2,2,35,28,35,28,0,0,0,30228027.07
BRENDEN.DILLON,20152016,S.J,1632.0166666666667,2,5,6,11,13,7,0,0,0,112,269,226,106,11,25,1368,1590,1317,1433,44,47,0,30228164.66
BRENT.BURNS,20152016,S.J,2723.833333333333,34,32,30,62,96,66,1,1,0,430,978,150,355,20,33,3066,2412,2028,1825,87,66,1,30228200.34
BRENT.REGNER,20152016,FLA,81.08333333333334,0,0,0,0,0,0,0,0,0,7,10,4,2,0,2,60,77,59,75,0,2,0,30228032.65
BRENT.SEABROOK,20152016,CHI,2037.9333333333332,15,13,17,30,45,28,0,0,0,182,394,150,142,3,18,1964,1930,1414,1530,48,54,0,30228185.055
BRETT.BULMER,20152016,MIN,20.15,0,0,0,0,0,0,0,0,0,2,2,2,0,3,2,7,24,7,23,0,1,0,30228027.53
BRETT.CONNOLLY,20152016,BOS,920.2333333333333,9,10,6,16,25,19,14,31,17,95,171,137,34,10,10,930,794,804,759,37,40,0.45161290322580644,30228106.310000002
BRETT.KULAK,20152016,CGY,98.76666666666668,0,0,0,0,0,0,0,0,0,9,18,2,6,0,0,93,77,93,74,1,3,0,30228029.85
BRETT.LERNOUT,20152016,MTL,6.5,0,0,0,0,0,0,0,0,0,0,0,1,0,0,0,4,9,4,9,0,0,0,15114013.15
BRETT.PESCE,20152016,CAR,1294.65,4,4,7,11,15,8,0,1,1,85,180,29,51,8,8,1103,1087,945,929,27,34,0,30228115.505000003
BRETT.RITCHIE,20152016,DAL,106.35000000000001,0,0,1,1,1,0,0,0,0,16,26,32,5,3,2,99,93,74,88,2,6,0,30228033.655
BRIAN.BOYLE,20152016,T.B,1244.0166666666664,18,4,3,7,25,22,451,896,445,147,240,157,46,20,25,1017,1162,802,790,30,37,0.5033482142857143,30228135.065
BRIAN.CAMPBELL,20152016,FLA,1980.6666666666665,6,13,13,26,32,19,0,0,0,107,219,33,65,14,13,1783,1514,1316,1181,73,42,0,30228134.415
BRIAN.DUMOULIN,20152016,PIT,2008.5500000000002,2,10,12,22,24,12,1,1,0,127,276,110,94,13,8,1875,1759,1674,1460,67,60,1,30228150.62
BRIAN.FLYNN,20152016,MTL,657.05,4,3,3,6,10,7,200,346,146,73,108,23,16,4,2,466,634,421,480,12,18,0.5780346820809249,30228084.715
BRIAN.GIONTA,20152016,BUF,1400.8666666666668,12,15,5,20,32,27,54,120,66,169,275,46,55,7,6,1242,1361,915,1044,34,37,0.45,30228150.705
BRIAN.O'NEILL,20152016,N.J,227.95,0,1,1,2,2,1,2,6,4,13,23,36,6,2,4,144,198,135,171,3,5,0.3333333333333333,30228043.625
BRIAN.STRAIT,20152016,NYI,802.5833333333333,1,1,4,5,6,2,0,0,0,43,110,106,41,6,14,651,827,615,683,23,23,0,30228091.96
BROCK.MCGINN,20152016,CAR,234.86666666666667,3,0,1,1,4,3,0,1,1,25,35,28,3,3,5,171,216,163,190,6,18,0,30228047.255
BROCK.NELSON,20152016,NYI,1465,27,8,10,18,45,35,238,503,265,191,331,73,86,20,18,1358,1291,1047,1144,46,43,0.4731610337972167,30228170.82
BRODY.SUTTER,20152016,CAR,71.73333333333333,0,0,0,0,0,0,9,13,4,7,9,21,0,1,0,43,76,43,74,0,3,0.6923076923076923,30228033.42
BROOKS.LAICH,20152016,TOR,293.5,1,3,3,6,7,4,60,134,74,35,54,43,13,3,1,252,293,210,235,7,12,0.44776119402985076,30228053.355
BROOKS.LAICH,20152016,WSH,632.7333333333333,1,2,3,5,6,3,38,109,71,66,104,83,17,8,8,467,683,435,405,11,17,0.3486238532110092,30228068.575000003
BROOKS.ORPIK,20152016,WSH,938.75,3,2,5,7,10,5,0,0,0,35,93,139,42,2,17,848,979,802,769,43,36,0,30228094.395
BRYAN.BICKELL,20152016,CHI,244.7,0,1,1,2,2,1,2,2,0,21,44,58,12,3,1,232,216,225,216,5,10,1,30228044.435000002
BRYAN.LERG,20152016,S.J,53.25,0,0,0,0,0,0,17,33,16,4,7,13,2,0,0,23,63,23,56,1,0,0.5151515151515151,30228031.630000003
BRYAN.LITTLE,20152016,WPG,1116.5500000000002,17,13,11,24,41,30,674,1313,639,127,216,48,44,12,6,1213,997,802,673,34,33,0.5133282559025133,30228125.604999997
BRYAN.RUST,20152016,PIT,777.1833333333334,10,7,3,10,20,17,4,9,5,102,174,96,27,13,9,720,649,670,600,27,17,0.4444444444444444,30228090.265
BUD.HOLLOWAY,20152016,MTL,7.316666666666666,0,0,0,0,0,0,0,1,1,1,1,0,0,0,0,1,5,1,5,0,0,0,15114012.8
BUDDY.ROBINSON,20152016,OTT,25.799999999999997,1,0,1,1,2,1,0,1,1,5,7,11,2,0,2,22,31,22,31,3,1,0,30228028.175
BYRON.FROESE,20152016,TOR,707.0666666666666,2,3,0,3,5,5,310,642,332,64,117,51,25,6,8,533,691,451,475,14,24,0.48286604361370716,30228087.86
CAL.CLUTTERBUCK,20152016,NYI,1066.7666666666669,17,5,4,9,26,22,1,4,3,99,182,326,48,24,17,777,1080,707,769,31,33,0.25,30228114.979999997
CAL.O'REILLY,20152016,BUF,223.60000000000002,3,2,2,4,7,5,59,109,50,10,14,3,1,1,1,207,194,121,172,6,6,0.5412844036697247,30228048.619999997
CALLE.JARNKROK,20152016,NSH,1515.85,16,7,8,15,31,23,395,863,468,132,213,49,40,15,9,1301,1432,1106,1050,44,46,0.45770567786790267,30228156.8
CALVIN.DE HAAN,20152016,NYI,1713.4166666666665,2,7,9,16,18,9,0,1,1,109,231,147,73,7,12,1452,1715,1319,1310,48,55,0,30228149.695
CAM.ATKINSON,20152016,CBJ,1441.65,27,19,7,26,53,46,2,4,2,226,371,47,66,17,10,1398,1322,971,979,44,52,0.5,30228148.725
CAM.FOWLER,20152016,ANA,1749.4333333333334,6,12,13,25,31,18,0,0,0,122,280,54,107,7,14,1736,1630,1135,1216,43,53,0,30228147.195
CARL.GUNNARSSON,20152016,STL,1566.9833333333333,3,3,5,8,11,6,0,0,0,61,136,86,48,12,15,1171,1490,1099,1151,50,43,0,30228136.545
CARL.HAGELIN,20152016,ANA,645.1,4,2,5,7,11,6,3,7,4,82,145,40,26,2,7,623,580,571,477,15,22,0.42857142857142855,30228070.465
CARL.HAGELIN,20152016,PIT,1004.5333333333333,16,17,10,27,43,33,4,12,8,155,243,84,57,12,15,993,964,886,742,52,28,0.3333333333333333,30228106.43
CARL.SODERBERG,20152016,COL,1477.2333333333331,12,27,12,39,51,39,339,719,380,163,267,27,50,24,16,1247,1445,867,1048,38,39,0.4714881780250348,30228175.2
CARLO.COLAIACOVO,20152016,BUF,521.0166666666667,1,2,2,4,5,3,0,0,0,29,59,36,16,2,5,434,457,407,445,14,25,0,30228070.07
CASEY.CIZIKAS,20152016,NYI,1177.7166666666667,8,14,9,23,31,22,546,1105,559,96,175,187,38,18,22,863,1236,787,851,34,38,0.49411764705882355,30228146.244999997
CASEY.NELSON,20152016,BUF,103.75,0,1,2,3,3,1,0,0,0,5,14,5,7,0,4,93,59,69,58,5,4,0,30228029
CEDRIC.PAQUETTE,20152016,T.B,891.5333333333333,6,2,4,6,12,8,153,314,161,64,134,176,35,36,29,681,836,650,655,17,23,0.4872611464968153,30228101.98
CHAD.RUHWEDEL,20152016,BUF,15.5,0,0,0,0,0,0,0,0,0,1,2,3,1,0,1,12,17,12,17,0,0,0,15114014
CHANDLER.STEPHENSON,20152016,WSH,70.71666666666667,0,0,0,0,0,0,30,55,25,2,4,5,1,0,1,61,49,59,49,0,3,0.5454545454545454,30228029.450000003
CHARLES.HUDON,20152016,MTL,32.083333333333336,0,1,1,2,2,1,0,1,1,3,7,7,0,0,0,29,28,26,28,2,0,0,30228027.425
CHARLIE.COYLE,20152016,MIN,1532.1666666666665,22,11,9,20,42,33,261,572,311,152,253,138,51,36,11,1439,1348,1016,1140,40,42,0.4562937062937063,30228175.225
CHASE.DE LEO,20152016,WPG,18.833333333333332,0,0,0,0,0,0,1,1,0,2,2,3,0,0,0,10,14,8,12,1,0,1,15114013.34
CHRIS.BIGRAS,20152016,COL,413.6,1,0,2,2,3,1,0,0,0,21,47,17,12,1,8,308,433,296,399,8,12,0,30228069.16
CHRIS.BROWN,20152016,WSH,7.683333333333334,0,0,0,0,0,0,0,0,0,1,2,2,1,0,0,6,3,6,3,0,0,0,15114012.05
CHRIS.BUTLER,20152016,STL,57.5,0,0,0,0,0,0,0,0,0,4,7,3,2,0,2,43,66,38,58,2,4,0,30228030.700000003
CHRIS.HIGGINS,20152016,VAN,454.68333333333334,3,1,0,1,4,4,1,3,2,51,86,15,17,3,2,344,469,305,352,7,17,0.3333333333333333,30228063.57
CHRIS.KELLY,20152016,BOS,143.95,2,0,0,0,2,2,22,52,30,8,14,13,3,0,0,85,155,72,112,5,4,0.4230769230769231,30228039.08
CHRIS.KREIDER,20152016,NYR,1340.35,23,13,9,22,45,36,5,7,2,168,300,200,63,16,24,1458,1104,1031,1003,56,37,0.7142857142857143,30228141.185000002
CHRIS.KUNITZ,20152016,PIT,1689.5666666666666,21,18,13,31,52,39,6,13,7,200,370,353,84,23,25,1934,1332,1519,1183,73,41,0.46153846153846156,30228141.795
CHRIS.NEIL,20152016,OTT,743.8499999999999,5,4,4,8,13,9,1,2,1,70,134,215,28,28,40,632,643,623,621,22,25,0.5,30228094.32
CHRIS.PORTER,20152016,MIN,648.6,5,1,2,3,8,6,0,2,2,48,93,173,23,7,3,383,664,367,531,11,16,0,30228087.42
CHRIS.STEWART,20152016,ANA,671.4,9,10,4,14,23,19,4,10,6,85,147,77,28,15,22,680,548,569,528,27,20,0.4,30228086.560000002
CHRIS.SUMMERS,20152016,NYR,46.16666666666667,0,0,0,0,0,0,0,0,0,5,7,4,1,2,2,36,44,35,36,1,3,0,30228027.92
CHRIS.TANEV,20152016,VAN,1501,4,6,6,12,16,10,0,0,0,41,95,18,35,9,5,1145,1394,957,980,34,43,0,30228122.240000002
CHRIS.TERRY,20152016,CAR,766.6166666666667,8,2,1,3,11,10,1,9,8,78,151,82,39,9,8,665,669,592,647,19,28,0.1111111111111111,30228095.105
CHRIS.THORBURN,20152016,WPG,829.95,6,4,2,6,12,10,68,122,54,70,114,146,21,18,26,624,818,588,704,21,24,0.5573770491803278,30228110.05
CHRIS.TIERNEY,20152016,S.J,1396.4,12,13,4,17,29,25,490,1071,581,111,185,46,29,24,13,1054,1513,988,1143,33,47,0.45751633986928103,30228184.490000002
CHRIS.VANDEVELDE,20152016,PHI,1161.8333333333333,3,5,7,12,15,8,8,23,15,78,134,149,20,10,12,863,1335,801,936,18,32,0.34782608695652173,30228130.494999997
CHRIS.WAGNER,20152016,ANA,194.88333333333333,0,1,1,2,2,1,53,97,44,29,48,56,11,4,4,171,184,163,148,2,2,0.5463917525773195,30228040.485
CHRIS.WAGNER,20152016,COL,214.08333333333334,4,0,0,0,4,4,101,185,84,27,45,43,8,1,3,140,204,137,199,5,7,0.5459459459459459,30228052.85
CHRIS.WIDEMAN,20152016,OTT,892.8166666666666,6,4,3,7,13,10,0,0,0,87,177,57,68,4,17,791,898,714,842,32,28,0,30228113.165
CHRISTIAN.EHRHOFF,20152016,CHI,136.23333333333332,0,0,2,2,2,0,0,0,0,19,37,5,9,2,1,130,103,111,102,4,5,0,30228033.07
CHRISTIAN.EHRHOFF,20152016,L.A,606.8833333333333,2,5,3,8,10,7,0,0,0,61,137,34,42,8,16,630,465,493,410,13,20,0,30228062.505
CHRISTIAN.FOLIN,20152016,MIN,379.0833333333333,0,2,2,4,4,2,0,0,0,14,36,38,17,2,4,268,405,234,317,9,11,0,30228058.52
CHRISTIAN.THOMAS,20152016,ARI,10.583333333333334,0,0,0,0,0,0,0,0,0,3,3,0,0,0,0,8,11,8,11,0,0,0,15114013.4
CHRISTIAN.THOMAS,20152016,MTL,43.05,0,2,0,2,2,2,0,0,0,6,9,5,3,0,1,45,25,45,25,2,1,0,30228026.299999997
CHRISTOPH.BERTSCHY,20152016,MIN,20.833333333333336,0,0,0,0,0,0,0,0,0,3,4,7,0,0,0,10,37,9,36,0,0,0,30228029.1
CLARKE.MACARTHUR,20152016,OTT,43.43333333333333,0,0,0,0,0,0,0,1,1,4,8,3,3,1,0,45,33,27,23,1,2,0,30228025.759999998
CLAUDE.GIROUX,20152016,PHI,1727.4,22,26,20,46,68,48,1158,2033,875,251,437,94,115,32,21,2071,1524,1201,1132,41,42,0.5696015740285293,30228189.740000002
CLAYTON.STONER,20152016,ANA,775.55,1,1,4,5,6,2,0,0,0,32,71,127,23,8,19,611,680,589,552,19,19,0,30228077.13
CODY.BASS,20152016,NSH,167.51666666666665,0,0,0,0,0,0,24,47,23,14,22,41,5,8,5,98,153,94,143,1,5,0.5106382978723404,30228042.29
CODY.CECI,20152016,OTT,1447.5166666666667,10,8,8,16,26,18,0,0,0,116,232,70,72,6,9,1090,1583,933,1163,38,36,0,30228154.509999998
CODY.EAKIN,20152016,DAL,1586.7833333333333,17,19,7,26,43,36,703,1438,735,149,268,116,65,17,24,1456,1587,1184,1201,47,54,0.48887343532684285,30228191.965
CODY.FRANSON,20152016,BUF,993.4000000000001,4,6,7,13,17,10,0,0,0,92,188,61,63,2,12,929,793,668,674,18,24,0,30228092.595
CODY.GOLOUBEF,20152016,CBJ,650.4,1,1,6,7,8,2,0,0,0,40,98,31,36,1,12,552,666,526,595,22,20,0,30228083.76
CODY.HODGSON,20152016,NSH,418.5833333333333,3,4,1,5,8,7,46,98,52,65,122,25,27,6,3,430,308,413,306,11,9,0.46938775510204084,30228053.825
CODY.MCLEOD,20152016,COL,864.2333333333333,8,2,3,5,13,10,1,1,0,73,107,240,14,29,38,622,901,581,757,23,22,1,30228119.505
COLE.SCHNEIDER,20152016,BUF,25.25,0,0,0,0,0,0,0,0,0,5,7,3,0,0,0,21,20,20,20,0,0,0,30228026.25
COLIN.GREENING,20152016,OTT,4,0,0,0,0,0,0,0,0,0,2,2,3,0,0,0,4,2,4,2,0,0,0,15114012.2
COLIN.GREENING,20152016,TOR,432.98333333333335,7,5,3,8,15,12,13,21,8,56,100,87,17,5,4,511,337,359,309,15,15,0.6190476190476191,30228059.195
COLIN.MCDONALD,20152016,PHI,67.30000000000001,1,0,0,0,1,1,2,2,0,8,11,29,0,2,2,40,63,39,63,1,1,1,30228032.75
COLIN.MILLER,20152016,BOS,663.3833333333333,3,6,6,12,15,9,0,0,0,59,140,45,52,8,14,668,557,550,505,24,21,0,30228071.83
COLIN.WILSON,20152016,NSH,1163.1,11,14,12,26,37,25,16,42,26,135,224,79,43,13,6,1213,939,982,868,43,38,0.38095238095238093,30228117.42
COLTON.PARAYKO,20152016,STL,1934.0166666666667,11,16,12,28,39,27,0,0,0,206,446,127,144,17,15,1846,1590,1505,1336,75,49,0,30228146.42
COLTON.SCEVIOUR,20152016,DAL,1039.9666666666667,13,10,5,15,28,23,25,49,24,145,259,90,70,11,9,931,1022,791,756,31,29,0.5102040816326531,30228107.335
COLTON.SISSONS,20152016,NSH,444.2833333333333,4,0,2,2,6,4,173,314,141,31,55,62,13,6,7,358,405,338,337,13,8,0.5509554140127388,30228064.68
CONNOR.BRICKLEY,20152016,FLA,200.68333333333334,1,4,0,4,5,5,0,0,0,13,18,46,1,3,7,121,173,117,170,5,4,0,30228047.380000003
CONNOR.BROWN,20152016,TOR,104.8,1,3,2,5,6,4,0,0,0,11,20,1,6,2,0,119,73,68,59,2,4,0,30228031.32
CONNOR.CARRICK,20152016,TOR,264.7833333333333,2,1,1,2,4,3,0,0,0,19,52,33,19,2,6,268,212,237,207,5,9,0,30228043.495
CONNOR.CARRICK,20152016,WSH,30.35,0,0,0,0,0,0,0,0,0,2,7,5,3,0,0,48,26,45,25,1,3,0,30228025
CONNOR.MCDAVID,20152016,EDM,849.8166666666666,16,16,16,32,48,32,249,604,355,105,156,12,19,18,9,954,694,620,589,35,34,0.41225165562913907,30228116.490000002
CONNOR.MURPHY,20152016,ARI,1599.75,6,4,7,11,17,10,0,0,0,101,244,175,92,18,24,1324,1622,1105,1262,49,44,0,30228152.655
CONOR.SHEARY,20152016,PIT,750.3,11,5,4,9,20,16,1,9,8,89,153,38,39,13,7,810,556,723,541,25,25,0.1111111111111111,30228076.17
CORBAN.KNIGHT,20152016,FLA,192.61666666666667,2,3,2,5,7,5,54,106,52,11,19,18,2,2,1,115,157,113,156,7,5,0.5094339622641509,30228046.380000003
COREY.PERRY,20152016,ANA,1576.75,34,23,9,32,66,57,2,11,9,236,413,113,82,26,36,1790,1203,1159,1090,46,45,0.18181818181818182,30228165.365000002
COREY.POTTER,20152016,NSH,14.733333333333333,0,0,0,0,0,0,0,0,0,0,1,0,0,0,0,18,11,18,11,0,0,0,15114012.75
CRAIG.CUNNINGHAM,20152016,ARI,100.83333333333334,0,0,1,1,1,0,2,3,1,13,18,15,2,1,1,76,104,75,100,2,2,0.6666666666666666,30228035.564999998
CRAIG.SMITH,20152016,NSH,1413.35,22,14,2,16,38,36,81,247,166,229,398,95,87,17,20,1563,1026,1216,954,53,42,0.32793522267206476,30228130.66
CURTIS.LAZAR,20152016,OTT,1053.2666666666667,6,10,4,14,20,16,168,384,216,78,140,118,29,17,6,760,1100,643,855,22,34,0.4375,30228136.54
CURTIS.MCKENZIE,20152016,DAL,33.7,0,0,0,0,0,0,0,0,0,5,8,8,1,3,1,27,31,26,31,0,1,0,30228027.63
DAINIUS.ZUBRUS,20152016,S.J,716.7166666666667,4,2,3,5,9,6,15,28,13,44,85,132,22,6,13,526,633,517,545,19,19,0.5357142857142857,30228082.585
DALE.WEISE,20152016,CHI,182.78333333333333,1,1,0,1,2,2,1,5,4,22,34,28,9,3,1,150,138,135,121,8,4,0.2,30228035.57
DALE.WEISE,20152016,MTL,803.2666666666667,14,7,5,12,26,21,15,30,15,117,191,108,43,15,11,859,654,656,610,27,25,0.5,30228094.475
DALTON.PROUT,20152016,CBJ,1035.05,3,4,1,5,8,7,0,1,1,69,151,139,60,7,34,820,958,790,814,32,39,0,30228105.845
DAMON.SEVERSON,20152016,N.J,1307.8666666666668,1,11,8,19,20,12,0,0,0,94,200,66,59,11,15,1050,994,846,886,37,42,0,30228114.61
DAN.BOYLE,20152016,NYR,1470.6333333333334,10,8,7,15,25,18,0,0,0,100,209,69,62,7,16,1451,1259,1094,1100,51,43,0,30228136.744999997
DAN.GIRARDI,20152016,NYR,1539,2,7,8,15,17,9,0,0,0,79,153,177,44,8,9,1089,1822,1000,1380,49,41,0,30228178.28
DAN.HAMHUIS,20152016,VAN,1242.0833333333335,3,5,3,8,11,8,0,0,0,71,163,64,64,11,13,1029,1159,850,843,30,38,0,30228104.535
DANIEL.CARR,20152016,MTL,277.68333333333334,6,0,3,3,9,6,0,0,0,39,76,24,15,3,4,299,205,249,199,9,10,0,30228044.805
DANIEL.CATENACCI,20152016,BUF,96.13333333333333,0,0,0,0,0,0,2,2,0,7,8,22,0,1,0,67,89,67,85,1,3,1,30228033.59
DANIEL.PAILLE,20152016,NYR,136.9,0,0,0,0,0,0,0,1,1,11,16,16,3,2,0,74,172,70,130,2,4,0,30228039.87
DANIEL.SEDIN,20152016,VAN,1503.3666666666668,28,20,12,32,60,48,5,19,14,256,394,20,56,15,18,1516,1153,938,964,46,32,0.2631578947368421,30228154.200000003
DANIEL.SPRONG,20152016,PIT,157.05,2,0,0,0,2,2,1,2,1,23,43,14,12,1,0,130,145,121,139,2,3,0.5,30228039.299999997
DANIEL.WINNIK,20152016,TOR,798.8,4,5,4,9,13,9,5,15,10,84,131,41,27,9,8,679,801,617,629,17,21,0.3333333333333333,30228092.69
DANIEL.WINNIK,20152016,WSH,380.0833333333333,2,1,2,3,5,3,3,6,3,28,55,25,14,6,8,293,328,259,241,8,4,0.5,30228048.78
DANNY.DEKEYSER,20152016,DET,1809.8000000000002,8,8,5,13,21,16,0,0,0,77,154,101,45,10,23,1323,1694,1178,1247,42,51,0,30228156.875
DARNELL.NURSE,20152016,EDM,1395.9166666666667,3,3,4,7,10,6,0,0,0,120,241,160,69,12,24,1101,1519,1000,1196,41,56,0,30228150.67
DARREN.DIETZ,20152016,MTL,188.98333333333335,1,2,2,4,5,3,0,0,0,13,24,38,6,1,5,159,160,156,149,9,8,0,30228039.66
DARREN.HELM,20152016,DET,1225.4333333333334,14,7,5,12,26,21,39,78,39,177,307,131,69,34,18,1052,1112,875,826,34,38,0.5,30228116.175
DAVE.BOLLAND,20152016,FLA,352.3,1,2,2,4,5,3,156,341,185,26,52,36,14,3,9,250,366,196,254,8,10,0.4574780058651026,30228061.32
DAVE.DZIURZYNSKI,20152016,OTT,141.08333333333331,1,1,2,3,4,2,3,7,4,14,21,55,2,1,3,78,163,76,156,4,8,0.42857142857142855,30228045.43
DAVID.BACKES,20152016,STL,1892.6,28,20,10,30,58,48,721,1408,687,204,326,332,51,16,41,1735,1691,1241,1244,46,37,0.5120738636363636,30228209
DAVID.CLARKSON,20152016,CBJ,212,2,1,1,2,4,3,2,12,10,24,33,45,5,6,6,159,224,149,222,4,12,0.16666666666666666,30228053.165
DAVID.DESHARNAIS,20152016,MTL,1040.1833333333334,11,10,8,18,29,21,391,803,412,90,143,31,32,19,9,1076,830,773,742,28,30,0.48692403486924035,30228124.18
DAVID.JONES,20152016,CGY,754.6166666666668,9,5,1,6,15,14,16,32,16,66,130,115,24,8,5,602,785,572,754,28,33,0.5,30228114.595
DAVID.JONES,20152016,MIN,255.66666666666669,2,2,0,2,4,4,1,2,1,20,38,42,6,4,0,200,245,183,241,6,4,0.5,30228052.78
DAVID.KREJCI,20152016,BOS,1461.6666666666665,17,28,16,44,61,45,560,1117,557,143,292,43,87,18,15,1606,1261,976,972,50,36,0.5013428827215757,30228160.78
DAVID.LEGWAND,20152016,BUF,765.9333333333334,5,5,4,9,14,10,195,426,231,61,93,28,23,4,7,465,840,422,508,17,24,0.45774647887323944,30228093.39
DAVID.PASTRNAK,20152016,BOS,711.2,15,6,5,11,26,21,0,3,3,108,174,52,38,17,9,728,652,662,632,30,24,0,30228096.744999997
DAVID.PERRON,20152016,ANA,525.2333333333333,9,9,5,14,23,18,2,6,4,67,115,48,26,13,20,623,373,435,347,23,10,0.3333333333333333,30228065.235
DAVID.PERRON,20152016,PIT,665.4,4,7,5,12,16,11,1,5,4,96,152,105,25,10,14,685,580,530,530,15,27,0.2,30228085.215
DAVID.RUNDBLAD,20152016,CHI,157.35,0,0,2,2,2,0,0,0,0,14,30,6,9,2,5,161,108,131,103,2,3,0,30228032.87
DAVID.SAVARD,20152016,CBJ,1506.2166666666667,4,10,9,19,23,14,0,0,0,122,258,122,76,3,17,1283,1468,980,1084,43,45,0,30228137.405
DAVID.SCHLEMKO,20152016,N.J,1248.1833333333334,6,10,3,13,19,16,0,0,0,104,182,47,44,8,8,998,956,706,747,26,41,0,30228106.655
DAVID.WARSOFSKY,20152016,N.J,163.65,0,0,1,1,1,0,0,0,0,19,37,3,10,3,1,150,131,103,123,2,6,0,30228036.705
DAVID.WARSOFSKY,20152016,PIT,213.06666666666666,1,0,0,0,1,1,0,0,0,21,46,2,9,1,0,262,163,203,150,3,7,0,30228036.31
DEAN.KUKAN,20152016,CBJ,138.83333333333331,0,0,0,0,0,0,0,0,0,3,6,7,1,1,0,118,121,112,117,10,2,0,30228034.46
DENNIS.EVERBERG,20152016,COL,134.15,0,0,0,0,0,0,0,0,0,9,16,11,4,2,0,82,167,79,137,1,7,0,30228040.32
DENNIS.RASMUSSEN,20152016,CHI,403.20000000000005,4,1,4,5,9,5,144,307,163,42,66,36,14,6,2,343,360,338,352,19,9,0.46905537459283386,30228067.77
DENNIS.SEIDENBERG,20152016,BOS,1183.25,1,6,4,10,11,7,0,0,0,66,132,127,43,4,10,934,1241,875,980,40,41,0,30228123.939999998
DENNIS.WIDEMAN,20152016,CGY,1051.3666666666666,2,8,7,15,17,10,0,0,0,75,185,37,72,10,11,968,1010,663,817,26,35,0,30228110.525
DEREK.DORSETT,20152016,VAN,893.9166666666667,5,5,6,11,16,10,3,10,7,91,147,127,22,43,45,678,852,647,755,23,37,0.3,30228116.9
DEREK.FORBORT,20152016,L.A,154.63333333333333,1,0,1,1,2,1,0,0,0,14,30,9,12,1,7,182,128,175,106,4,5,0,30228031.285
DEREK.GRANT,20152016,CGY,163.18333333333334,0,0,1,1,1,0,61,111,50,22,36,25,7,0,0,140,177,127,149,0,8,0.5495495495495496,30228042.015
DEREK.MACKENZIE,20152016,FLA,929.6666666666666,6,2,6,8,14,8,491,895,404,88,145,172,23,15,14,544,883,479,569,18,12,0.5486033519553073,30228106.939999998
DEREK.RYAN,20152016,CAR,73.21666666666667,2,0,0,0,2,2,35,59,24,5,9,2,4,0,1,65,45,56,43,3,2,0.5932203389830508,30228029.25
DEREK.STEPAN,20152016,NYR,1364.3,24,16,14,30,54,40,558,1190,632,212,329,42,53,13,8,1350,1240,906,917,47,37,0.4689075630252101,30228165.85
DERICK.BRASSARD,20152016,NYR,1514.75,28,19,15,34,62,47,722,1433,711,193,331,116,79,12,14,1616,1321,1086,1176,54,39,0.5038381018841591,30228197.525
DERRICK.POULIOT,20152016,PIT,369.33333333333337,0,2,4,6,6,2,0,0,0,30,67,17,25,3,3,411,296,371,274,16,11,0,30228043.78
DERYK.ENGELLAND,20152016,CGY,1050.9666666666667,3,2,7,9,12,5,0,0,0,71,149,105,49,9,15,824,1108,789,954,35,36,0,30228124.665
DEVANTE.SMITH-PELLY,20152016,MTL,506.3166666666666,6,1,5,6,12,7,0,2,2,60,99,85,18,11,11,399,451,375,411,14,16,0,30228072.085
DEVANTE.SMITH-PELLY,20152016,N.J,280.3833333333333,8,4,1,5,13,12,2,3,1,34,51,20,7,6,4,236,210,155,189,13,12,0.6666666666666666,30228051.865000002
DEVIN.SHORE,20152016,DAL,36.35,0,0,0,0,0,0,0,1,1,1,2,2,1,0,0,21,41,20,40,2,1,0,15114016.65
DION.PHANEUF,20152016,OTT,463.33333333333337,1,4,2,6,7,5,0,0,0,28,90,48,40,15,10,409,452,319,319,10,13,0,30228054.5
DION.PHANEUF,20152016,TOR,1123.2833333333333,3,11,10,21,24,14,0,0,0,116,267,120,90,21,28,1261,980,853,811,24,30,0,30228105.009999998
DMITRIJ.JASKIN,20152016,STL,819.6666666666667,5,6,4,10,15,11,8,28,20,98,170,137,41,12,14,752,595,724,585,25,21,0.2857142857142857,30228080.79
DMITRY.KULIKOV,20152016,FLA,1707.4833333333333,2,9,9,18,20,11,0,0,0,109,212,138,53,13,26,1286,1545,1056,1139,49,45,0,30228143.255
DMITRY.ORLOV,20152016,WSH,1460.4166666666667,8,10,12,22,30,18,0,0,0,95,218,147,83,20,14,1460,1221,1315,1157,60,48,0,30228129.4
DOMINIC.MOORE,20152016,NYR,1127.0333333333333,7,5,4,9,16,12,509,925,416,99,159,56,33,12,18,741,1256,677,886,24,26,0.5502702702702703,30228145.93
DOMINIK.SIMON,20152016,PIT,18.21666666666667,0,1,0,1,1,1,0,0,0,2,2,1,0,0,0,19,13,19,13,1,1,0,30228025.5
DOUGIE.HAMILTON,20152016,CGY,1620.9166666666667,12,11,19,30,42,23,0,0,0,190,381,78,111,9,20,1728,1475,1243,1287,45,56,0,30228159.965
DREW.DOUGHTY,20152016,L.A,2451.583333333333,14,18,17,35,49,32,0,0,0,206,467,134,143,19,27,2600,1932,1888,1323,63,51,0,30228132.665
DREW.MILLER,20152016,DET,363.23333333333335,1,1,0,1,2,2,1,2,1,27,44,39,6,0,1,189,460,177,276,5,10,0.5,30228057.689999998
DREW.MILLER,20152016,EDM,54.733333333333334,0,0,0,0,0,0,13,29,16,3,4,5,0,1,0,38,39,36,39,0,2,0.4482758620689655,30228028.880000003
DREW.SHORE,20152016,CGY,27.983333333333334,0,1,0,1,1,1,4,10,6,3,3,0,0,0,1,18,27,14,12,1,1,0.4,30228026.06
DREW.STAFFORD,20152016,WPG,1393.35,21,9,7,16,37,30,51,101,50,187,289,59,62,8,11,1280,1135,970,917,37,57,0.504950495049505,30228131.445
DUNCAN.KEITH,20152016,CHI,1879.55,12,16,20,36,48,28,0,1,1,152,329,22,116,5,10,1773,1680,1306,1184,45,43,0,30228140.05
DUSTIN.BROWN,20152016,L.A,1406.9333333333334,11,11,5,16,27,22,8,17,9,221,385,260,67,26,16,1439,1144,1219,877,30,36,0.47058823529411764,30228108.255
DUSTIN.BYFUGLIEN,20152016,WPG,2041,19,20,13,33,52,39,0,0,0,247,498,222,143,19,49,2170,1686,1512,1284,73,61,0,30228153.765
DUSTIN.JEFFREY,20152016,ARI,79.85,1,1,0,1,2,2,35,58,23,5,6,2,1,1,1,56,71,41,70,4,2,0.603448275862069,30228034.16
DWIGHT.KING,20152016,L.A,750.7833333333333,7,4,3,7,14,11,3,11,8,55,106,84,20,2,10,691,698,637,572,18,23,0.2727272727272727,30228084.215
DYLAN.DEMELO,20152016,S.J,612.8166666666666,2,1,1,2,4,3,0,0,0,42,97,39,36,6,7,546,444,472,430,14,15,0,30228062.634999998
DYLAN.LARKIN,20152016,DET,1395.6333333333332,24,16,6,22,46,40,42,102,60,231,418,74,95,29,23,1461,1096,1064,981,49,40,0.4117647058823529,30228140.27
DYLAN.MCILRATH,20152016,NYR,489.33333333333337,2,1,1,2,4,3,0,0,0,29,73,93,26,12,22,425,442,413,389,18,10,0,30228061.994999997
DYLAN.OLSEN,20152016,FLA,110.01666666666667,0,1,0,1,1,1,0,0,0,9,13,6,2,0,1,72,96,72,96,3,4,0,30228035.200000003
ELIAS.LINDHOLM,20152016,CAR,1485.1333333333334,11,15,11,26,37,26,213,434,221,175,294,112,59,15,12,1608,1169,1135,984,32,47,0.49078341013824883,30228137.595
EMERSON.ETEM,20152016,NYR,210.46666666666667,0,3,0,3,3,3,1,2,1,23,50,26,20,4,0,180,195,174,194,7,11,0.5,30228043.23
EMERSON.ETEM,20152016,VAN,552.2333333333333,7,3,1,4,11,10,1,2,1,76,131,61,27,6,3,474,589,450,547,17,24,0.5,30228087.925
EMILE.POIRIER,20152016,CGY,27.783333333333335,0,0,0,0,0,0,0,0,0,3,8,4,1,1,1,32,15,32,15,0,1,0,15114012.81
ERIC.BOULTON,20152016,NYI,56.91666666666667,0,0,0,0,0,0,0,0,0,3,5,15,2,1,1,25,50,24,45,1,4,0,30228029.41
ERIC.FEHR,20152016,PIT,985.9833333333333,11,2,5,7,18,13,115,261,146,109,175,109,31,15,10,680,1001,609,671,21,30,0.44061302681992337,30228108.825000003
ERIC.GELINAS,20152016,COL,76.15,0,0,0,0,0,0,0,0,0,10,15,10,2,1,0,70,72,53,68,4,1,0,30228031.16
ERIC.GELINAS,20152016,N.J,477.23333333333335,1,3,2,5,6,4,0,0,0,44,102,51,37,1,8,414,326,331,306,9,14,0,30228052.36
ERIC.GRYBA,20152016,EDM,947.7666666666667,1,2,1,3,4,3,0,0,0,58,143,132,56,13,30,782,1005,747,761,26,29,0,30228097.905
ERIC.NYSTROM,20152016,NSH,537.6,7,0,0,0,7,7,1,2,1,27,50,93,14,4,8,344,500,323,400,7,16,0.5,30228072.23
ERIC.SELLECK,20152016,ARI,9.55,0,0,0,0,0,0,0,0,0,1,1,3,0,1,1,8,11,8,11,0,0,0,15114013.46
ERIC.STAAL,20152016,CAR,1215.0166666666669,10,14,9,23,33,24,323,601,278,158,295,55,60,15,16,1449,876,1019,788,35,35,0.5374376039933444,30228113.495
ERIC.STAAL,20152016,NYR,405.48333333333335,3,2,1,3,6,5,169,315,146,47,91,28,22,8,3,387,388,298,299,9,11,0.5365079365079365,30228061.064999998
ERIC.TANGRADI,20152016,DET,6.916666666666667,0,0,0,0,0,0,0,1,1,0,0,1,0,0,0,7,4,7,4,0,0,0,15114012.3
ERIK.CONDRA,20152016,T.B,593.2666666666667,6,3,2,5,11,9,1,3,2,58,99,21,22,9,17,501,497,481,403,19,24,0.3333333333333333,30228065.880000003
ERIK.GUDBRANSON,20152016,FLA,1448.5666666666666,2,3,2,5,7,5,0,0,0,80,177,165,59,17,21,1023,1477,946,1054,38,37,0,30228130.770000003
ERIK.GUSTAFSSON,20152016,CHI,690.1500000000001,0,7,7,14,14,7,0,0,0,63,143,31,53,3,2,739,557,617,531,30,21,0,30228068.205
ERIK.HAULA,20152016,MIN,1058.5500000000002,15,15,8,23,38,30,457,870,413,111,185,73,42,11,13,736,1104,659,807,42,27,0.5252873563218391,30228142.54
ERIK.JOHNSON,20152016,COL,1711.3,11,8,7,15,26,19,0,1,1,175,307,126,81,14,18,1409,1886,1047,1322,40,52,0,30228176.064999998
ERIK.KARLSSON,20152016,OTT,2375.9166666666665,16,35,31,66,82,51,0,1,1,247,585,84,206,16,26,2508,1958,1659,1550,77,77,0,30228180.335
ESA.LINDELL,20152016,DAL,56.18333333333333,0,0,0,0,0,0,0,0,0,2,9,4,5,0,0,56,57,54,52,1,4,0,30228028.299999997
EVAN.RODRIGUES,20152016,BUF,23.5,1,0,1,1,2,1,0,0,0,8,12,3,2,0,0,34,12,31,12,1,0,0,30228024.975
EVANDER.KANE,20152016,BUF,1367.4166666666665,20,9,5,14,34,29,62,124,62,271,473,171,111,32,34,1373,1170,978,951,26,46,0.5,30228137.975
EVGENI.MALKIN,20152016,PIT,1506.7166666666667,33,26,15,41,74,59,427,981,554,234,413,47,100,31,37,1831,1076,1142,925,43,36,0.4352701325178389,30228163.715000004
EVGENY.KUZNETSOV,20152016,WSH,1637.4166666666665,21,43,15,58,79,64,629,1312,683,232,385,92,84,26,20,1829,1322,1343,1197,65,50,0.4794207317073171,30228196.245
EVGENY.MEDVEDEV,20152016,PHI,847.2833333333333,4,4,4,8,12,8,0,0,0,71,189,38,74,7,17,839,710,690,606,27,24,0,30228076.72
FEDOR.TYUTIN,20152016,CBJ,1073,1,2,0,2,3,3,0,0,0,25,78,128,33,7,13,828,987,775,754,29,38,0,30228094.12
FILIP.FORSBERG,20152016,NSH,1841.95,35,15,18,33,68,50,3,12,9,285,569,146,138,39,16,2002,1533,1418,1133,57,52,0.25,30228145.36
FRANCOIS.BEAUCHEMIN,20152016,COL,2056.55,8,6,17,23,31,14,0,0,0,127,264,78,85,7,19,1612,2267,1204,1590,47,54,0,30228201.945
FRANK.CORRADO,20152016,TOR,563.7,1,2,2,4,5,3,0,0,0,46,112,46,38,6,13,573,482,518,428,17,28,0,30228060.310000002
FRANK.VATRANO,20152016,BOS,463.33333333333337,8,2,1,3,11,10,0,3,3,99,150,61,26,5,7,415,399,377,389,13,18,0,30228070.625
FRANS.NIELSEN,20152016,NYI,1674.0166666666667,23,16,19,35,58,39,662,1309,647,206,365,54,77,15,7,1731,1519,1106,1077,39,40,0.5057295645530939,30228176.405
FREDDIE.HAMILTON,20152016,CGY,50.800000000000004,1,1,0,1,2,2,12,21,9,7,10,8,3,0,0,50,44,49,37,1,1,0.5714285714285714,30228028.43
FREDERIK.GAUTHIER,20152016,TOR,96.91666666666667,0,1,0,1,1,1,52,110,58,3,7,10,0,2,0,57,114,50,74,1,8,0.4727272727272727,30228035.55
FREDRIK.CLAESSON,20152016,OTT,308.6333333333333,0,0,2,2,2,0,0,0,0,15,35,33,14,0,1,248,285,241,241,6,11,0,30228046.15
GABRIEL.BOURQUE,20152016,NSH,272.01666666666665,1,2,1,3,4,3,0,1,1,25,42,55,9,5,5,205,282,181,188,7,8,0,30228044.725
GABRIEL.LANDESKOG,20152016,COL,1419.4333333333334,20,18,11,29,49,38,31,56,25,170,250,141,39,23,28,1334,1355,882,1057,40,39,0.5535714285714286,30228165.195
GARNET.HATHAWAY,20152016,CGY,168.25,0,3,0,3,3,3,1,4,3,11,19,50,3,10,10,134,152,128,128,4,4,0.25,30228039.69
GARRETT.WILSON,20152016,FLA,325.26666666666665,0,0,0,0,0,0,0,1,1,32,53,98,9,7,12,265,250,258,247,4,8,0,30228049.72
GREG.MCKEGG,20152016,FLA,129.89999999999998,2,0,0,0,2,2,51,114,63,15,25,21,6,1,2,91,125,88,116,3,2,0.4473684210526316,30228040.75
GREG.PATERYN,20152016,MTL,636.35,1,5,1,6,7,6,0,0,0,32,85,100,37,8,12,501,594,480,485,17,25,0,30228071.655
GREGORY.CAMPBELL,20152016,CBJ,866.4333333333334,3,3,5,8,11,6,229,482,253,57,114,100,31,17,22,545,1031,512,731,17,23,0.475103734439834,30228121.655
GRIFFIN.REINHART,20152016,EDM,523.9833333333333,0,0,1,1,1,0,0,0,0,24,61,62,27,4,8,420,538,390,453,15,21,0,30228068.665
GUSTAV.NYQUIST,20152016,DET,1328.2333333333331,18,17,9,26,44,35,0,2,2,172,285,69,67,17,19,1436,864,930,772,40,36,0,30228111.595
GUSTAV.OLOFSSON,20152016,MIN,18.383333333333333,0,0,0,0,0,0,0,0,0,1,5,2,2,0,0,13,15,13,15,0,0,0,30228025.35
HAMPUS.LINDHOLM,20152016,ANA,1925.1333333333332,10,8,13,21,31,18,0,0,0,163,343,80,115,16,19,1939,1540,1478,1105,47,40,0,30228115.085
HARRY.ZOLNIERCZYK,20152016,ANA,8.8,0,0,0,0,0,0,0,0,0,1,1,3,0,1,0,11,8,10,8,0,1,0,15114012.76
HENRIK.SEDIN,20152016,VAN,1360.0333333333333,11,30,14,44,55,41,620,1347,727,99,157,9,27,11,12,1398,1056,853,878,37,32,0.4602821083890126,30228165.71
HENRIK.ZETTERBERG,20152016,DET,1689.65,14,21,16,37,51,35,569,1132,563,227,420,62,108,18,14,1781,1275,1142,1099,41,45,0.5026501766784452,30228168.04
HUDSON.FASCHING,20152016,BUF,80.65,1,1,0,1,2,2,0,0,0,9,15,8,1,1,2,65,58,65,57,4,1,0,30228030.56
HUNTER.SHINKARUK,20152016,CGY,110.13333333333334,2,0,1,1,3,2,0,1,1,12,23,8,4,2,1,103,84,78,79,1,5,0,30228033.494999997
HUNTER.SHINKARUK,20152016,VAN,9.583333333333334,0,0,0,0,0,0,0,0,0,0,0,1,0,0,0,3,6,3,6,0,0,0,15114012.75
IAN.COLE,20152016,PIT,1595.8333333333333,1,5,9,14,15,6,0,0,0,88,193,171,62,14,35,1331,1641,1241,1229,44,47,0,30228144.315
IIRO.PAKARINEN,20152016,EDM,676.8,5,5,3,8,13,10,5,13,8,76,140,152,32,7,4,504,654,446,526,13,22,0.38461538461538464,30228085.145
J.T..BROWN,20152016,T.B,1137.3999999999999,8,11,5,16,24,19,24,51,27,146,252,125,53,23,19,951,1100,896,848,37,24,0.47058823529411764,30228116.415
J.T..MILLER,20152016,NYR,1313.7,22,14,10,24,46,36,71,165,94,139,264,196,69,16,19,1278,1141,1027,1035,47,39,0.4303030303030303,30228148.3
JACCOB.SLAVIN,20152016,CAR,1322.1833333333334,2,7,9,16,18,9,0,0,0,84,185,41,60,11,4,1155,1172,997,965,37,40,0,30228115.185
JACK.EICHEL,20152016,BUF,1548.85,24,22,10,32,56,46,401,979,578,237,433,43,106,26,10,1554,1329,992,1132,39,50,0.40960163432073543,30228190.6
JACK.JOHNSON,20152016,CBJ,1450.5166666666667,6,3,5,8,14,9,0,1,1,86,205,98,68,6,11,1225,1466,909,1052,32,41,0,30228133.634999998
JACK.SKILLE,20152016,COL,653.5833333333334,8,6,0,6,14,14,4,19,15,105,175,97,32,10,5,498,697,471,657,18,22,0.21052631578947367,30228107.21
JACOB.DE LA ROSE,20152016,MTL,273.56666666666666,0,1,0,1,1,1,67,130,63,20,45,39,13,2,3,179,299,171,236,6,12,0.5153846153846153,30228052.5
JACOB.JOSEFSON,20152016,N.J,900.2833333333333,4,3,7,10,14,7,323,667,344,86,147,67,27,14,10,767,652,480,470,5,21,0.48425787106446777,30228090.585
JACOB.TROUBA,20152016,WPG,1787.3833333333332,6,9,5,14,20,15,0,1,1,133,283,144,106,14,24,1558,1727,1319,1221,56,45,0,30228136.865000002
JADEN.SCHWARTZ,20152016,STL,930.3999999999999,12,14,9,23,35,26,40,83,43,99,175,75,37,7,7,929,771,706,632,25,23,0.4819277108433735,30228098.795
JAKE.GARDINER,20152016,TOR,1629.0500000000002,7,11,13,24,31,18,2,2,0,122,320,86,112,5,17,1831,1323,1363,1185,43,53,1,30228130.955
JAKE.MCCABE,20152016,BUF,1471.2666666666667,4,7,2,9,13,11,0,2,2,62,146,114,52,14,15,1159,1423,1058,1175,41,44,0,30228145.79
JAKE.MUZZIN,20152016,L.A,2018.75,9,15,17,32,41,24,0,0,0,220,489,215,170,8,28,2255,1728,1654,1240,53,51,0,30228124.955
JAKE.VIRTANEN,20152016,VAN,636.0166666666667,7,5,1,6,13,12,2,5,3,94,174,128,38,13,12,558,491,491,472,20,26,0.4,30228076.035
JAKOB.SILFVERBERG,20152016,ANA,1510.3833333333332,20,14,9,23,43,34,4,21,17,230,390,97,78,18,19,1390,1469,1127,982,37,41,0.19047619047619047,30228135.415
JAKUB.KINDL,20152016,DET,411.56666666666666,2,2,2,4,6,4,0,0,0,37,86,13,28,0,7,403,294,327,266,9,9,0,30228047.55
JAKUB.KINDL,20152016,FLA,278.08333333333337,0,0,2,2,2,0,0,1,1,26,51,28,15,1,2,287,227,270,218,19,10,0,30228039.91
JAKUB.NAKLADAL,20152016,CGY,383.1333333333333,2,1,2,3,5,3,0,0,0,42,88,41,29,5,3,369,285,305,269,11,10,0,30228047.8
JAKUB.VORACEK,20152016,PHI,1464.1166666666668,12,27,17,44,56,39,4,8,4,229,416,59,114,23,20,1811,1153,1080,986,36,34,0.5,30228134.765
JAMES.NEAL,20152016,NSH,1864.6833333333334,35,23,8,31,66,58,8,29,21,315,580,148,144,32,35,2050,1428,1467,1285,64,40,0.27586206896551724,30228172.240000002
JAMES.VAN RIEMSDYK,20152016,TOR,710.5166666666667,14,10,5,15,29,24,1,2,1,129,228,52,50,6,3,904,561,610,507,23,19,0.5,30228081.275
JAMES.WISNIEWSKI,20152016,CAR,0.7833333333333333,0,0,0,0,0,0,0,0,0,0,0,1,0,0,0,0,0,0,0,0,0,0,15114012
JAMIE.BENN,20152016,DAL,1919.5500000000002,46,28,29,57,103,74,242,506,264,279,494,187,106,36,31,2204,1713,1444,1267,69,68,0.4782608695652174,30228195.115000002
JAMIE.MCBAIN,20152016,L.A,581.8333333333333,2,3,4,7,9,5,0,0,0,34,87,22,31,1,4,659,444,550,426,16,14,0,30228059.009999998
JAMIE.MCGINN,20152016,ANA,378.9666666666667,10,3,1,4,14,13,3,5,2,52,91,66,13,4,7,387,300,273,286,12,13,0.6,30228061.985
JAMIE.MCGINN,20152016,BUF,892.3499999999999,14,5,8,13,27,19,2,3,1,109,172,113,24,8,5,870,700,568,640,25,31,0.6666666666666666,30228103.71
JAMIE.OLEKSIAK,20152016,DAL,241.59999999999997,0,1,1,2,2,1,0,0,0,13,28,54,9,5,5,220,227,212,208,6,11,0,30228044.425
JANNIK.HANSEN,20152016,VAN,1101.0833333333333,22,12,4,16,38,34,6,21,15,117,190,39,34,15,15,867,1049,716,785,45,29,0.2857142857142857,30228125.34
JARED.BOLL,20152016,CBJ,199.5,1,1,1,2,3,2,2,2,0,11,22,53,6,12,16,116,229,116,227,5,7,1,30228054.975
JARED.COWEN,20152016,OTT,628.2333333333333,0,2,1,3,3,2,0,0,0,23,63,116,28,4,8,445,738,409,539,20,18,0,30228080.765
JARED.MCCANN,20152016,VAN,864.0166666666667,9,4,5,9,18,13,181,522,341,106,199,45,57,16,15,788,779,659,728,24,29,0.34674329501915707,30228119.925
JARED.SPURGEON,20152016,MIN,1902.2666666666664,13,10,10,20,33,23,0,0,0,132,270,61,80,10,9,1732,1762,1321,1365,61,54,0,30228164.95
JAROME.IGINLA,20152016,COL,1300.65,22,16,9,25,47,38,61,115,54,182,342,70,101,16,16,1295,1200,810,1100,35,45,0.5304347826086957,30228166.725
JAROMIR.JAGR,20152016,FLA,1479.95,27,22,19,41,68,49,0,1,1,163,290,34,53,12,25,1507,1114,1095,1033,68,43,0,30228150.545
JARRED.TINORDI,20152016,ARI,103.68333333333334,0,0,0,0,0,0,0,0,0,3,10,17,2,3,3,70,112,64,87,2,3,0,30228033.88
JARRED.TINORDI,20152016,MTL,39.300000000000004,0,0,0,0,0,0,0,0,0,0,0,5,0,1,1,32,41,31,39,1,4,0,15114016.31
JARRET.STOLL,20152016,MIN,611.05,3,0,3,3,6,3,336,605,269,25,44,64,8,7,10,321,744,297,530,9,13,0.5553719008264463,30228101.335
JARRET.STOLL,20152016,NYR,399.6,1,1,1,2,3,2,158,273,115,26,37,58,4,3,10,213,427,195,309,8,5,0.5787545787545788,30228067.125
JASON.CHIMERA,20152016,WSH,1308.0500000000002,21,15,6,21,42,36,9,29,20,182,280,125,54,13,17,1205,1229,933,1027,37,41,0.3103448275862069,30228153.840000004
JASON.DEMERS,20152016,DAL,1543.5166666666667,7,13,6,19,26,20,0,0,0,111,272,103,91,9,28,1509,1479,1231,1073,47,40,0,30228125.04
JASON.DICKINSON,20152016,DAL,11.916666666666666,1,0,0,0,1,1,1,7,6,2,3,0,1,0,0,11,13,11,13,1,0,0.14285714285714285,15114014.19
JASON.GARRISON,20152016,T.B,1660.6333333333332,6,5,7,12,18,11,0,0,0,137,273,108,70,2,14,1397,1589,1184,1198,50,49,0,30228142.945
JASON.POMINVILLE,20152016,MIN,1322.85,15,11,17,28,43,26,41,90,49,203,309,36,52,9,6,1453,1096,1062,991,45,35,0.45555555555555555,30228136.005000003
JASON.SPEZZA,20152016,DAL,1467.4166666666667,38,21,16,37,75,59,632,1178,546,236,459,12,122,13,12,1873,1176,1263,1041,53,37,0.5365025466893039,30228164.810000002
JASON.ZUCKER,20152016,MIN,1189.7333333333333,13,8,4,12,25,21,1,1,0,161,292,90,51,23,11,1049,1020,847,903,33,41,1,30228128.22
JAY.BEAGLE,20152016,WSH,957.2333333333333,11,5,4,9,20,16,464,811,347,90,146,75,17,12,13,722,979,674,718,22,18,0.5721331689272503,30228122.18
JAY.BOUWMEESTER,20152016,STL,2156.833333333333,3,10,8,18,21,13,0,0,0,125,282,99,100,8,18,1709,2258,1538,1626,57,56,0,30228184.68
JAY.MCCLEMENT,20152016,CAR,893.4833333333333,3,7,1,8,11,10,375,678,303,64,107,79,20,7,12,610,888,574,663,19,34,0.5530973451327433,30228111.395
JAYSON.MEGNA,20152016,NYR,73.48333333333332,1,0,1,1,2,1,1,1,0,9,21,6,6,1,1,79,61,63,61,2,3,1,30228030.175
JC.LIPON,20152016,WPG,62.7,0,0,1,1,1,0,0,0,0,4,7,29,3,1,1,50,46,50,46,1,1,0,30228028.235
JEAN-GABRIEL.PAGEAU,20152016,OTT,1369.65,19,14,9,23,42,33,614,1177,563,133,211,166,46,17,9,1119,1404,922,1029,41,36,0.5216652506372133,30228171.055
JEFF.CARTER,20152016,L.A,1509.1666666666665,26,20,17,37,63,46,642,1317,675,254,475,109,103,15,12,1774,1332,1220,965,42,40,0.4874715261958998,30228158.455
JEFF.PETRY,20152016,MTL,1089.1666666666665,5,5,4,9,14,10,1,1,0,98,233,86,91,3,8,1040,937,808,682,23,31,1,30228081.47
JEFF.SCHULTZ,20152016,L.A,18.25,0,0,0,0,0,0,0,0,0,1,1,0,0,1,0,13,17,9,10,0,1,0,15114013.11
JEFF.SKINNER,20152016,CAR,1335.4833333333333,28,20,3,23,51,48,20,47,27,258,435,21,97,28,16,1430,1085,1035,1003,48,46,0.425531914893617,30228148.505000003
JEREMY.WELSH,20152016,STL,16.616666666666667,0,0,0,0,0,0,1,3,2,0,1,4,1,0,1,17,7,17,7,0,0,0.3333333333333333,15114012.29
JESPER.FAST,20152016,NYR,1250.2666666666667,10,11,10,21,31,21,1,6,5,81,155,128,34,16,9,982,1328,902,947,38,35,0.16666666666666666,30228129.75
JIM.O'BRIEN,20152016,N.J,54.06666666666666,0,0,0,0,0,0,29,49,20,3,5,7,2,2,1,30,41,28,40,0,3,0.5918367346938775,30228029.33
JIMMY.HAYES,20152016,BOS,1036.9833333333333,13,5,11,16,29,18,42,112,70,126,184,128,24,13,22,945,924,764,891,31,43,0.375,30228136.685
JIRI.HUDLER,20152016,CGY,882.0666666666666,10,13,12,25,35,23,9,20,11,80,133,14,29,13,7,915,669,591,622,33,34,0.45,30228099.14
JIRI.HUDLER,20152016,FLA,342.2,6,5,1,6,12,11,2,7,5,34,58,21,9,3,7,320,286,242,270,13,16,0.2857142857142857,30228059.134999998
JIRI.SEKAC,20152016,ANA,268.0333333333333,1,0,2,2,3,1,0,2,2,29,52,18,13,4,2,258,173,203,164,3,3,0,30228038.79
JIRI.SEKAC,20152016,ARI,126.51666666666667,0,1,1,2,2,1,2,2,0,9,16,25,4,1,1,117,115,111,112,1,6,1,30228035.715
JIRI.SEKAC,20152016,CHI,60.35000000000001,0,1,0,1,1,1,0,0,0,11,18,7,5,1,1,51,38,45,38,1,2,0,30228027.810000002
JIRI.TLUSTY,20152016,N.J,411.35,2,2,0,2,4,4,0,0,0,38,64,39,14,3,3,301,322,266,284,6,6,0,30228055.18
JOAKIM.ANDERSSON,20152016,DET,294.5333333333333,1,1,2,3,4,2,35,80,45,21,34,15,5,3,3,197,282,190,194,6,6,0.4375,30228046.78
JOAKIM.NORDSTROM,20152016,CAR,1109.4333333333334,10,8,6,14,24,18,6,10,4,81,171,98,37,17,6,864,1013,810,820,28,32,0.6,30228113.86
JOE.COLBORNE,20152016,CGY,1107.0833333333333,19,15,10,25,44,34,85,155,70,100,163,122,34,7,11,1106,983,808,869,44,47,0.5483870967741935,30228133.92
JOE.MORROW,20152016,BOS,524.9666666666667,1,3,3,6,7,4,0,0,0,44,81,28,28,2,2,477,496,393,446,20,24,0,30228069.145
JOE.PAVELSKI,20152016,S.J,2123.55,52,31,18,49,101,83,692,1275,583,298,522,212,100,25,16,2569,1684,1644,1365,79,42,0.5427450980392157,30228214.28
JOE.THORNTON,20152016,S.J,1977.5166666666664,22,43,37,80,102,65,526,1000,474,155,287,78,59,23,27,2492,1454,1572,1258,80,38,0.526,30228185.545
JOE.VITALE,20152016,ARI,6.216666666666667,0,0,0,0,0,0,0,1,1,1,2,1,0,3,1,8,8,7,6,1,0,0,15114012.68
JOEL.ARMIA,20152016,WPG,522.9333333333334,4,3,3,6,10,7,0,2,2,52,97,59,28,7,6,449,429,402,396,14,16,0,30228065.345
JOEL.EDMUNDSON,20152016,STL,1175.3,2,4,4,8,10,6,0,0,0,105,208,205,60,17,30,1063,1048,1038,924,29,38,0,30228111.17
JOEL.HANLEY,20152016,MTL,159.98333333333335,0,3,1,4,4,3,0,0,0,10,17,6,2,2,1,121,141,113,121,8,8,0,30228037.395
JOEL.VERMIN,20152016,T.B,54.83333333333334,0,0,1,1,1,0,1,1,0,1,5,6,2,0,0,44,35,36,33,2,1,1,30228026.665
JOEL.WARD,20152016,S.J,1721.7166666666667,28,18,9,27,55,46,291,631,340,173,292,104,53,10,21,1639,1514,1218,1165,47,50,0.4611727416798732,30228179.015
JOFFREY.LUPUL,20152016,TOR,672.5666666666667,11,2,1,3,14,13,0,4,4,102,178,58,29,8,7,737,592,467,546,13,23,0,30228091.555
JOHAN.FRANZEN,20152016,DET,25.9,0,1,0,1,1,1,0,1,1,3,6,3,1,0,1,21,24,19,23,0,0,0,30228027.25
JOHAN.LARSSON,20152016,BUF,1096.65,10,5,2,7,17,15,388,759,371,95,191,113,47,17,12,955,1012,806,914,25,27,0.5111989459815547,30228141.29
JOHN-MICHAEL.LILES,20152016,BOS,328.51666666666665,0,4,2,6,6,4,0,0,0,19,28,17,5,1,1,303,322,258,258,11,15,0,30228050.86
JOHN-MICHAEL.LILES,20152016,CAR,1316.0833333333335,6,4,5,9,15,10,0,0,0,92,204,64,77,8,8,1230,1049,951,854,31,34,0,30228101.005
JOHN.CARLSON,20152016,WSH,1650.0166666666669,13,19,18,37,50,32,0,0,0,173,355,70,107,12,9,1775,1541,1187,1137,47,35,0,30228143.12
JOHN.KLINGBERG,20152016,DAL,2046.3333333333335,11,22,27,49,60,33,0,0,0,190,430,59,165,16,17,2531,1695,1853,1456,78,62,0,30228147.335
JOHN.MCCARTHY,20152016,S.J,7.083333333333333,0,0,0,0,0,0,0,1,1,0,0,0,0,0,0,0,14,0,14,0,0,0,15114014.15
JOHN.MCFARLAND,20152016,FLA,29.733333333333334,0,0,0,0,0,0,0,0,0,2,4,5,0,0,0,15,31,14,31,0,1,0,15114016.05
JOHN.MITCHELL,20152016,COL,1082.4499999999998,10,4,7,11,21,14,415,849,434,101,165,85,34,13,20,756,1183,624,858,22,30,0.48881036513545345,30228148.555
JOHN.MOORE,20152016,N.J,1448.1833333333334,4,7,8,15,19,11,0,0,0,106,218,93,65,3,14,1029,1364,795,1024,35,46,0,30228137.53
JOHN.RAMAGE,20152016,CBJ,14.15,0,0,0,0,0,0,0,0,0,0,0,0,0,0,0,7,16,7,16,0,2,0,15114014.05
JOHN.SCOTT,20152016,ARI,69.31666666666666,0,1,0,1,1,1,0,0,0,6,6,20,0,5,7,46,48,43,45,1,1,0,30228030.4
JOHN.SCOTT,20152016,MTL,9.016666666666666,0,0,0,0,0,0,0,0,0,0,0,3,0,0,1,5,5,4,5,0,1,0,15114012.7
JOHN.TAVARES,20152016,NYI,1811.3333333333335,39,34,8,42,81,73,864,1587,723,290,528,64,139,33,20,2057,1515,1417,1335,57,50,0.5444234404536862,30228215.939999998
JOHNNY.BOYCHUK,20152016,NYI,1736.9666666666667,9,6,7,13,22,15,0,0,0,186,403,198,136,12,16,1509,1734,1290,1376,51,44,0,30228159.795
JOHNNY.GAUDREAU,20152016,CGY,1573.3166666666666,30,30,16,46,76,60,1,4,3,216,370,26,84,29,9,1721,1257,1097,1105,57,51,0.25,30228165.03
JOHNNY.ODUYA,20152016,DAL,1913.4166666666667,5,9,10,19,24,14,0,0,0,75,223,85,88,14,14,1622,1964,1495,1435,53,59,0,30228158.54
JON.MERRILL,20152016,N.J,794.1333333333334,1,2,1,3,4,3,0,0,0,30,57,48,15,5,14,534,683,502,580,21,35,0,30228086.025
JONAS.BRODIN,20152016,MIN,1512.0833333333335,3,4,3,7,10,7,0,0,0,59,146,36,55,4,9,1050,1526,972,1222,35,38,0,30228154.065
JONATHAN.DROUIN,20152016,T.B,592.8666666666667,9,10,5,15,24,19,15,29,14,60,119,57,34,9,10,588,478,427,441,21,16,0.5172413793103449,30228077.865000002
JONATHAN.ERICSSON,20152016,DET,1402.4,3,7,4,11,14,10,0,0,0,71,161,127,47,18,25,1034,1379,967,996,44,40,0,30228125.130000003
JONATHAN.HUBERDEAU,20152016,FLA,1519.9666666666667,21,19,20,39,60,40,9,24,15,209,322,59,55,33,24,1470,1218,1057,1073,62,41,0.375,30228156.240000002
JONATHAN.MARCHESSAULT,20152016,T.B,579.5333333333333,7,4,8,12,19,11,40,84,44,88,144,69,26,18,12,622,405,425,370,14,20,0.47619047619047616,30228068.13
JONATHAN.TOEWS,20152016,CHI,1697.5333333333333,27,20,15,35,62,47,1030,1755,725,195,300,92,53,39,28,1761,1483,1229,1163,44,42,0.5868945868945868,30228193.765
JOONAS.DONSKOI,20152016,S.J,1448.5666666666666,17,21,10,31,48,38,2,3,1,142,254,53,55,20,10,1466,1163,1222,1081,55,46,0.6666666666666666,30228141.58
JOONAS.KEMPPAINEN,20152016,BOS,551.6666666666667,2,2,1,3,5,4,226,458,232,35,52,36,10,0,1,383,619,357,488,12,18,0.49344978165938863,30228089.865000002
JORDAN.CARON,20152016,STL,32.5,0,0,0,0,0,0,0,0,0,1,2,6,1,0,0,21,26,21,26,0,3,0,30228026.75
JORDAN.EBERLE,20152016,EDM,1232.0666666666666,25,12,10,22,47,37,5,8,3,173,296,28,63,19,6,1367,1041,970,933,39,47,0.625,30228134.84
JORDAN.MARTINOOK,20152016,ARI,1230.45,9,12,3,15,24,21,18,33,15,109,207,52,45,14,9,887,1266,802,895,26,36,0.5454545454545454,30228128.134999998
JORDAN.NOLAN,20152016,L.A,462.65,0,3,2,5,5,3,0,1,1,49,97,78,23,10,16,419,419,418,413,11,11,0,30228066.75
JORDAN.OESTERLE,20152016,EDM,367.4,0,3,1,4,4,3,0,0,0,24,51,10,19,0,0,324,314,245,259,12,10,0,30228048.875
JORDAN.SCHROEDER,20152016,MIN,267.9,3,1,1,2,5,4,1,3,2,32,51,15,11,0,1,215,256,206,256,10,9,0.3333333333333333,30228053.515
JORDAN.STAAL,20152016,CAR,1500.65,20,20,8,28,48,40,806,1394,588,151,271,165,54,20,16,1444,1182,1037,892,36,35,0.5781922525107605,30228149.54
JORDAN.WEAL,20152016,L.A,81.16666666666667,0,0,0,0,0,0,20,44,24,1,5,2,1,2,1,66,64,63,60,1,1,0.45454545454545453,30228030.77
JORDAN.WEAL,20152016,PHI,49.900000000000006,0,0,0,0,0,0,13,24,11,3,6,3,1,0,0,37,47,28,43,1,0,0.5416666666666666,30228029.32
JORDIE.BENN,20152016,DAL,1014.1333333333333,3,6,2,8,11,9,0,0,0,58,126,90,44,7,11,850,1048,780,813,37,34,0,30228104.97
JORDIN.TOOTOO,20152016,N.J,760.8333333333333,4,3,2,5,9,7,0,2,2,90,141,98,20,22,28,573,557,458,527,6,26,0,30228089.87
JORI.LEHTERA,20152016,STL,1583.8666666666668,12,16,15,31,43,28,610,1214,604,112,176,57,43,14,22,1504,1325,1189,1092,58,40,0.5024711696869851,30228164.665
JOSEPH.BLANDISI,20152016,N.J,639.7,5,8,3,11,16,13,11,33,22,43,81,39,16,15,18,536,497,381,457,14,24,0.3333333333333333,30228083.115000002
JOSH.ANDERSON,20152016,CBJ,128.38333333333333,1,0,3,3,4,1,0,0,0,11,22,40,6,1,1,97,124,93,122,5,4,0,30228037.634999998
JOSH.ARCHIBALD,20152016,PIT,5.033333333333333,0,0,0,0,0,0,0,0,0,0,1,1,1,0,0,1,7,1,7,0,0,0,15114012.85
JOSH.BAILEY,20152016,NYI,1429.3,14,11,10,21,35,25,16,42,26,122,214,54,49,10,12,1311,1334,1096,1187,39,50,0.38095238095238093,30228159.79
JOSH.GORGES,20152016,BUF,1575.8166666666666,2,2,6,8,10,4,0,0,0,57,139,143,49,10,29,1170,1676,1103,1312,37,50,0,30228163
JOSH.JOORIS,20152016,CGY,725.0166666666667,4,3,5,8,12,7,114,256,142,80,129,62,29,10,17,568,748,517,569,17,20,0.4453125,30228094.035
JOSH.LEIVO,20152016,TOR,147.8,5,0,0,0,5,5,1,2,1,20,38,7,9,0,3,166,106,107,92,5,4,0.5,30228035.34
JOSH.MANSON,20152016,ANA,1338.2833333333333,5,3,5,8,13,8,0,0,0,89,171,160,43,20,23,1169,1126,1092,830,40,33,0,30228095.075
JOSHUA.MORRISSEY,20152016,WPG,15.899999999999999,0,0,0,0,0,0,0,0,0,1,1,1,0,0,0,9,12,9,12,0,0,0,15114013.4
JUJHAR.KHAIRA,20152016,EDM,155.31666666666666,0,2,0,2,2,2,0,1,1,14,30,29,10,2,5,135,157,135,157,5,7,0,30228041.17
JULIAN.MELCHIORI,20152016,WPG,149.55,0,0,0,0,0,0,0,0,0,12,21,18,5,2,0,111,144,107,132,5,4,0,30228037.57
JUSSI.JOKINEN,20152016,FLA,1628.6,19,25,20,45,64,44,138,272,134,160,262,52,53,15,18,1503,1369,1026,886,58,28,0.5073529411764706,30228133.67
JUSTIN.ABDELKADER,20152016,DET,1607.45,20,17,5,22,42,37,5,15,10,164,250,225,32,48,56,1504,1324,946,969,36,46,0.3333333333333333,30228153.105
JUSTIN.BAILEY,20152016,BUF,92.81666666666666,0,0,0,0,0,0,0,0,0,22,28,8,3,1,1,85,92,80,92,2,4,0,30228034.310000002
JUSTIN.BRAUN,20152016,S.J,2157.8333333333335,6,13,11,24,30,19,0,0,0,142,320,122,124,10,21,1761,2041,1595,1509,71,62,0,30228163.875
JUSTIN.FALK,20152016,CBJ,341.41666666666663,0,4,0,4,4,4,0,0,0,16,44,36,19,8,6,291,371,285,337,15,14,0,30228059.18
JUSTIN.FAULK,20152016,CAR,1538.75,16,10,9,19,35,26,0,1,1,184,395,109,137,8,12,1575,1311,1112,1015,39,54,0,30228122.755
JUSTIN.FONTAINE,20152016,MIN,764.7,5,7,4,11,16,12,1,5,4,58,102,11,18,11,10,518,757,476,608,27,26,0.2,30228097
JUSTIN.SCHULTZ,20152016,EDM,902.6,3,2,4,6,9,5,0,2,2,59,133,29,45,6,7,822,831,627,667,23,35,0,30228090.16
JUSTIN.SCHULTZ,20152016,PIT,451.3166666666667,1,7,4,11,12,8,0,0,0,50,96,20,19,3,1,495,372,380,348,20,12,0,30228058.88
JUSTIN.WILLIAMS,20152016,WSH,1551.05,25,17,17,34,59,42,63,120,57,231,375,44,68,15,24,1690,1350,1261,1136,59,51,0.525,30228157.945
JYRKI.JOKIPAKKA,20152016,CGY,322.2833333333333,0,2,4,6,6,2,0,0,0,19,33,22,12,1,4,229,299,210,228,10,8,0,30228047.36
JYRKI.JOKIPAKKA,20152016,DAL,580.1333333333333,2,4,0,4,6,6,0,0,0,26,65,47,27,4,3,523,558,503,504,24,23,0,30228072.19
KAEL.MOUILLIERAT,20152016,PIT,10.683333333333334,0,0,0,0,0,0,5,11,6,1,1,4,0,0,0,4,8,4,8,0,0,0.45454545454545453,15114013.3
KARL.ALZNER,20152016,WSH,2009.35,4,8,8,16,20,12,0,0,0,89,218,157,80,7,16,1600,2071,1494,1496,55,46,0,30228168.17
KASPERI.KAPANEN,20152016,TOR,133.01666666666665,0,0,0,0,0,0,0,0,0,14,23,10,6,1,1,148,104,104,100,0,3,0,30228033.76
KEITH.YANDLE,20152016,NYR,1740.5,6,23,15,38,44,29,0,0,0,176,399,45,133,11,21,1811,1419,1322,1278,54,45,0,30228151.585
KENNY.AGOSTINO,20152016,CGY,27.1,0,0,0,0,0,0,0,0,0,3,3,3,0,0,0,27,19,22,18,0,1,0,15114013.75
KERBY.RYCHEL,20152016,CBJ,304.45,2,6,1,7,9,8,1,3,2,32,55,39,12,3,6,234,284,232,281,13,7,0.3333333333333333,30228058.195
KEVAN.MILLER,20152016,BOS,1353.1666666666665,5,6,6,12,17,11,0,0,0,64,145,164,45,12,18,1085,1355,1022,1029,50,42,0,30228126.270000003
KEVIN.BIEKSA,20152016,ANA,1610.05,4,7,5,12,16,11,0,0,0,120,271,160,88,18,32,1501,1558,1248,1214,39,48,0,30228142.655
KEVIN.CONNAUTON,20152016,ARI,667.1666666666666,4,2,2,4,8,6,0,0,0,65,144,76,52,7,13,633,725,532,634,18,18,0,30228091.32
KEVIN.CONNAUTON,20152016,CBJ,420.8,1,0,6,6,7,1,0,0,0,44,86,24,26,8,9,389,347,316,317,19,10,0,30228053.78
KEVIN.FIALA,20152016,NSH,65.76666666666667,1,0,0,0,1,1,0,0,0,11,19,2,3,1,0,78,53,72,53,1,1,0,30228029.009999998
KEVIN.GRAVEL,20152016,L.A,58.38333333333333,0,0,0,0,0,0,0,0,0,2,12,4,4,0,0,54,47,44,44,2,3,0,15114015.6
KEVIN.HAYES,20152016,NYR,1111.8166666666666,14,14,8,22,36,28,138,385,247,136,252,65,59,10,13,1054,951,838,877,41,29,0.35844155844155845,30228136.57
KEVIN.KLEIN,20152016,NYR,1501.6666666666667,9,5,11,16,25,14,0,0,0,77,176,135,64,6,10,1248,1497,1099,1138,51,39,0,30228137.785
KEVIN.PORTER,20152016,PIT,464.0833333333333,0,2,1,3,3,2,44,87,43,34,57,96,11,4,0,323,427,297,313,6,10,0.5057471264367817,30228058.175
KEVIN.SHATTENKIRK,20152016,STL,2035.6,16,24,14,38,54,40,0,0,0,218,433,119,132,17,28,1937,1712,1363,1278,48,58,0,30228161.27
KLAS.DAHLBECK,20152016,ARI,1117.0333333333333,2,2,3,5,7,4,0,0,0,64,137,178,45,1,14,762,1166,708,860,24,33,0,30228115.285
KORBINIAN.HOLZER,20152016,ANA,430.75,0,3,0,3,3,3,0,0,0,17,42,57,14,4,5,377,393,359,350,14,17,0,30228057.64
KRIS.LETANG,20152016,PIT,2576.6833333333334,19,25,35,60,79,44,0,0,0,288,567,188,194,31,45,2877,2188,1972,1632,74,64,0,30228181.134999998
KRIS.RUSSELL,20152016,CGY,1166.3666666666668,4,5,6,11,15,9,0,1,1,56,155,31,55,5,5,960,1224,795,1009,37,45,0,30228131.450000003
KRIS.RUSSELL,20152016,DAL,503.68333333333334,0,3,5,8,8,3,0,0,0,22,60,23,18,5,3,500,498,385,385,24,21,0,30228059.825
KRIS.VERSTEEG,20152016,CAR,1032.3333333333335,11,8,14,22,33,19,6,13,7,136,248,17,45,16,13,1203,764,931,725,28,31,0.46153846153846156,30228097.6
KRIS.VERSTEEG,20152016,L.A,201.46666666666667,5,1,1,2,7,6,3,5,2,25,46,7,10,4,3,231,137,177,129,10,5,0.6,30228037.435
KURTIS.GABRIEL,20152016,MIN,35.166666666666664,0,0,0,0,0,0,0,0,0,3,4,16,1,2,2,11,32,11,32,1,0,0,30228028.42
KYLE.BAUN,20152016,CHI,18.1,0,0,0,0,0,0,0,0,0,1,1,3,0,0,0,13,19,13,19,0,2,0,30228026.25
KYLE.BRODZIAK,20152016,STL,993.95,9,2,2,4,13,11,327,653,326,61,123,67,29,11,16,667,862,629,640,18,24,0.5007656967840735,30228107.64
KYLE.CHIPCHURA,20152016,ARI,716.4166666666666,4,6,2,8,12,10,88,168,80,47,87,73,23,9,13,524,719,489,614,15,25,0.5238095238095238,30228099.71
KYLE.CLIFFORD,20152016,L.A,558.3,3,4,3,7,10,7,3,7,4,68,123,123,26,15,18,537,460,528,453,15,15,0.42857142857142855,30228070.345
KYLE.OKPOSO,20152016,NYI,1680.8166666666666,24,27,20,47,71,51,38,89,51,246,448,115,113,26,26,1841,1364,1259,1204,48,48,0.42696629213483145,30228169.28
KYLE.PALMIERI,20152016,N.J,1460.3166666666666,30,16,11,27,57,46,10,27,17,222,391,129,91,42,17,1209,1141,771,929,34,25,0.37037037037037035,30228151.495
KYLE.QUINCEY,20152016,DET,1004.3666666666666,4,1,7,8,12,5,0,0,0,64,119,57,37,8,20,757,966,721,758,28,34,0,30228102.055
KYLE.RAU,20152016,FLA,113.31666666666666,0,0,0,0,0,0,0,0,0,14,27,4,5,2,1,102,87,94,86,2,3,0,30228032.02
KYLE.TURRIS,20152016,OTT,1123.1666666666665,13,10,7,17,30,23,536,1044,508,122,225,44,55,13,15,1188,950,770,778,27,34,0.5134099616858238,30228133.545
LADISLAV.SMID,20152016,CGY,254.88333333333333,0,0,0,0,0,0,0,0,0,11,24,39,9,3,3,212,267,210,242,7,15,0,30228048.43
LANCE.BOUMA,20152016,CGY,529.5666666666666,2,3,2,5,7,5,5,13,8,49,83,110,17,13,6,402,615,382,449,10,20,0.38461538461538464,30228075.23
LANDON.FERRARO,20152016,BOS,626,5,3,2,5,10,8,28,82,54,65,112,79,22,9,7,406,645,391,493,15,21,0.34146341463414637,30228084.96
LANDON.FERRARO,20152016,DET,95.56666666666666,0,0,0,0,0,0,1,4,3,12,20,22,3,2,2,53,109,52,102,0,3,0.25,30228037.310000002
LARS.ELLER,20152016,MTL,1205.3166666666666,13,7,6,13,26,20,207,409,202,149,275,111,66,18,12,1148,1061,932,828,37,45,0.5061124694376528,30228117.009999998
LAURENT.DAUPHIN,20152016,ARI,90.51666666666667,1,0,0,0,1,1,32,73,41,7,16,6,6,2,2,66,84,62,74,3,2,0.4383561643835616,30228033.75
LAURI.KORPIKOSKI,20152016,EDM,988.45,10,7,5,12,22,17,18,34,16,88,148,100,30,5,5,723,1104,591,782,17,33,0.5294117647058824,30228121.744999997
LEE.STEMPNIAK,20152016,BOS,291.31666666666666,3,2,5,7,10,5,0,3,3,26,50,28,13,7,2,297,261,279,218,11,9,0,30228044.545
LEE.STEMPNIAK,20152016,N.J,1179.3666666666668,16,13,12,25,41,29,2,10,8,120,207,85,46,4,14,887,1027,613,725,36,32,0.2,30228117.57
LEO.KOMAROV,20152016,TOR,1194.95,19,7,8,15,34,26,62,127,65,130,217,283,29,19,16,1333,1019,899,789,26,40,0.4881889763779528,30228118.619999997
LEON.DRAISAITL,20152016,EDM,1298.4166666666665,19,15,16,31,50,34,501,1035,534,132,212,38,37,19,9,1409,1072,1023,950,45,43,0.48405797101449277,30228155.630000003
LINDEN.VEY,20152016,VAN,645.8166666666666,4,7,4,11,15,11,193,448,255,40,75,4,15,4,3,554,577,400,494,10,18,0.43080357142857145,30228094.61
LOGAN.COUTURE,20152016,S.J,1368.6,25,22,17,39,64,47,398,870,472,202,386,69,102,13,13,1581,1070,918,837,43,32,0.4574712643678161,30228144.575
LOGAN.SHAW,20152016,FLA,683.6333333333333,5,1,1,2,7,6,17,41,24,81,123,96,17,13,3,543,580,427,513,11,20,0.4146341463414634,30228085.185000002
LOUI.ERIKSSON,20152016,BOS,1597.5,30,18,15,33,63,48,12,21,9,184,268,22,33,10,5,1755,1383,1109,1022,51,29,0.5714285714285714,30228151.655
LUCA.SBISA,20152016,VAN,712.35,2,3,3,6,8,5,0,0,0,29,72,71,33,8,10,515,745,485,606,22,18,0,30228088.705
LUCAS.LESSIO,20152016,MTL,125.7,1,0,1,1,2,1,0,2,2,14,24,24,6,1,1,98,110,93,106,4,2,0,30228035.485
LUKE.GAZDIC,20152016,EDM,179.73333333333335,1,0,0,0,1,1,0,1,1,18,27,35,6,7,6,163,182,163,182,4,10,0,30228044.270000003
LUKE.GLENDENING,20152016,DET,1263.7666666666667,8,7,7,14,22,15,667,1223,556,92,159,147,27,24,23,772,1420,698,868,28,33,0.5453802125919869,30228150.445
LUKE.SCHENN,20152016,L.A,845.5666666666666,3,4,6,10,13,7,0,0,0,62,144,183,53,8,19,786,825,727,630,35,29,0,30228079.73
LUKE.SCHENN,20152016,PHI,510.1166666666667,2,0,3,3,5,2,1,2,1,19,74,71,47,2,7,389,552,376,428,15,21,0.5,30228063.785
LUKE.WITKOWSKI,20152016,T.B,35.03333333333334,0,0,0,0,0,0,0,0,0,1,5,9,2,1,2,40,23,40,23,1,0,0,30228025.36
MAGNUS.PAAJARVI,20152016,STL,641.3833333333333,3,6,1,7,10,9,0,2,2,90,145,45,21,11,4,635,522,604,499,15,23,0,30228074.035
MARC-ANDRE.GRAGNANI,20152016,N.J,57.44999999999999,0,0,0,0,0,0,0,0,0,0,9,1,5,0,1,54,35,38,34,0,2,0,30228026.6
MARC-EDOUARD.VLASIC,20152016,S.J,2115.1833333333334,9,17,23,40,49,26,0,0,0,156,402,69,142,9,17,1896,1924,1488,1369,75,54,0,30228150.215
MARC.METHOT,20152016,OTT,1425.4166666666665,5,3,4,7,12,8,0,0,0,73,131,123,36,3,16,1101,1485,1014,1156,52,48,0,30228145.03
MARC.STAAL,20152016,NYR,1611.0666666666666,2,5,10,15,17,7,1,4,3,70,157,70,57,9,20,1197,1723,1126,1341,45,48,0.25,30228165.18
MARCO.SCANDELLA,20152016,MIN,1627.9,6,7,8,15,21,13,0,0,0,137,317,72,113,15,13,1298,1610,1114,1264,46,45,0,30228151.65
MARCUS.FOLIGNO,20152016,BUF,988.8333333333333,10,7,6,13,23,17,1,4,3,81,137,192,24,27,22,790,910,736,843,34,33,0.25,30228124.009999998
MARCUS.JOHANSSON,20152016,WSH,1431.45,19,21,13,34,53,40,133,301,168,157,248,57,41,22,11,1579,1151,1003,1039,42,34,0.4418604651162791,30228159.865000002
MARCUS.KRUGER,20152016,CHI,659.9666666666667,0,4,1,5,5,4,281,572,291,58,97,28,18,7,11,499,704,461,483,11,20,0.49125874125874125,30228087.685000002
MAREK.HRIVIK,20152016,NYR,53.58333333333333,0,0,1,1,1,0,3,5,2,3,5,6,2,0,0,25,50,25,42,3,0,0.6,30228028.595
MAREK.ZIDLICKY,20152016,NYI,916.9333333333333,4,7,5,12,16,11,0,0,0,52,106,46,34,1,13,878,791,702,735,30,20,0,30228101.134999998
MARIAN.GABORIK,20152016,L.A,867.9333333333333,12,7,4,11,23,19,1,3,2,150,228,32,30,11,9,989,627,748,569,21,28,0.3333333333333333,30228085.9
MARIAN.HOSSA,20152016,CHI,1230.6166666666668,16,16,6,22,38,32,1,3,2,224,361,46,92,15,12,1214,1082,937,821,28,27,0.3333333333333333,30228115.990000002
MARK.ARCOBELLO,20152016,TOR,253.55,3,0,1,1,4,3,132,242,110,43,69,22,13,3,0,330,188,228,166,10,9,0.5454545454545454,30228042.585
MARK.BARBERIO,20152016,MTL,449.93333333333334,2,2,6,8,10,4,0,0,0,32,88,12,39,2,3,439,370,398,342,19,15,0,30228051.72
MARK.BOROWIECKI,20152016,OTT,921.5,1,0,0,0,1,1,0,1,1,27,60,271,19,18,31,663,1075,613,735,18,26,0,30228104.98
MARK.FAYNE,20152016,EDM,1153.4666666666667,2,2,3,5,7,4,0,0,0,61,134,53,40,1,9,970,1177,930,963,35,44,0,30228117.835
MARK.GIORDANO,20152016,CGY,2033.0166666666667,21,17,17,34,55,38,0,0,0,212,472,65,176,21,27,1958,1823,1346,1341,62,68,0,30228162.335
MARK.LETESTU,20152016,EDM,1294.15,10,7,7,14,24,17,596,1162,566,107,198,68,46,4,4,1059,1292,691,841,17,36,0.5129087779690189,30228145.855
MARK.MCNEILL,20152016,CHI,12.733333333333333,0,0,0,0,0,0,0,1,1,0,1,3,1,0,0,7,14,6,14,0,0,0,15114013.7
MARK.PYSYK,20152016,BUF,874.6333333333334,1,6,2,8,9,7,0,0,0,44,102,37,31,4,16,801,751,715,680,28,28,0,30228090.189999998
MARK.SCHEIFELE,20152016,WPG,1316.9666666666667,29,20,12,32,61,49,515,1165,650,194,320,53,57,26,20,1437,1035,1051,897,57,39,0.44206008583690987,30228161.41
MARK.STONE,20152016,OTT,1508.5166666666667,23,21,17,38,61,44,8,19,11,150,271,55,56,11,18,1660,1321,1097,1015,46,40,0.42105263157894735,30228145.805
MARK.STREIT,20152016,PHI,1480.0166666666669,6,6,11,17,23,12,0,0,0,115,237,32,72,12,12,1448,1381,979,1053,35,31,0,30228132.945
MARK.STUART,20152016,WPG,1046.4,1,0,1,1,2,1,0,0,0,39,105,161,41,15,25,724,1151,685,774,23,32,0,30228102.875
MARKO.DANO,20152016,CHI,125.9,1,0,1,1,2,1,1,4,3,15,26,15,6,3,1,134,111,130,108,3,4,0.25,30228034.195
MARKO.DANO,20152016,WPG,290.65,4,1,3,4,8,5,1,2,1,39,66,47,11,6,4,266,213,233,204,8,15,0.5,30228046.325
MARKUS.GRANLUND,20152016,CGY,401.93333333333334,4,3,0,3,7,7,126,282,156,37,80,21,22,6,4,309,386,266,333,9,13,0.44680851063829785,30228069.5
MARKUS.GRANLUND,20152016,VAN,246.08333333333334,2,1,0,1,3,3,76,190,114,19,33,10,7,1,3,194,236,154,196,8,13,0.4,30228051.75
MARKUS.HANNIKAINEN,20152016,CBJ,28.583333333333332,0,0,0,0,0,0,0,0,0,3,3,7,0,0,0,16,37,15,36,0,2,0,30228028.8
MARTIN.HANZAL,20152016,ARI,1139.0333333333333,13,14,14,28,41,27,586,1047,461,140,242,126,41,26,31,1206,990,763,774,33,29,0.559694364851958,30228137.799999997
MARTIN.HAVLAT,20152016,STL,21.78333333333333,1,0,0,0,1,1,0,0,0,3,4,1,0,1,0,18,16,18,14,1,1,0,15114013.91
MARTIN.MARINCIN,20152016,TOR,1090,1,3,3,6,7,4,0,0,0,55,180,37,91,6,16,943,1016,881,765,27,35,0,30228084.785
MASON.RAYMOND,20152016,CGY,357.9,4,0,1,1,5,4,3,7,4,53,87,12,19,2,4,356,335,286,326,10,11,0.42857142857142855,30228060.564999998
MATHIEU.PERREAULT,20152016,WPG,1174.9833333333331,9,14,18,32,41,23,94,203,109,133,258,83,80,21,18,1412,808,970,729,39,40,0.4630541871921182,30228096.42
MATS.ZUCCARELLO,20152016,NYR,1588.3666666666666,27,27,9,36,63,54,6,13,7,178,342,100,86,23,18,1682,1337,1144,1200,59,49,0.46153846153846156,30228171.595
MATT.BARTKOWSKI,20152016,VAN,1489.5333333333333,6,5,6,11,17,11,0,0,0,85,198,141,76,8,23,1193,1525,1100,1297,39,59,0,30228161.479999997
MATT.BELESKEY,20152016,BOS,1268.55,15,11,11,22,37,26,6,25,19,168,362,259,96,15,19,1312,1142,1070,1044,48,38,0.24,30228135.165
MATT.CALVERT,20152016,CBJ,1104.35,11,8,5,13,24,19,7,14,7,114,192,91,43,20,20,816,1166,750,851,33,30,0.5,30228124.405
MATT.CARLE,20152016,T.B,1284.7166666666667,2,6,5,11,13,8,0,0,0,60,125,45,40,3,16,1010,1311,929,1052,40,39,0,30228133.855
MATT.CULLEN,20152016,PIT,1470.1,20,12,6,18,38,32,787,1437,650,143,227,65,48,18,13,1078,1577,952,1068,39,37,0.5476687543493389,30228178.509999998
MATT.DUCHENE,20152016,COL,1412.8833333333332,30,16,13,29,59,46,428,739,311,200,325,41,63,24,12,1444,1328,985,1188,46,45,0.5791610284167794,30228190.685000002
MATT.DUMBA,20152016,MIN,1450.5666666666666,10,11,6,17,27,21,0,0,0,156,341,89,110,16,19,1397,1211,1014,1110,49,44,0,30228140.259999998
MATT.GREENE,20152016,L.A,35.25,0,0,0,0,0,0,0,0,0,3,4,5,0,1,4,25,38,22,31,0,1,0,15114016.31
MATT.HALISCHUK,20152016,WPG,283.48333333333335,0,3,0,3,3,3,1,3,2,39,55,38,8,2,2,207,251,198,234,5,4,0.3333333333333333,30228051.259999998
MATT.HENDRICKS,20152016,EDM,899.9833333333333,5,4,3,7,12,9,250,452,202,62,117,175,31,23,25,639,1016,595,711,14,14,0.5530973451327433,30228114.755
MATT.HUNWICK,20152016,TOR,1353.8166666666666,2,5,3,8,10,7,0,0,0,74,183,126,63,6,17,1101,1517,971,1087,29,47,0,30228135.384999998
MATT.IRWIN,20152016,BOS,29.866666666666667,0,0,0,0,0,0,0,0,0,3,4,1,1,0,0,22,30,19,27,1,5,0,15114014.95
MATT.MARTIN,20152016,NYI,981.6833333333334,10,7,2,9,19,17,1,4,3,101,169,434,28,34,44,835,863,816,849,35,37,0.25,30228124.23
MATT.MOULSON,20152016,BUF,963.3666666666667,8,7,6,13,21,15,0,5,5,111,182,44,28,6,4,926,722,666,683,22,26,0,30228102.01
MATT.NIETO,20152016,S.J,1079.2333333333333,9,6,5,11,20,15,2,8,6,104,183,55,47,13,9,902,1077,866,892,23,30,0.25,30228120.935000002
MATT.NISKANEN,20152016,WSH,2340.666666666667,5,14,14,28,33,19,0,0,0,167,393,195,142,9,21,2160,2212,1629,1552,61,48,0,30228168.74
MATT.PUEMPEL,20152016,OTT,294.7833333333333,2,0,1,1,3,2,1,2,1,26,52,18,15,2,3,256,324,230,313,7,10,0.5,30228059.435000002
MATT.READ,20152016,PHI,1278.8666666666668,11,8,7,15,26,19,26,54,28,131,225,89,28,10,13,1226,1166,960,853,24,31,0.48148148148148145,30228118.515
MATT.STAJAN,20152016,CGY,1015.8,6,8,3,11,17,14,373,787,414,58,111,77,29,13,18,731,1099,690,880,25,35,0.47395171537484115,30228144.925
MATT.TAORMINA,20152016,T.B,52.666666666666664,0,0,0,0,0,0,0,0,0,3,6,1,1,1,0,37,40,32,36,2,1,0,30228027.51
MATT.TENNYSON,20152016,S.J,304.8,1,1,2,3,4,2,0,0,0,23,63,23,27,0,0,280,272,220,251,11,11,0,30228047.5
MATTHEW.O'CONNOR,20152016,OTT,58.03333333333333,0,0,0,0,0,0,0,0,0,0,0,0,0,0,0,43,70,0,0,0,0,0,15114012
MATTIAS.EKHOLM,20152016,NSH,1993.0666666666666,11,15,14,29,40,26,0,0,0,139,305,76,100,10,24,1755,1598,1476,1283,69,55,0,30228144.95
MATTIAS.JANMARK,20152016,DAL,1210.8,17,13,4,17,34,30,102,288,186,126,248,12,63,7,9,1253,1047,1130,947,52,43,0.3541666666666667,30228127.65
MAX.DOMI,20152016,ARI,1326.3166666666666,18,24,10,34,52,42,20,55,35,156,297,34,80,29,25,1396,1175,899,1038,43,31,0.36363636363636365,30228156.240000002
MAX.FRIBERG,20152016,ANA,44.199999999999996,0,0,0,0,0,0,0,0,0,1,6,7,2,0,1,23,38,23,37,0,1,0,30228028.299999997
MAX.MCCORMICK,20152016,OTT,209.16666666666669,2,0,2,2,4,2,39,76,37,37,54,46,9,7,11,190,197,188,184,5,9,0.5131578947368421,30228046.68
MAX.PACIORETTY,20152016,MTL,1519.2333333333333,30,23,11,34,64,53,6,13,7,303,540,102,115,14,15,1736,1265,1179,954,48,50,0.46153846153846156,30228136.005000003
MAX.TALBOT,20152016,BOS,426.1166666666667,2,3,2,5,7,5,164,345,181,29,43,66,9,6,6,266,486,248,364,9,22,0.4753623188405797,30228076.52
MELKER.KARLSSON,20152016,S.J,1213.4666666666667,15,8,3,11,26,23,13,28,15,121,215,108,33,22,12,963,1227,879,980,34,32,0.4642857142857143,30228140.815
MICHAEL.CHAPUT,20152016,CBJ,71.98333333333333,1,0,1,1,2,1,49,75,26,10,12,13,2,2,1,63,67,63,67,4,1,0.6533333333333333,30228032.255
MICHAEL.DEL ZOTTO,20152016,PHI,1217.4666666666667,4,4,4,8,12,8,0,0,0,97,213,140,83,8,8,1135,1193,929,878,20,34,0,30228105.23
MICHAEL.FROLIK,20152016,CGY,1011.7666666666667,15,9,8,17,32,24,5,10,5,155,269,49,77,10,12,944,1033,859,809,35,38,0.5,30228111.5
MICHAEL.GRABNER,20152016,TOR,1157.5333333333333,9,5,4,9,18,14,3,13,10,116,186,41,23,4,6,914,1233,795,809,23,32,0.23076923076923078,30228115.259999998
MICHAEL.KERANEN,20152016,MIN,6.15,0,0,0,0,0,0,0,0,0,0,0,1,0,0,0,6,6,6,6,0,1,0,15114012.6
MICHAEL.KOSTKA,20152016,OTT,222.71666666666667,0,0,1,1,1,0,0,0,0,9,17,7,4,0,2,180,235,166,213,10,6,0,30228046.375
MICHAEL.LATTA,20152016,WSH,347.6833333333333,3,1,2,3,6,4,102,197,95,29,51,58,16,13,13,279,274,277,268,10,10,0.5177664974619289,30228056.509999998
MICHAEL.MATHESON,20152016,FLA,161.01666666666665,0,0,1,1,1,0,0,0,0,12,21,4,6,1,1,161,132,151,129,3,1,0,30228035.285
MICHAEL.MCCARRON,20152016,MTL,233.63333333333333,1,1,0,1,2,2,85,169,84,41,56,49,7,6,10,206,222,170,210,4,10,0.5029585798816568,30228053.560000002
MICHAEL.MERSCH,20152016,L.A,176.4666666666667,1,1,1,2,3,2,1,4,3,23,33,26,1,2,1,141,201,129,179,4,3,0.25,30228046.435000002
MICHAEL.PALIOTTA,20152016,CBJ,7.533333333333333,0,0,0,0,0,0,0,0,0,2,2,0,0,0,1,6,16,6,15,1,1,0,15114014.05
MICHAEL.RAFFL,20152016,PHI,1248,14,10,8,18,32,24,44,109,65,140,251,148,48,19,14,1301,1002,1110,934,42,34,0.4036697247706422,30228123.1
MICHAEL.SGARBOSSA,20152016,ANA,8.35,0,0,0,0,0,0,2,4,2,0,0,0,0,0,0,10,4,10,4,0,0,0.5,15114012.18
MICHAEL.STONE,20152016,ARI,1684.9833333333333,6,15,12,27,33,21,0,2,2,161,364,137,118,11,31,1583,1608,1114,1227,40,45,0,30228154.91
MICHAEL.ZALEWSKI,20152016,VAN,35.56666666666666,0,1,0,1,1,1,6,10,4,2,3,7,0,0,0,24,22,24,22,1,0,0.6,30228026.740000002
MICHAL.JORDAN,20152016,CAR,545.9,1,0,0,0,1,1,0,0,0,36,76,24,27,2,6,468,455,459,417,18,24,0,30228060.27
MICHAL.ROZSIVAL,20152016,CHI,889.0666666666666,1,6,6,12,13,7,0,0,0,42,94,91,38,4,12,785,806,723,725,30,30,0,30228094.79
MICHEAL.FERLAND,20152016,CGY,895.4833333333333,4,7,7,14,18,11,7,12,5,122,189,207,29,13,17,861,793,703,741,27,39,0.5833333333333334,30228107.735
MICHEAL.HALEY,20152016,S.J,113.56666666666666,1,0,0,0,1,1,11,19,8,10,15,39,3,10,11,82,109,82,109,1,3,0.5789473684210527,30228038.89
MIIKKA.SALOMAKI,20152016,NSH,914.3166666666666,6,3,3,6,12,9,2,4,2,76,148,198,34,17,16,663,878,635,677,17,19,0.5,30228098.675
MIKA.ZIBANEJAD,20152016,OTT,1438.5166666666667,21,16,13,29,50,37,658,1305,647,184,331,111,66,21,8,1473,1376,965,1035,49,39,0.5042145593869731,30228174.605
MIKAEL.BACKLUND,20152016,CGY,1347.15,20,17,9,26,46,37,539,1142,603,154,273,68,62,7,14,1285,1227,1006,919,46,36,0.47197898423817863,30228154.005000003
MIKAEL.GRANLUND,20152016,MIN,1619.4333333333334,14,27,6,33,47,41,534,1102,568,180,312,93,74,21,10,1690,1410,1150,1172,37,48,0.484573502722323,30228184.52
MIKE.ANGELIDIS,20152016,T.B,36.00000000000001,1,0,0,0,1,1,10,31,21,1,6,6,3,1,1,28,26,28,25,2,0,0.3225806451612903,30228027.46
MIKE.BLUNDEN,20152016,T.B,213.73333333333335,3,2,0,2,5,5,0,0,0,19,37,56,12,7,11,174,183,173,180,7,5,0,30228045.37
MIKE.BROWN,20152016,MTL,135.11666666666667,1,1,0,1,2,2,1,1,0,14,25,56,6,9,9,104,121,102,121,3,5,1,30228039.08
MIKE.BROWN,20152016,S.J,317.7,1,2,0,2,3,3,2,3,1,37,64,120,14,13,20,248,332,245,314,5,9,0.6666666666666666,30228062.81
MIKE.CAMMALLERI,20152016,N.J,809.7166666666667,14,18,6,24,38,32,7,14,7,102,154,15,23,8,9,665,570,451,474,33,19,0.5,30228091.11
MIKE.FISHER,20152016,NSH,1462.55,18,7,5,12,30,25,808,1523,715,133,242,182,63,11,14,1462,1333,1086,937,38,47,0.5305318450426789,30228148.455
MIKE.GREEN,20152016,DET,1546.6666666666665,8,13,16,29,37,21,0,2,2,132,275,111,90,10,21,1669,1060,1157,940,42,45,0,30228111.25
MIKE.HOFFMAN,20152016,OTT,1368.3666666666668,29,19,10,29,58,48,8,18,10,242,465,22,133,15,9,1444,1158,968,1003,49,40,0.4444444444444444,30228144.27
MIKE.REILLY,20152016,MIN,350.4,1,2,4,6,7,3,0,0,0,27,51,3,18,1,4,340,320,235,280,9,13,0,30228054.259999998
MIKE.RIBEIRO,20152016,NSH,1597.8833333333332,7,19,26,45,52,26,315,833,518,83,139,79,24,12,18,1811,1144,1300,1043,58,47,0.37815126050420167,30228150.17
MIKE.RICHARDS,20152016,WSH,609.8833333333333,2,3,0,3,5,5,296,602,306,55,95,74,18,6,5,462,645,429,407,10,11,0.49169435215946844,30228078.35
MIKE.SANTORELLI,20152016,ANA,706.4833333333333,9,1,8,9,18,10,75,158,83,81,131,28,28,7,5,642,575,578,558,18,21,0.47468354430379744,30228087.62
MIKE.SISLO,20152016,N.J,223.65,3,0,1,1,4,3,0,2,2,29,53,25,6,1,2,155,187,132,178,4,6,0,30228046.634999998
MIKE.WEBER,20152016,BUF,556.8,1,3,0,3,4,4,0,0,0,28,55,72,15,5,14,423,503,408,401,14,12,0,30228065.299999997
MIKE.WEBER,20152016,WSH,159.5,0,0,0,0,0,0,0,0,0,12,23,38,7,2,7,126,158,123,145,3,5,0,30228039.77
MIKHAIL.GRABOVSKI,20152016,NYI,817.9833333333333,9,7,9,16,25,16,221,463,242,83,158,28,34,12,10,806,760,698,707,31,28,0.4773218142548596,30228111.884999998
MIKHAIL.GRIGORENKO,20152016,COL,981.7333333333332,6,13,8,21,27,19,151,349,198,84,143,23,27,3,5,849,955,662,838,38,29,0.4326647564469914,30228132.17
MIKKEL.BOEDKER,20152016,ARI,1156.4,13,17,9,26,39,30,0,1,1,144,260,43,64,12,5,1262,975,716,857,23,47,0,30228130.945
MIKKEL.BOEDKER,20152016,COL,325.95,4,4,4,8,12,8,1,2,1,22,49,7,11,3,1,326,300,222,259,11,13,0.5,30228055.07
MIKKO.KOIVU,20152016,MIN,1763.0333333333333,20,19,22,41,61,39,1089,1938,849,155,305,44,84,12,21,1849,1410,1130,1069,53,41,0.5619195046439629,30228175.98
MIKKO.RANTANEN,20152016,COL,80.61666666666667,0,0,0,0,0,0,13,24,11,9,17,0,6,1,1,70,115,68,115,0,7,0.5416666666666666,30228037.98
MILAN.LUCIC,20152016,L.A,1481.3166666666666,20,28,10,38,58,48,8,23,15,130,285,268,65,16,29,1863,1070,1404,983,64,43,0.34782608695652173,30228123.73
MILAN.MICHALEK,20152016,OTT,537.85,6,2,2,4,10,8,2,5,3,56,95,23,19,4,6,474,486,298,345,17,12,0.4,30228064.77
MILAN.MICHALEK,20152016,TOR,187.48333333333335,1,3,2,5,6,4,1,3,2,8,24,19,9,1,3,184,145,114,135,3,3,0.3333333333333333,30228040.200000003
MILES.WOOD,20152016,N.J,13.1,0,0,0,0,0,0,0,0,0,2,2,1,0,1,0,7,8,7,6,0,0,0,15114012.66
MIRCO.MUELLER,20152016,S.J,116.63333333333334,0,0,0,0,0,0,0,0,0,8,19,2,8,1,2,109,99,103,99,0,4,0,30228033.21
MORGAN.ELLIS,20152016,MTL,26.866666666666667,0,0,0,0,0,0,0,0,0,3,7,1,3,0,1,22,22,22,22,1,1,0,15114013.9
MORGAN.RIELLY,20152016,TOR,1904.6166666666668,9,8,17,25,34,17,0,0,0,167,423,58,136,11,14,1942,1878,1421,1432,46,69,0,30228162.985
NAIL.YAKUPOV,20152016,EDM,852.9333333333334,8,6,9,15,23,14,0,1,1,127,220,54,61,12,12,838,737,646,666,24,33,0,30228096.744999997
NATE.GUENIN,20152016,COL,378.75,0,0,0,0,0,0,0,0,0,10,26,15,10,1,1,242,433,233,350,11,9,0,30228062.36
NATE.PROSSER,20152016,MIN,686.0833333333334,0,1,2,3,3,1,0,0,0,22,50,37,18,9,15,477,722,454,570,13,21,0,30228086.29
NATE.SCHMIDT,20152016,WSH,1426.05,2,9,6,15,17,11,0,0,0,86,204,83,65,17,6,1284,1396,1215,1176,42,37,0,30228135.77
NATE.THOMPSON,20152016,ANA,659.9666666666667,5,2,1,3,8,7,258,503,245,52,91,131,23,5,15,490,672,458,485,13,16,0.5129224652087475,30228087.695
NATHAN.BEAULIEU,20152016,MTL,1117.25,2,8,9,17,19,10,0,0,0,74,144,59,45,10,15,1065,969,890,858,33,38,0,30228109.025
NATHAN.GERBE,20152016,CAR,632.3833333333333,3,2,2,4,7,5,2,5,3,73,140,54,39,10,7,513,530,423,439,11,26,0.4,30228069.48
NATHAN.MACKINNON,20152016,COL,1358.35,21,15,16,31,52,36,507,1047,540,245,417,46,80,25,9,1425,1300,964,1114,45,41,0.48424068767908307,30228184.08
NAZEM.KADRI,20152016,TOR,1388.7833333333333,17,20,8,28,45,37,641,1303,662,260,485,148,129,59,36,1683,1159,1140,1028,33,50,0.49194167306216424,30228166.08
NIC.DOWD,20152016,L.A,52.88333333333334,0,0,0,0,0,0,18,34,16,3,8,6,3,2,1,69,27,61,27,2,1,0.5294117647058824,30228025.19
NIC.PETAN,20152016,WPG,305.43333333333334,2,2,2,4,6,4,12,21,9,25,52,7,12,3,6,284,235,220,223,6,5,0.5714285714285714,30228048.91
NICK.BJUGSTAD,20152016,FLA,1134.8666666666668,17,15,6,21,38,32,493,963,470,192,305,101,56,14,16,1146,866,797,785,35,35,0.5119418483904465,30228139.56
NICK.BONINO,20152016,PIT,1410.6666666666665,13,22,12,34,47,35,662,1328,666,138,236,38,52,13,18,1303,1397,1011,965,48,28,0.49849397590361444,30228161.71
NICK.COUSINS,20152016,PHI,452.23333333333335,6,2,3,5,11,8,131,274,143,44,75,46,18,15,4,445,379,413,367,14,10,0.4781021897810219,30228067.915
NICK.FOLIGNO,20152016,CBJ,1216.0166666666667,12,13,12,25,37,25,83,176,93,149,243,152,43,26,19,1175,942,884,820,31,37,0.4715909090909091,30228122.53
NICK.HOLDEN,20152016,COL,1794.1999999999998,6,8,7,15,21,14,0,0,0,98,200,217,65,7,12,1442,1961,1262,1546,59,64,0,30228190.095
NICK.LEDDY,20152016,NYI,2129.6833333333334,6,20,17,37,43,26,0,0,0,142,310,94,105,10,11,2181,1874,1601,1631,61,67,0,30228189.025
NICK.PAUL,20152016,OTT,292.65,2,2,1,3,5,4,31,60,29,28,50,43,11,4,3,230,271,220,256,8,10,0.5166666666666667,30228054.155
NICK.RITCHIE,20152016,ANA,388.1166666666667,2,1,0,1,3,3,1,3,2,55,101,93,22,6,14,377,310,343,302,7,9,0.3333333333333333,30228054.75
NICK.SCHULTZ,20152016,PHI,1554.55,1,2,7,9,10,3,1,1,0,72,170,89,58,8,22,1137,1740,1043,1203,37,41,1,30228147.345
NICK.SHORE,20152016,L.A,852.8833333333333,3,5,1,6,9,8,388,749,361,90,158,99,32,7,15,873,651,811,514,12,21,0.5180240320427236,30228079.865000002
NICK.SPALING,20152016,S.J,599.5166666666667,2,2,3,5,7,4,106,214,108,36,87,76,25,5,5,399,593,372,481,12,11,0.4953271028037383,30228081.665
NICK.SPALING,20152016,TOR,534.0999999999999,1,2,3,5,6,3,259,507,248,32,63,44,19,0,7,371,584,342,416,11,18,0.5108481262327417,30228079.285
NICKLAS.BACKSTROM,20152016,WSH,1679.0666666666666,22,35,23,58,80,57,768,1586,818,153,277,66,54,15,20,1930,1435,1264,1138,53,31,0.4842370744010088,30228195.845
NICKLAS.GROSSMANN,20152016,ARI,1031.5833333333333,3,2,1,3,6,5,0,0,0,42,91,106,32,4,12,715,1153,671,828,21,26,0,30228113.915
NICOLAS.DESLAURIERS,20152016,BUF,722.2,6,2,4,6,12,8,0,1,1,72,136,206,30,18,13,507,708,490,672,18,34,0,30228104.48
NIKITA.KUCHEROV,20152016,T.B,1744.8,41,29,14,43,84,70,0,1,1,260,496,83,132,24,19,1945,1303,1330,1134,66,42,0,30228159.74
NIKITA.NESTEROV,20152016,T.B,956.5,3,4,2,6,9,7,0,0,0,66,161,110,62,8,18,899,798,755,741,28,29,0,30228094.43
NIKITA.NIKITIN,20152016,EDM,162.83333333333334,0,0,0,0,0,0,0,0,0,12,33,14,15,2,4,176,154,170,150,5,10,0,30228036.22
NIKITA.SOSHNIKOV,20152016,TOR,171.83333333333334,2,1,2,3,5,3,0,1,1,33,53,34,11,4,3,199,153,158,141,4,8,0,30228039.29
NIKITA.TRYAMKIN,20152016,VAN,227.75,1,0,1,1,2,1,0,0,0,11,35,31,11,2,5,178,250,171,224,7,10,0,30228048.445
NIKITA.ZADOROV,20152016,COL,372.3833333333333,0,1,0,1,1,1,0,0,0,18,43,53,15,3,5,298,365,269,322,9,13,0,30228057.479999997
NIKLAS.HJALMARSSON,20152016,CHI,1981.9,2,8,15,23,25,10,0,0,0,81,191,38,73,11,15,1610,1929,1469,1371,51,55,0,30228150.935000002
NIKLAS.KRONWALL,20152016,DET,1517.0666666666666,3,11,12,23,26,14,0,0,0,70,161,97,60,5,19,1380,1384,939,943,33,43,0,30228120
NIKOLAJ.EHLERS,20152016,WPG,1159.2666666666667,15,16,6,22,37,31,0,2,2,167,304,29,64,24,10,1234,893,949,817,41,33,0,30228113.29
NIKOLAY.GOLDOBIN,20152016,S.J,100.66666666666666,1,1,0,1,2,2,0,0,0,7,16,0,3,3,0,73,101,73,100,3,2,0,30228036.08
NIKOLAY.KULEMIN,20152016,NYI,1336.25,10,11,4,15,25,21,24,60,36,112,187,129,46,9,11,1040,1445,934,1104,44,36,0.4,30228151.65
NINO.NIEDERREITER,20152016,MIN,1367.1666666666667,21,15,13,28,49,36,11,28,17,177,298,144,57,15,19,1393,994,1069,899,53,42,0.39285714285714285,30228125.415
NOAH.HANIFIN,20152016,CAR,1414.4166666666667,4,14,2,16,20,18,0,0,0,122,280,67,101,5,13,1435,1153,1062,1069,43,50,0,30228128.4
NOEL.ACCIARI,20152016,BOS,187.91666666666669,0,1,0,1,1,1,60,136,76,17,27,52,4,4,4,140,188,137,135,4,8,0.4411764705882353,30228041.439999998
OLIVER.BJORKSTRAND,20152016,CBJ,191.71666666666667,4,2,2,4,8,6,0,0,0,25,44,9,12,5,0,190,161,151,154,9,4,0,30228041.75
OLIVER.EKMAN-LARSSON,20152016,ARI,1857.7166666666667,21,16,17,33,54,37,0,0,0,228,509,154,178,41,35,2004,1466,1211,1209,61,56,0,30228150.785
OLIVER.KYLINGTON,20152016,CGY,17.366666666666667,0,0,0,0,0,0,0,0,0,1,2,0,1,0,0,11,19,5,6,1,1,0,15114012.4
OLLI.MAATTA,20152016,PIT,1656.6666666666665,6,8,11,19,25,14,0,0,0,112,230,111,76,7,12,1484,1572,1328,1268,74,44,0,30228142.195
ONDREJ.PALAT,20152016,T.B,1442.05,20,19,11,30,50,39,2,10,8,151,276,162,73,29,17,1423,1295,983,958,51,40,0.2,30228135.994999997
OSCAR.KLEFBOM,20152016,EDM,656.25,4,3,4,7,11,7,0,0,0,48,104,21,27,3,3,560,627,440,430,18,21,0,30228067.38
OSCAR.LINDBERG,20152016,NYR,855.4333333333334,13,9,6,15,28,22,135,278,143,119,187,138,26,11,21,767,759,654,705,30,19,0.4856115107913669,30228118.16
OSKAR.SUNDQVIST,20152016,PIT,204.18333333333334,1,2,1,3,4,3,66,146,80,13,21,23,2,1,2,167,183,165,173,5,6,0.4520547945205479,30228046.825000003
P.K..SUBBAN,20152016,MTL,1792.6333333333332,6,22,23,45,51,28,0,0,0,176,378,102,130,14,31,1928,1519,1225,1117,61,52,0,30228133.265
PASCAL.DUPUIS,20152016,PIT,271.75,2,2,0,2,4,4,2,3,1,28,52,35,13,1,5,199,340,180,244,10,8,0.6666666666666666,30228052.84
PATRIC.HORNQVIST,20152016,PIT,1798.6,31,17,15,32,63,48,5,9,4,337,506,248,80,33,22,2198,1343,1558,1250,62,51,0.5555555555555556,30228165.105
PATRICE.BERGERON,20152016,BOS,1586.7833333333333,32,16,20,36,68,48,1129,1976,847,281,454,77,74,10,23,1846,1312,1144,901,47,38,0.5713562753036437,30228165.159999996
PATRICE.CORMIER,20152016,WPG,8.983333333333333,0,0,0,0,0,0,3,9,6,1,2,1,1,0,0,11,3,7,3,0,0,0.3333333333333333,15114012.27
PATRICK.BROWN,20152016,CAR,88.23333333333333,1,0,1,1,2,1,0,0,0,8,13,11,1,1,2,74,80,74,78,6,2,0,30228032.435000002
PATRICK.EAVES,20152016,DAL,838.0666666666666,14,5,4,9,23,19,7,16,9,109,201,85,45,13,13,975,664,689,577,27,22,0.4375,30228086.06
PATRICK.KANE,20152016,CHI,1841.4166666666665,47,43,22,65,112,90,12,56,44,312,509,43,106,23,16,1976,1408,1378,1280,71,59,0.21428571428571427,30228199.060000002
PATRICK.MARLEAU,20152016,S.J,1963.1666666666665,30,17,14,31,61,47,311,620,309,257,429,116,74,12,6,2142,1681,1270,1299,48,55,0.5016129032258064,30228194.66
PATRICK.MAROON,20152016,ANA,637.4666666666667,4,2,7,9,13,6,16,49,33,65,111,114,21,15,19,670,510,495,495,13,25,0.32653061224489793,30228080.565
PATRICK.MAROON,20152016,EDM,250.9,8,5,1,6,14,13,1,4,3,39,57,37,9,9,8,288,231,237,216,16,7,0.25,30228052.604999997
PATRICK.SHARP,20152016,DAL,1579.8166666666666,24,27,10,37,61,51,19,43,24,266,472,89,97,10,15,1895,1294,1339,1140,54,57,0.4418604651162791,30228154.46
PATRICK.SIELOFF,20152016,CGY,17.983333333333334,1,0,0,0,1,1,0,0,0,1,3,3,2,0,1,12,21,9,6,1,0,0,15114012.9
PATRICK.WIERCIOCH,20152016,OTT,901.7166666666667,0,2,3,5,5,2,0,0,0,56,136,53,54,6,12,828,881,729,772,28,26,0,30228097.035
PATRIK.BERGLUND,20152016,STL,945.9000000000001,14,5,5,10,24,19,187,379,192,117,191,79,34,8,9,806,876,717,737,32,21,0.49340369393139843,30228116.735
PATRIK.ELIAS,20152016,N.J,246.98333333333332,2,3,3,6,8,5,9,28,19,21,35,10,9,4,5,187,158,116,117,7,4,0.32142857142857145,30228039.325
PATRIK.NEMETH,20152016,DAL,594.3333333333333,0,3,5,8,8,3,0,0,0,36,82,58,25,4,7,539,571,523,493,15,16,0,30228070.715
PAUL.BYRON,20152016,MTL,853.0333333333333,11,6,1,7,18,17,3,5,2,51,91,112,23,18,4,655,806,598,614,17,32,0.6,30228094.675
PAUL.CAREY,20152016,WSH,39.88333333333333,1,0,0,0,1,1,0,0,0,5,5,6,0,1,0,25,28,25,27,1,1,0,30228027.61
PAUL.GAUSTAD,20152016,NSH,871.7333333333333,3,2,2,4,7,5,512,915,403,60,94,147,15,13,14,512,967,442,690,8,24,0.5595628415300546,30228125.560000002
PAUL.MARTIN,20152016,S.J,2146.55,3,7,15,22,25,10,0,0,0,66,164,84,64,9,14,1919,2159,1749,1691,72,55,0,30228182.365000002
PAUL.POSTMA,20152016,WPG,297.76666666666665,2,0,0,0,2,2,0,0,0,24,58,13,21,0,2,292,241,270,233,9,12,0,30228043.85
PAUL.STASTNY,20152016,STL,1627.4833333333333,13,24,24,48,61,37,939,1655,716,142,243,69,39,9,14,1707,1472,1232,1138,51,49,0.5673716012084592,30228179.4
PAUL.THOMPSON,20152016,N.J,37.583333333333336,0,0,0,0,0,0,0,0,0,3,4,3,1,0,1,25,29,24,29,1,1,0,30228027.15
PAVEL.DATSYUK,20152016,DET,1389.05,16,16,17,33,49,32,640,1202,562,199,351,76,81,13,9,1573,895,1041,776,37,31,0.5324459234608985,30228125.055
PAVEL.ZACHA,20152016,N.J,16.849999999999998,0,1,1,2,2,1,3,9,6,3,4,1,0,0,0,16,10,10,9,3,0,0.3333333333333333,15114013.445
PETER.HOLLAND,20152016,TOR,953.2833333333333,9,13,5,18,27,22,216,465,249,138,238,78,41,9,11,1057,724,689,639,16,28,0.4645161290322581,30228109.605
PETTER.GRANBERG,20152016,NSH,370.4333333333333,0,2,0,2,2,2,0,0,0,12,22,48,5,4,5,252,327,248,305,11,10,0,30228057.439999998
PETTERI.LINDBOHM,20152016,STL,137.88333333333333,0,0,0,0,0,0,0,0,0,9,24,14,10,2,2,130,113,130,111,2,6,0,30228033.119999997
PHIL.KESSEL,20152016,PIT,1934.0500000000002,36,30,15,45,81,66,2,5,3,372,654,18,166,14,13,2339,1494,1507,1328,70,48,0.4,30228176.095
PHIL.VARONE,20152016,OTT,9.483333333333333,0,1,0,1,1,1,4,9,5,0,0,1,0,0,0,7,20,7,20,1,0,0.4444444444444444,15114015.26
PHILIP.SAMUELSSON,20152016,ARI,63.550000000000004,0,0,0,0,0,0,0,0,0,5,7,3,1,0,1,58,58,56,50,1,1,0,15114016.8
PHILIP.VARONE,20152016,BUF,41.55,1,1,0,1,2,2,6,9,3,2,3,3,1,1,1,26,42,26,42,3,1,0.6666666666666666,30228030
PHILLIP.DANAULT,20152016,CHI,385.3833333333333,1,2,1,3,4,3,163,369,206,48,78,33,15,4,3,339,345,326,316,5,11,0.44173441734417346,30228065.535
PHILLIP.DANAULT,20152016,MTL,265.20000000000005,3,0,2,2,5,3,84,150,66,24,45,12,10,3,4,220,250,206,192,5,8,0.56,30228046.79
PHILLIP.DI GIUSEPPE,20152016,CAR,584.6833333333333,7,7,3,10,17,14,7,20,13,68,119,113,20,4,9,543,554,481,526,24,21,0.35,30228086.595
PIERRE-ALEX.PARENTEAU,20152016,TOR,1251.9333333333334,20,10,11,21,41,30,4,18,14,168,313,48,76,20,28,1550,980,1021,879,39,36,0.2222222222222222,30228121.335
PIERRE-EDOUARD.BELLEMARE,20152016,PHI,1074.7166666666667,7,7,1,8,15,14,303,640,337,105,209,76,53,12,14,796,1240,730,833,15,30,0.4734375,30228132.365
PONTUS.ABERG,20152016,NSH,13.433333333333334,0,0,0,0,0,0,0,0,0,0,0,2,0,0,0,6,14,6,14,0,0,0,15114013.8
QUINTON.HOWDEN,20152016,FLA,601.5833333333333,6,3,2,5,11,9,3,6,3,54,82,116,13,7,8,416,486,402,471,16,17,0.5,30228080.29
R.J..UMBERGER,20152016,PHI,396.2166666666667,2,8,1,9,11,10,2,5,3,48,72,59,12,7,5,331,384,310,365,15,13,0.4,30228068.425
RADEK.FAKSA,20152016,DAL,765.5666666666666,8,4,5,9,17,12,302,610,308,85,157,66,25,17,8,729,712,675,561,26,19,0.49508196721311476,30228092.925
RADIM.VRBATA,20152016,VAN,1010.95,13,6,8,14,27,19,4,14,10,198,330,15,76,2,9,1039,836,650,733,20,36,0.2857142857142857,30228111.78
RADKO.GUDAS,20152016,PHI,1625.75,5,5,4,9,14,10,0,0,0,159,365,334,129,20,43,1519,1681,1392,1219,40,47,0,30228133.049999997
RAPHAEL.DIAZ,20152016,NYR,13.933333333333334,0,1,0,1,1,1,0,0,0,2,3,1,1,0,0,18,10,9,10,0,1,0,15114013.55
RASMUS.RISTOLAINEN,20152016,BUF,2073.016666666667,9,15,17,32,41,24,0,0,0,201,395,139,133,18,12,1806,2044,1226,1471,44,60,0,30228184.655
REID.BOUCHER,20152016,N.J,556.5333333333333,8,7,4,11,19,15,1,3,2,74,123,32,24,6,3,475,492,354,452,13,22,0.3333333333333333,30228082.6
REILLY.SMITH,20152016,FLA,1675.1,29,20,9,29,58,49,1,3,2,197,339,91,76,22,10,1523,1358,1045,935,55,28,0.3333333333333333,30228135.985
RENE.BOURQUE,20152016,CBJ,511.71666666666664,3,1,4,5,8,4,3,9,6,77,131,82,27,11,15,410,471,398,451,14,21,0.3333333333333333,30228075.03
RICH.CLUNE,20152016,TOR,153.78333333333333,0,4,0,4,4,4,0,0,0,10,17,58,5,11,8,130,119,128,111,5,4,0,30228036.759999998
RICHARD.PANIK,20152016,CHI,401.9,6,3,2,5,11,9,1,2,1,49,87,77,14,10,6,375,369,354,361,15,10,0.5,30228065.59
RICK.NASH,20152016,NYR,1107.15,17,13,10,23,40,30,0,1,1,194,343,80,74,25,17,1134,1057,779,840,38,29,0,30228126.6
RICKARD.RAKELL,20152016,ANA,1262.4833333333333,21,14,10,24,45,35,226,500,274,183,342,134,68,19,8,1380,937,969,864,44,43,0.452,30228133.48
RILEY.NASH,20152016,CAR,829.2,9,6,6,12,21,15,193,390,197,76,129,58,32,11,7,751,682,597,553,20,24,0.4948717948717949,30228092.229999997
RILEY.SHEAHAN,20152016,DET,1315.4499999999998,14,6,5,11,25,20,374,816,442,141,219,78,36,7,8,1071,1183,853,811,30,38,0.4583333333333333,30228133.255
RINAT.VALIEV,20152016,TOR,122.5,0,0,0,0,0,0,0,0,0,7,18,9,8,1,0,106,99,105,97,4,4,0,30228031.86
ROB.KLINKHAMMER,20152016,EDM,131.76666666666668,1,0,0,0,1,1,1,1,0,10,26,47,10,2,3,91,127,89,119,1,7,1,30228037.41
ROB.SCUDERI,20152016,CHI,188.63333333333333,0,0,0,0,0,0,0,0,0,14,21,7,5,1,0,143,180,139,172,3,9,0,30228042.36
ROB.SCUDERI,20152016,L.A,477,0,3,3,6,6,3,0,0,0,15,35,18,14,2,2,366,458,353,340,18,11,0,30228055.494999997
ROB.SCUDERI,20152016,PIT,427.04999999999995,0,2,2,4,4,2,0,1,1,9,25,10,10,5,4,316,479,304,350,13,11,0,30228060.25
ROBBY.FABBRI,20152016,STL,1245.8666666666668,22,12,17,29,51,34,8,18,10,142,246,74,46,20,16,1224,1034,1008,978,48,43,0.4444444444444444,30228139.595
ROBERT.BORTUZZO,20152016,STL,587.6833333333334,2,1,1,2,4,3,0,0,0,52,99,105,24,9,21,529,461,513,407,17,14,0,30228061.115000002
ROCCO.GRIMALDI,20152016,FLA,258.3,3,0,2,2,5,3,53,125,72,31,51,18,12,4,2,223,195,179,192,9,13,0.424,30228047.91
ROMAN.JOSI,20152016,NSH,2455.5666666666666,15,37,17,54,69,52,0,0,0,240,484,85,151,16,25,2393,2425,1712,1726,62,69,0,30228213.384999998
ROMAN.POLAK,20152016,S.J,805.9000000000001,0,1,2,3,3,1,0,0,0,59,150,150,64,9,10,623,790,613,691,12,19,0,30228090.84
ROMAN.POLAK,20152016,TOR,1085.7,1,7,4,11,12,8,1,1,0,56,137,220,44,11,21,852,1096,790,794,32,29,1,30228103.1
RON.HAINSEY,20152016,CAR,1808.3,5,6,7,13,18,11,0,0,0,131,251,85,68,10,17,1516,1705,1358,1280,50,61,0,30228146.925
RONALDS.KENINS,20152016,VAN,91.28333333333333,0,0,0,0,0,0,1,3,2,6,13,19,3,2,3,63,86,63,82,1,2,0.3333333333333333,30228033.41
ROSS.JOHNSTON,20152016,NYI,16.283333333333335,0,0,0,0,0,0,0,0,0,0,0,6,0,0,2,6,11,4,10,0,0,0,15114013.6
RYAN.CALLAHAN,20152016,T.B,1539.0166666666669,12,12,8,20,32,24,24,45,21,184,334,227,60,33,26,1345,1427,995,1007,38,40,0.5333333333333333,30228140.44
RYAN.CARPENTER,20152016,S.J,7.45,0,0,0,0,0,0,0,2,2,0,0,1,0,0,0,4,5,4,5,0,0,0,15114012.65
RYAN.CARTER,20152016,MIN,688.5833333333333,7,4,1,5,12,11,21,40,19,63,97,93,19,22,21,385,748,354,563,13,17,0.525,30228100.384999998
RYAN.DZINGEL,20152016,OTT,323.93333333333334,3,2,4,6,9,5,2,4,2,23,46,54,14,2,4,255,313,236,294,14,10,0.5,30228057.45
RYAN.ELLIS,20152016,NSH,1989.75,10,17,11,28,38,27,0,0,0,174,353,88,121,27,19,1870,1540,1508,1255,66,53,0,30228137.795
RYAN.GARBUTT,20152016,ANA,491.4166666666667,6,3,0,3,9,9,2,8,6,59,123,86,30,16,12,439,406,417,347,16,18,0.25,30228059.34
RYAN.GARBUTT,20152016,CHI,444.0666666666667,2,4,0,4,6,6,0,2,2,83,132,94,17,8,12,419,403,410,380,8,16,0,30228066.48
RYAN.GETZLAF,20152016,ANA,1656.6333333333332,15,33,19,52,67,48,654,1316,662,200,395,119,85,21,23,1855,1299,1203,988,45,33,0.4969604863221885,30228162.845
RYAN.HARTMAN,20152016,CHI,27.71666666666667,0,1,0,1,1,1,1,4,3,3,10,5,3,0,0,31,37,31,37,1,2,0.25,30228028.24
RYAN.JOHANSEN,20152016,CBJ,659.1666666666667,6,11,9,20,26,17,322,616,294,88,156,58,42,9,12,679,552,436,459,17,14,0.5227272727272727,30228090.895
RYAN.JOHANSEN,20152016,NSH,1007.6500000000001,12,17,13,30,42,29,435,835,400,120,194,88,34,11,21,1055,752,749,689,32,24,0.5209580838323353,30228123.634999998
RYAN.JOHNSTON,20152016,MTL,48.83333333333333,0,0,0,0,0,0,0,0,0,1,5,2,4,0,0,49,47,45,45,1,1,0,30228027.8
RYAN.KESLER,20152016,ANA,1683.9166666666665,25,19,13,32,57,44,1077,1847,770,180,372,182,86,31,30,1633,1585,1121,1023,38,40,0.5831077422847861,30228173.265
RYAN.MCDONAGH,20152016,NYR,1693.7666666666667,9,16,8,24,33,25,1,1,0,116,271,112,92,14,11,1508,1683,1114,1220,67,45,1,30228150.73
RYAN.MURPHY,20152016,CAR,603.8666666666667,0,5,4,9,9,5,0,0,0,46,98,25,34,6,4,570,459,467,433,18,19,0,30228063.810000002
RYAN.MURRAY,20152016,CBJ,1873.3833333333332,4,8,12,20,24,12,0,0,0,90,198,51,74,3,21,1697,1798,1227,1349,57,58,0,30228161.130000003
RYAN.NUGENT-HOPKINS,20152016,EDM,1048.1333333333332,12,15,7,22,34,27,368,821,453,108,214,39,68,11,9,1052,952,726,789,32,38,0.4482338611449452,30228134.055
RYAN.O'REILLY,20152016,BUF,1543.1833333333334,21,26,13,39,60,47,1024,1811,787,157,243,17,44,13,4,1476,1366,923,974,35,47,0.5654334621755936,30228179.765
RYAN.PULOCK,20152016,NYI,323.3166666666667,3,3,1,4,7,6,0,0,0,20,61,25,21,2,1,303,277,241,255,14,15,0,30228049.945
RYAN.REAVES,20152016,STL,544.6833333333334,3,0,1,1,4,3,1,3,2,34,60,225,14,15,19,386,424,384,424,7,12,0.3333333333333333,30228072.215
RYAN.SPOONER,20152016,BOS,1211.2833333333333,13,29,7,36,49,42,304,710,406,161,273,53,57,9,12,1362,1035,808,918,38,37,0.428169014084507,30228159.825
RYAN.STANTON,20152016,WSH,8.683333333333334,0,0,0,0,0,0,0,0,0,0,0,0,0,0,1,9,11,9,11,1,2,0,15114013.2
RYAN.STROME,20152016,NYI,1222.1833333333334,9,14,8,22,31,23,46,111,65,144,240,85,47,9,15,1243,1099,1026,1017,44,47,0.4144144144144144,30228138.53
RYAN.SUTER,20152016,MIN,2520.3,8,23,21,44,52,31,0,0,0,198,429,79,155,8,16,2423,2200,1672,1688,75,60,0,30228191.305
RYAN.WHITE,20152016,PHI,993.0333333333333,12,2,3,5,17,14,201,380,179,97,192,229,57,20,36,854,984,687,807,18,29,0.5289473684210526,30228126.565
SAM.BENNETT,20152016,CGY,1165.4166666666665,18,12,5,17,35,30,160,347,187,136,240,109,60,30,17,1157,1003,883,923,38,39,0.4610951008645533,30228140.575000003
SAM.CARRICK,20152016,TOR,34.4,0,0,0,0,0,0,1,1,0,4,4,4,0,0,2,18,39,17,35,0,2,1,30228028.89
SAM.GAGNER,20152016,PHI,828.3833333333334,8,5,5,10,18,13,37,103,66,101,188,19,45,7,10,832,680,678,624,24,19,0.3592233009708738,30228091.625
SAM.REINHART,20152016,BUF,1330.0500000000002,23,13,6,19,42,36,36,108,72,165,275,26,52,13,6,1413,1028,943,911,36,40,0.3333333333333333,30228136.52
SAMI.VATANEN,20152016,ANA,1674.6333333333332,10,14,16,30,40,24,0,0,0,152,323,94,109,8,13,1735,1456,1128,1085,43,41,0,30228133.08
SCOTT.GOMEZ,20152016,OTT,149.08333333333334,0,1,0,1,1,1,55,118,63,10,14,2,3,0,3,121,160,104,153,3,6,0.4661016949152542,30228044.95
SCOTT.GOMEZ,20152016,STL,236.38333333333333,1,2,5,7,8,3,70,159,89,10,18,1,3,3,3,216,196,169,174,4,9,0.44025157232704404,30228047.505000003
SCOTT.HARRINGTON,20152016,TOR,196.41666666666666,0,0,1,1,1,0,0,0,0,9,31,23,14,0,2,179,173,171,161,5,6,0,30228037.575000003
SCOTT.HARTNELL,20152016,CBJ,1231.0833333333335,23,15,11,26,49,38,0,3,3,150,240,131,41,22,42,1292,1021,919,935,46,48,0,30228144.595
SCOTT.KOSMACHUK,20152016,WPG,92.26666666666667,0,2,1,3,3,2,0,0,0,9,12,7,1,0,1,66,92,62,91,3,2,0,30228035.725
SCOTT.LAUGHTON,20152016,PHI,768.3,7,7,6,13,20,14,172,391,219,93,153,88,35,7,13,644,774,614,668,23,22,0.4398976982097187,30228109.9
SCOTT.MAYFIELD,20152016,NYI,102.65,1,0,0,0,1,1,0,0,0,4,12,12,6,2,4,73,106,71,88,3,7,0,30228033.82
SCOTT.WILSON,20152016,PIT,256.45000000000005,5,1,0,1,6,6,0,0,0,39,59,38,10,8,3,240,186,212,179,5,6,0,30228044.53
SCOTTIE.UPSHALL,20152016,STL,915.75,7,7,3,10,17,14,12,34,22,126,207,135,38,24,21,703,815,677,662,24,23,0.35294117647058826,30228099.795
SEAN.COLLINS,20152016,WSH,17.05,0,0,0,0,0,0,0,0,0,0,1,0,0,2,1,11,15,11,12,0,1,0,15114013.42
SEAN.COUTURIER,20152016,PHI,1180.9166666666665,11,15,11,26,37,26,539,1110,571,120,202,32,52,17,14,1128,1034,865,739,36,28,0.48558558558558557,30228126.604999997
SEAN.MONAHAN,20152016,CGY,1552.7666666666667,27,25,11,36,63,52,887,1739,852,197,336,38,67,10,9,1589,1338,1011,1082,56,53,0.5100632547441059,30228195.805
SERGEI.PLOTNIKOV,20152016,ARI,134.76666666666665,0,1,0,1,1,1,0,0,0,9,20,42,4,3,2,116,113,112,112,1,1,0,30228035.78
SERGEI.PLOTNIKOV,20152016,PIT,309.76666666666665,0,1,1,2,2,1,1,2,1,32,58,65,12,6,10,289,255,278,242,6,9,0.5,30228047.525
SERGEY.KALININ,20152016,N.J,1039.75,8,3,4,7,15,11,134,322,188,69,121,146,22,17,14,787,814,634,747,22,30,0.4161490683229814,30228119.08
SERGEY.TOLCHINSKY,20152016,CAR,23.55,0,1,0,1,1,1,0,1,1,1,3,1,2,0,0,21,15,21,15,1,0,0,30228025.4
SETH.GRIFFITH,20152016,BOS,39.86666666666667,0,0,1,1,1,0,0,0,0,2,4,4,1,0,2,41,46,25,44,0,4,0,30228029.675
SETH.HELGESON,20152016,N.J,265.1666666666667,0,1,0,1,1,1,0,0,0,9,22,46,4,3,7,178,254,173,243,2,7,0,30228052.98
SETH.JONES,20152016,CBJ,1002.5,2,7,10,17,19,9,0,0,0,83,191,53,66,11,6,1008,997,755,775,28,34,0,30228099.560000002
SETH.JONES,20152016,NSH,785.7,1,4,6,10,11,5,0,0,0,74,153,33,55,8,5,750,557,592,432,14,17,0,30228056.73
SHANE.DOAN,20152016,ARI,1266.85,28,12,7,19,47,40,74,143,69,171,291,116,55,11,28,1313,1108,861,950,41,34,0.5174825174825175,30228151.345
SHANE.PRINCE,20152016,NYI,401.01666666666665,6,2,1,3,9,8,2,2,0,47,76,16,17,7,2,337,420,325,404,14,10,1,30228071.775
SHANE.PRINCE,20152016,OTT,446.29999999999995,3,4,5,9,12,7,2,3,1,62,110,16,30,8,3,455,397,429,380,20,16,0.6666666666666666,30228060.384999998
SHAWN.HORCOFF,20152016,ANA,822.9833333333333,6,7,3,10,16,13,336,660,324,76,121,65,16,3,18,663,782,588,591,21,21,0.509090909090909,30228105.345
SHAWN.MATTHIAS,20152016,COL,295.9166666666667,6,3,2,5,11,9,4,8,4,35,51,8,6,0,3,269,354,219,278,13,15,0.5,30228060.259999998
SHAWN.MATTHIAS,20152016,TOR,663.5,6,5,6,11,17,11,5,16,11,66,109,60,19,8,6,650,652,574,580,20,30,0.3125,30228088.630000003
SHAWN.THORNTON,20152016,FLA,463.1333333333333,1,4,0,4,5,5,6,13,7,60,94,83,13,14,23,331,355,319,350,8,10,0.46153846153846156,30228067.18
SHAYNE.GOSTISBEHERE,20152016,PHI,1409.0333333333333,18,14,16,30,48,32,1,1,0,164,376,31,121,16,14,1652,1133,995,992,46,32,1,30228129.950000003
SHEA.THEODORE,20152016,ANA,448.83333333333337,3,3,2,5,8,6,0,0,0,34,80,7,28,2,1,437,379,299,305,15,8,0,30228054.12
SHEA.WEBER,20152016,NSH,2359.7,23,19,16,35,58,42,0,0,0,217,459,217,131,9,20,2344,2281,1661,1610,56,71,0,30228196.09
SIDNEY.CROSBY,20152016,PIT,2128.083333333333,42,37,24,61,103,79,1281,2469,1188,317,575,122,131,28,22,2575,1685,1700,1431,78,63,0.5188335358444714,30228239.869999997
SIMON.DESPRES,20152016,ANA,750,0,1,3,4,4,1,0,0,0,36,78,87,26,5,7,612,758,555,582,20,27,0,30228080.325000003
SLATER.KOEKKOEK,20152016,T.B,193.41666666666666,0,2,0,2,2,2,0,0,0,20,42,13,13,2,2,197,183,195,182,6,7,0,30228041.12
SONNY.MILANO,20152016,CBJ,40.13333333333333,0,1,0,1,1,1,0,0,0,2,5,4,0,0,0,37,30,37,30,2,1,0,30228027
STANISLAV.GALIEV,20152016,WSH,218.88333333333333,0,3,0,3,3,3,0,0,0,30,56,14,10,1,2,211,173,180,168,6,4,0,30228041.259999998
STEFAN.ELLIOTT,20152016,ARI,270.48333333333335,2,3,1,4,6,5,0,0,0,35,67,10,22,2,2,257,242,223,230,8,9,0,30228048.045
STEFAN.ELLIOTT,20152016,NSH,27.016666666666666,0,0,0,0,0,0,0,0,0,2,4,2,2,0,0,18,32,17,30,1,2,0,30228027.3
STEFAN.MATTEAU,20152016,MTL,127.55,0,0,1,1,1,0,0,0,0,5,17,28,8,3,2,97,126,97,125,2,6,0,30228037.055
STEFAN.MATTEAU,20152016,N.J,201.46666666666667,1,0,0,0,1,1,0,0,0,22,36,39,7,4,5,152,153,132,149,2,10,0,30228040.990000002
STEFAN.NOESEN,20152016,ANA,10.033333333333333,0,0,0,0,0,0,0,0,0,0,0,3,0,1,0,4,7,2,6,0,0,0,15114012.81
STEPHEN.GIONTA,20152016,N.J,1001.2666666666667,1,6,4,10,11,7,291,691,400,61,109,113,22,12,16,563,917,532,667,16,27,0.4211287988422576,30228118.71
STEPHEN.JOHNS,20152016,DAL,442.03333333333336,1,0,1,1,2,1,0,0,0,19,63,96,23,5,6,410,410,389,377,11,17,0,30228058.675
STEVE.BERNIER,20152016,NYI,346,1,1,4,5,6,2,1,1,0,33,53,67,15,3,3,275,323,269,317,8,7,1,30228058.32
STEVE.DOWNIE,20152016,ARI,234.05,3,2,1,3,6,5,2,4,2,22,36,29,7,9,12,188,196,175,192,9,7,0.5,30228047.995
STEVE.OTT,20152016,STL,291.16666666666663,0,2,1,3,3,2,55,99,44,27,38,61,4,10,14,206,276,199,212,7,9,0.5555555555555556,30228050.575000003
STEVEN.KAMPFER,20152016,FLA,709.25,0,0,4,4,4,0,1,2,1,54,98,70,25,9,13,557,662,508,566,20,15,0.5,30228081.83
STEVEN.SANTINI,20152016,N.J,14.583333333333334,0,0,0,0,0,0,0,0,0,1,1,0,0,1,1,5,13,5,13,2,0,0,15114013.61
STEVEN.STAMKOS,20152016,T.B,1533.0166666666667,36,17,11,28,64,53,466,935,469,217,406,111,94,20,17,1565,1249,1053,996,46,38,0.4983957219251337,30228167.515
STUART.PERCY,20152016,TOR,39.483333333333334,0,0,0,0,0,0,0,0,0,1,5,4,3,0,0,29,35,29,35,0,2,0,30228027.4
SVEN.ANDRIGHETTO,20152016,MTL,621.1833333333334,7,5,5,10,17,12,3,7,4,74,131,71,30,9,2,643,517,548,487,24,18,0.42857142857142855,30228073.835
SVEN.BAERTSCHI,20152016,VAN,928.6166666666667,15,8,5,13,28,23,0,1,1,108,188,30,37,16,7,838,824,647,754,25,30,0,30228117.384999998
T.J..OSHIE,20152016,WSH,1745.0666666666666,32,12,17,29,61,44,173,321,148,217,379,151,77,34,21,1941,1539,1261,1182,57,35,0.5389408099688473,30228168.435000002
TANNER.GLASS,20152016,NYR,624.1500000000001,4,2,1,3,7,6,8,24,16,51,86,242,16,18,19,451,652,439,594,15,20,0.3333333333333333,30228096.775
TANNER.KERO,20152016,CHI,208.98333333333332,1,2,0,2,3,3,55,123,68,26,42,19,9,3,1,172,245,150,177,5,8,0.44715447154471544,30228047.08
TANNER.PEARSON,20152016,L.A,1208.7666666666667,16,15,8,23,39,31,9,27,18,143,280,119,69,20,9,1221,979,1012,733,39,28,0.3333333333333333,30228096.71
TAYLOR.BECK,20152016,NYI,16.96666666666667,0,0,0,0,0,0,0,0,0,0,3,6,1,1,1,10,16,10,16,0,0,0,30228025.91
TAYLOR.CHORNEY,20152016,WSH,813.5,1,3,2,5,6,4,0,0,0,30,87,65,37,2,11,665,800,644,663,33,26,0,30228086.42
TAYLOR.FEDUN,20152016,VAN,18.799999999999997,0,1,0,1,1,1,0,0,0,0,0,3,0,0,0,9,18,9,17,1,0,0,15114014.5
TAYLOR.HALL,20152016,EDM,1573.0833333333335,25,29,10,39,64,54,14,39,25,284,472,82,106,24,27,1720,1291,1225,1146,57,53,0.358974358974359,30228164
TAYLOR.LEIER,20152016,PHI,46.33333333333333,0,0,0,0,0,0,0,0,0,3,9,2,4,2,0,26,46,25,45,0,0,0,30228029.07
TEDDY.PURCELL,20152016,EDM,1062.7,11,11,9,20,31,22,1,5,4,130,244,27,63,6,5,1076,870,786,729,33,34,0.2,30228101.575
TEDDY.PURCELL,20152016,FLA,308.01666666666665,5,4,4,8,13,9,1,1,0,31,59,10,14,3,1,262,268,192,246,8,12,1,30228055.72
TEEMU.PULKKINEN,20152016,DET,416.4166666666667,6,2,3,5,11,8,0,1,1,65,135,5,31,6,7,458,268,332,242,9,6,0,30228047.634999998
TEUVO.TERAVAINEN,20152016,CHI,1281.5166666666667,13,16,7,23,36,29,139,349,210,149,262,28,63,15,11,1138,1046,896,855,27,30,0.3982808022922636,30228130.735
THOMAS.HICKEY,20152016,NYI,1298.0666666666666,7,10,3,13,20,17,0,0,0,75,180,79,57,16,19,1078,1338,943,1020,43,36,0,30228132.235
THOMAS.VANEK,20152016,MIN,1155.2,18,17,6,23,41,35,12,38,26,146,248,18,56,6,10,1157,983,745,894,33,33,0.3157894736842105,30228139.939999998
TIM.JACKMAN,20152016,ANA,11.466666666666667,0,0,0,0,0,0,0,0,0,1,1,2,0,1,2,12,15,12,15,0,2,0,30228026.01
TIM.SCHALLER,20152016,BUF,141.5,1,1,1,2,3,2,40,113,73,18,26,13,4,4,1,94,142,89,103,4,2,0.35398230088495575,30228039.465
TJ.BRENNAN,20152016,TOR,105.68333333333334,1,0,0,0,1,1,0,0,0,11,26,7,8,0,3,95,94,91,89,1,7,0,30228033.15
TJ.BRODIE,20152016,CGY,1768.2333333333331,6,16,21,37,43,22,0,0,0,79,197,15,84,16,10,1556,1670,1201,1220,62,58,0,30228145.235
TOBIAS.ENSTROM,20152016,WPG,1501.5166666666669,2,5,8,13,15,7,0,0,0,50,120,25,44,10,22,1286,1270,1082,1006,47,42,0,30228117.8
TOBIAS.LINDBERG,20152016,TOR,95.03333333333333,0,1,1,2,2,1,0,3,3,12,25,10,7,0,1,105,82,74,76,3,2,0,30228031.725
TOBIAS.RIEDER,20152016,ARI,1419.05,14,14,9,23,37,28,10,29,19,189,349,54,81,24,4,1373,1342,963,981,35,48,0.3448275862068966,30228134.915
TOM.GILBERT,20152016,MTL,758.8666666666667,1,1,0,1,2,2,0,0,0,36,82,29,36,2,6,628,754,560,585,18,22,0,30228079.62
TOM.KUHNHACKL,20152016,PIT,775.8833333333333,7,9,4,13,20,16,1,4,3,67,106,120,21,13,6,568,773,540,671,24,23,0.25,30228105.57
TOM.SESTITO,20152016,PIT,23.183333333333334,0,0,1,1,1,0,0,0,0,1,1,13,0,2,4,10,22,10,22,1,0,0,15114015.395
TOM.WILSON,20152016,WSH,1203.05,7,14,3,17,24,21,8,16,8,107,210,293,58,47,59,909,1287,858,986,37,38,0.5,30228142.564999998
TOMAS.FLEISCHMANN,20152016,CHI,312.1166666666667,4,1,0,1,5,5,12,19,7,26,48,12,12,2,2,248,296,222,204,7,15,0.631578947368421,30228045.85
TOMAS.FLEISCHMANN,20152016,MTL,886.65,10,7,3,10,20,17,12,26,14,100,169,30,40,10,14,753,814,641,656,26,28,0.46153846153846156,30228099.305
TOMAS.HERTL,20152016,S.J,1649.6166666666668,27,14,16,30,57,41,271,484,213,252,435,135,100,34,17,1817,1325,1540,1215,72,45,0.5599173553719008,30228154.68
TOMAS.JURCO,20152016,DET,404.04999999999995,4,2,0,2,6,6,1,1,0,43,76,50,18,5,8,329,295,304,287,10,15,1,30228054.939999998
TOMAS.NOSEK,20152016,DET,60.8,0,0,0,0,0,0,4,8,4,2,5,6,2,0,1,33,40,32,29,0,2,0.5,30228026.86
TOMAS.PLEKANEC,20152016,MTL,1519.6333333333332,14,21,19,40,54,35,803,1614,811,189,323,60,73,16,17,1560,1304,1056,955,46,40,0.49752168525402723,30228164.055
TOMAS.TATAR,20152016,DET,1237.6333333333332,21,11,14,25,46,32,7,26,19,171,299,80,61,15,13,1329,776,926,707,41,35,0.2692307692307692,30228101.78
TOMMY.CROSS,20152016,BOS,39.266666666666666,0,1,0,1,1,1,0,0,0,0,3,3,3,1,0,30,36,29,31,1,3,0,30228027.16
TOMMY.WINGELS,20152016,S.J,1141.85,9,7,3,10,19,16,39,99,60,134,209,282,27,40,28,919,1057,821,875,21,31,0.3939393939393939,30228131.285
TOREY.KRUG,20152016,BOS,1750.7166666666667,4,26,13,39,43,30,2,2,0,244,491,61,149,16,14,1991,1435,1290,1229,56,43,1,30228145.615000002
TORREY.MITCHELL,20152016,MTL,900.6833333333333,11,5,2,7,18,16,370,717,347,69,102,67,16,13,20,671,899,612,665,19,22,0.5160390516039052,30228118.73
TRAVIS.HAMONIC,20152016,NYI,2002.8,6,5,12,17,23,11,0,0,0,159,367,175,123,16,16,1731,2045,1535,1552,59,65,0,30228171.11
TRAVIS.MOEN,20152016,DAL,228.7,0,1,1,2,2,1,4,6,2,16,24,37,4,8,6,154,210,150,183,2,7,0.6666666666666666,30228045.515
TRAVIS.ZAJAC,20152016,N.J,1469.3833333333332,14,14,13,27,41,28,714,1386,672,111,186,64,36,14,11,1122,1309,721,861,31,28,0.5151515151515151,30228159.325000003
TREVOR.CARRICK,20152016,CAR,33.31666666666667,0,0,0,0,0,0,0,0,0,3,6,1,2,0,0,29,33,29,31,1,2,0,15114014.9
TREVOR.DALEY,20152016,CHI,428,0,4,2,6,6,4,0,1,1,43,100,19,37,1,4,464,330,392,320,15,12,0,30228049.759999998
TREVOR.DALEY,20152016,PIT,1416.2,7,8,12,20,27,15,0,0,0,116,230,32,74,11,18,1405,1210,1097,996,50,40,0,30228118.76
TREVOR.LEWIS,20152016,L.A,1145.0333333333333,10,5,3,8,18,15,110,275,165,173,277,176,41,10,12,1010,969,904,721,24,34,0.4,30228104.875
TREVOR.VAN RIEMSDYK,20152016,CHI,1805.9,4,7,3,10,14,11,0,0,0,96,214,46,77,12,15,1571,1735,1391,1397,49,59,0,30228159.145000003
TROY.BROUWER,20152016,STL,1773.2166666666667,25,14,12,26,51,39,67,119,52,176,315,280,63,19,30,1553,1683,1207,1262,48,44,0.5630252100840336,30228177.82
TUOMO.RUUTU,20152016,N.J,379.6166666666667,0,1,0,1,1,1,2,5,3,34,52,63,8,2,4,258,296,250,276,6,13,0.4,30228053.799999997
TURNER.ELSON,20152016,CGY,14.899999999999999,0,0,1,1,1,0,0,0,0,0,0,2,0,0,0,3,16,3,7,1,0,0,15114012.825
TY.RATTIE,20152016,STL,120.73333333333333,4,2,0,2,6,6,0,0,0,16,24,6,2,1,2,100,94,98,93,6,6,0,30228036.86
TYE.MCGINN,20152016,T.B,17.083333333333336,0,0,0,0,0,0,0,0,0,1,2,0,0,0,1,12,14,12,14,0,0,0,15114013.7
TYLER.BOZAK,20152016,TOR,988.4666666666667,12,12,11,23,35,24,596,1058,462,99,183,46,47,9,9,1198,868,806,762,27,33,0.5633270321361059,30228126.255000003
TYLER.ENNIS,20152016,BUF,415.56666666666666,3,3,4,7,10,6,2,2,0,57,102,30,22,5,4,406,363,277,330,6,13,1,30228062.98
TYLER.GAUDET,20152016,ARI,148.4,1,1,1,2,3,2,43,92,49,6,14,23,3,1,0,110,128,100,97,4,6,0.4673913043478261,30228036.155
TYLER.GRAOVAC,20152016,MIN,23.216666666666665,0,0,0,0,0,0,13,19,6,2,6,1,3,0,0,23,17,23,17,0,1,0.6842105263157895,15114013.22
TYLER.JOHNSON,20152016,T.B,1484.7333333333333,21,26,8,34,55,47,603,1271,668,200,355,68,71,22,17,1583,1233,1073,1012,56,40,0.47442958300550747,30228172.84
TYLER.KENNEDY,20152016,N.J,671.25,3,8,5,13,16,11,23,58,35,72,125,35,31,6,7,570,470,449,441,14,25,0.39655172413793105,30228074.055
TYLER.MYERS,20152016,WPG,1650.3833333333332,9,7,9,16,25,16,0,1,1,139,287,54,93,9,24,1507,1446,1146,1060,43,39,0,30228126.814999998
TYLER.RANDELL,20152016,BOS,188.53333333333333,6,0,0,0,6,6,0,0,0,18,21,39,1,7,11,124,191,124,187,9,11,0,30228051.17
TYLER.SEGUIN,20152016,DAL,1415.5166666666667,33,26,14,40,73,59,470,845,375,279,516,84,130,15,9,1758,1123,1170,962,54,55,0.5562130177514792,30228150.15
TYLER.TOFFOLI,20152016,L.A,1503.2166666666667,31,16,12,28,59,47,0,4,4,222,439,79,108,9,11,1833,1206,1331,924,56,34,0,30228115.89
TYLER.WOTHERSPOON,20152016,CGY,155.86666666666667,0,0,1,1,1,0,0,0,0,9,30,14,15,0,0,135,143,134,117,4,5,0,30228032.525
TYSON.BARRIE,20152016,COL,1809.5666666666666,13,19,15,34,47,32,0,0,0,172,353,37,122,19,14,1747,1704,1211,1503,57,56,0,30228193.615000002
TYSON.STRACHAN,20152016,MIN,15.1,0,0,0,0,0,0,0,0,0,0,2,4,1,0,0,16,10,16,10,1,0,0,30228024.4
VALERI.NICHUSHKIN,20152016,DAL,1235.45,9,11,10,21,30,20,0,0,0,150,272,82,58,12,7,1281,1067,1119,1022,45,41,0,30228127.67
VALTTERI.FILPPULA,20152016,T.B,1740.35,9,16,13,29,38,25,822,1578,756,130,207,36,46,14,22,1610,1581,1144,1115,37,38,0.5209125475285171,30228177.195
VERNON.FIDDLER,20152016,DAL,1070.55,13,5,7,12,25,18,502,993,491,106,205,56,41,20,16,851,1138,750,766,25,27,0.5055387713997986,30228131.305
VICTOR.BARTLEY,20152016,MTL,119.93333333333334,0,0,0,0,0,0,0,0,0,8,15,19,2,0,3,113,123,111,120,6,3,0,30228036.1
VICTOR.BARTLEY,20152016,NSH,13.25,0,0,0,0,0,0,0,0,0,0,1,2,0,0,0,8,23,8,23,0,1,0,15114015.05
VICTOR.HEDMAN,20152016,T.B,2265.583333333333,14,26,20,46,60,40,0,0,0,227,509,83,172,13,26,2316,1951,1706,1363,76,50,0,30228146.93
VICTOR.RASK,20152016,CAR,1358.65,21,10,16,26,47,31,479,935,456,160,295,32,60,12,11,1452,1128,971,989,42,46,0.5122994652406417,30228157.68
VIKTOR.ARVIDSSON,20152016,NSH,883.3166666666666,9,5,4,9,18,14,0,4,4,163,285,38,67,11,16,907,767,868,737,24,36,0,30228097.71
VIKTOR.LOOV,20152016,TOR,41.83333333333333,0,0,2,2,2,0,0,0,0,1,7,8,2,0,0,41,33,41,32,4,0,0,15114014.05
VIKTOR.STALBERG,20152016,NYR,969.8,9,5,6,11,20,14,2,6,4,135,225,157,37,18,12,775,998,725,807,29,23,0.3333333333333333,30228117.310000002
VIKTOR.SVEDBERG,20152016,CHI,449.44999999999993,2,0,1,1,3,2,0,0,0,42,93,13,37,2,5,397,450,380,409,12,17,0,30228063.345
VIKTOR.TIKHONOV,20152016,ARI,458.59999999999997,3,1,2,3,6,4,45,115,70,30,65,35,12,5,7,353,430,300,405,7,11,0.391304347826087,30228075.35
VIKTOR.TIKHONOV,20152016,CHI,113.11666666666667,0,0,0,0,0,0,0,1,1,11,19,19,4,3,3,106,85,103,85,0,4,0,30228032.08
VINCENT.HINOSTROZA,20152016,CHI,60.833333333333336,0,0,0,0,0,0,13,31,18,6,10,2,1,4,2,44,55,42,54,1,2,0.41935483870967744,30228031.11
VINCENT.LECAVALIER,20152016,L.A,654.2166666666667,11,5,3,8,19,16,337,647,310,68,125,71,29,4,11,630,534,470,456,16,14,0.5208655332302936,30228090.045
VINCENT.LECAVALIER,20152016,PHI,66.21666666666667,0,1,0,1,1,1,2,7,5,7,8,2,0,0,1,47,78,46,75,1,2,0.2857142857142857,30228034.08
VINCENT.TROCHECK,20152016,FLA,1413.6166666666668,25,18,11,29,54,43,575,1172,597,178,313,137,64,25,22,1330,1083,927,882,50,31,0.4906143344709898,30228157.625
VLADIMIR.TARASENKO,20152016,STL,1851.2166666666667,49,18,22,40,89,67,1,3,2,353,676,60,200,29,17,2044,1544,1446,1295,63,52,0.3333333333333333,30228172.93
VLADISLAV.NAMESTNIKOV,20152016,T.B,1303.6,15,12,11,23,38,27,231,508,277,121,203,73,43,22,19,1263,959,1036,884,47,31,0.4547244094488189,30228129.885
VOJTECH.MOZIK,20152016,N.J,92.68333333333334,0,0,0,0,0,0,0,0,0,6,9,12,1,0,2,67,68,67,67,2,2,0,30228030.85
WAYNE.SIMMONDS,20152016,PHI,1502.75,32,19,11,30,62,51,5,7,2,246,422,214,86,36,44,1908,1247,1172,1074,48,44,0.7142857142857143,30228159.384999998
WILLIAM.KARLSSON,20152016,CBJ,1171.9666666666667,9,6,4,10,19,15,416,911,495,108,179,40,33,10,3,882,1152,801,816,31,38,0.4566410537870472,30228133.189999998
WILLIAM.NYLANDER,20152016,TOR,359.4333333333333,6,5,2,7,13,11,143,291,148,43,99,5,28,6,2,424,260,283,242,9,8,0.49140893470790376,30228056.18
WILLIE.MITCHELL,20152016,FLA,916.5666666666666,1,1,3,4,5,2,0,0,0,33,77,68,27,6,9,564,985,522,703,28,29,0,30228099.634999998
XAVIER.OUELLET,20152016,DET,81.21666666666667,0,1,0,1,1,1,0,0,0,4,10,5,3,0,1,63,73,61,64,2,4,0,30228030.700000003
YANNI.GOURDE,20152016,T.B,14.633333333333333,0,1,0,1,1,1,0,0,0,0,1,2,0,0,1,6,13,6,13,1,0,0,15114014.2
YANNICK.WEBER,20152016,VAN,847.35,0,5,2,7,7,5,0,0,0,65,158,49,59,1,12,780,703,563,599,21,28,0,30228081.66
ZAC.DALPE,20152016,MIN,44.96666666666667,1,0,0,0,1,1,21,42,21,3,5,5,1,0,0,21,28,16,24,1,2,0.5,30228028.189999998
ZAC.RINALDO,20152016,BOS,431.3833333333333,1,1,1,2,3,2,0,1,1,38,64,153,10,15,22,269,431,262,413,11,16,0,30228076.424999997
ZACH.BOGOSIAN,20152016,BUF,1429.4666666666667,7,6,10,16,23,13,0,0,0,121,218,86,58,14,23,1207,1367,959,1114,43,49,0,30228146.59
ZACH.HYMAN,20152016,TOR,250.98333333333335,4,2,0,2,6,6,1,3,2,37,68,31,11,9,5,246,215,211,169,6,7,0.3333333333333333,30228042.93
ZACH.PARISE,20152016,MIN,1350.4333333333334,25,14,13,27,52,39,0,4,4,234,385,71,70,21,15,1484,1156,932,957,33,30,0,30228146.035
ZACH.REDMOND,20152016,COL,435.81666666666666,2,4,0,4,6,6,0,0,0,22,62,47,22,3,5,362,417,352,404,18,13,0,30228066.48
ZACH.SILL,20152016,WSH,99.33333333333334,1,0,0,0,1,1,33,77,44,13,23,20,7,2,1,83,90,82,75,3,1,0.42857142857142855,30228033.04
ZACH.TROTMAN,20152016,BOS,705.05,2,2,3,5,7,4,0,0,0,59,122,71,46,2,11,615,725,559,603,27,28,0,30228082.895
ZACK.KASSIAN,20152016,EDM,448.26666666666665,3,2,2,4,7,5,1,4,3,42,77,95,20,10,29,368,430,347,416,9,17,0.25,30228074.740000002
ZACK.SMITH,20152016,OTT,1247.3833333333332,25,7,3,10,35,32,380,729,349,121,220,175,44,34,29,1214,1150,915,869,36,26,0.5212620027434842,30228142.565
ZBYNEK.MICHALEK,20152016,ARI,1191.15,2,1,4,5,7,3,0,0,0,69,133,84,41,8,10,798,1291,736,940,33,36,0,30228124.380000003
ZDENO.CHARA,20152016,BOS,1927.75,9,15,13,28,37,24,0,1,1,158,312,134,95,21,33,1698,1955,1356,1376,60,52,0,30228167.985
ZEMGUS.GIRGENSONS,20152016,BUF,1067.5666666666666,7,9,2,11,18,16,153,335,182,110,179,125,38,25,8,887,961,725,748,23,19,0.45671641791044776,30228115.32
AARON.EKBLAD,20162017,FLA,1459.2833333333333,10,4,7,11,21,14,0,0,0,225,408,88,112,16,28,1549,1170,1084,1003,30,47,0,30243125.785
AARON.NESS,20162017,WSH,25.666666666666664,0,0,0,0,0,0,0,0,0,0,1,2,0,0,0,16,25,16,25,0,1,0,30243028.450000003
ADAM.CLENDENING,20162017,NYR,489.9333333333333,2,2,7,9,11,4,0,0,0,38,88,22,31,5,7,505,356,431,336,18,16,0,30243053.025
ADAM.CRACKNELL,20162017,DAL,721.75,10,3,3,6,16,13,135,295,160,86,169,91,43,14,6,697,698,668,642,26,20,0.4576271186440678,30243098.915
ADAM.ERNE,20162017,T.B,306.98333333333335,3,0,0,0,3,3,0,2,2,40,65,71,7,6,4,286,249,248,240,4,12,0,30243052.31
ADAM.HENRIQUE,20162017,N.J,1490.1166666666668,20,13,7,20,40,33,585,1212,627,142,243,88,53,19,16,1260,1419,865,980,35,45,0.48267326732673266,30243172.915
ADAM.LARSSON,20162017,EDM,1900.1833333333334,6,4,12,16,22,10,0,0,0,100,241,295,90,8,27,1677,1955,1536,1571,77,65,0,30243175.73
ADAM.LOWRY,20162017,WPG,1316.0333333333333,15,7,7,14,29,22,658,1295,637,122,200,217,36,16,18,1127,1299,814,877,32,34,0.5081081081081081,30243155.255
ADAM.MCQUAID,20162017,BOS,1427.4,2,4,4,8,10,6,0,0,0,66,140,158,44,18,23,1302,1362,1208,1015,41,47,0,30243115.43
ADAM.PARDY,20162017,NSH,43.96666666666667,0,0,0,0,0,0,0,0,0,4,6,3,1,0,3,37,47,37,47,1,2,0,30243031.05
ADAM.PELECH,20162017,NYI,740.7,3,1,6,7,10,4,0,0,0,40,88,73,31,6,3,584,729,567,647,27,32,0,30243091.11
ADRIAN.KEMPE,20162017,L.A,305.76666666666665,2,3,1,4,6,5,67,153,86,32,61,23,17,5,3,301,233,262,196,4,5,0.43790849673202614,30243047.505000003
AJ.GREER,20162017,COL,68.28333333333333,0,0,1,1,1,0,0,0,0,8,11,4,1,2,2,66,57,60,56,1,3,0,30243031.395
ALAN.QUINE,20162017,NYI,763.7666666666667,5,6,7,13,18,11,264,550,286,82,125,77,26,4,4,717,825,622,734,34,33,0.48,30243119.225
ALEC.MARTINEZ,20162017,L.A,1774.5833333333335,9,13,15,28,37,22,0,1,1,144,333,137,109,5,12,1804,1536,1375,1141,44,60,0,30243128.625
ALEKSANDER.BARKOV,20162017,FLA,1184.1,21,21,10,31,52,42,476,1022,546,142,226,39,37,18,5,1270,846,817,668,41,30,0.4657534246575342,30243130.72
ALES.HEMSKY,20162017,DAL,216.3,4,3,0,3,7,7,0,0,0,30,52,1,11,1,0,212,180,168,159,5,5,0,30243044.509999998
ALEX.BIEGA,20162017,VAN,474.06666666666666,0,1,2,3,3,1,0,0,0,37,79,97,20,2,9,393,454,381,401,11,14,0,30243065.869999997
ALEX.BURMISTROV,20162017,ARI,400.48333333333335,5,6,3,9,14,11,125,290,165,32,57,32,13,5,3,337,390,242,344,11,14,0.43103448275862066,30243077.525
ALEX.BURMISTROV,20162017,WPG,253.95,0,2,0,2,2,2,53,147,94,13,32,27,12,2,3,166,250,154,193,2,9,0.36054421768707484,30243051.04
ALEX.BURROWS,20162017,OTT,491.18333333333334,6,6,4,10,16,12,6,11,5,49,97,49,32,7,8,467,454,367,400,18,10,0.5454545454545454,30243071.36
ALEX.BURROWS,20162017,VAN,822.8,9,7,4,11,20,16,0,6,6,114,179,44,35,15,17,662,816,603,639,26,29,0,30243101.200000003
ALEX.CARRIER,20162017,NSH,20.78333333333333,0,0,0,0,0,0,0,0,0,1,1,0,0,0,0,15,16,13,16,0,0,0,15121514.55
ALEX.CHIASSON,20162017,CGY,1135.7333333333333,12,5,7,12,24,17,7,29,22,106,171,85,38,10,16,1000,952,869,811,32,38,0.2413793103448276,30243113.705
ALEX.EDLER,20162017,VAN,1653.3333333333335,6,7,8,15,21,13,2,3,1,138,309,106,115,7,19,1465,1597,1141,1199,43,56,0.6666666666666666,30243143.1
ALEX.GALCHENYUK,20162017,MTL,1071.2666666666667,17,17,13,30,47,34,287,677,390,117,226,37,56,8,12,1147,950,869,859,35,37,0.4239290989660266,30243143.835
ALEX.GOLIGOSKI,20162017,ARI,1913,6,14,16,30,36,20,0,0,0,112,235,137,79,9,14,1661,2028,1263,1514,54,63,0,30243190.39
ALEX.GRENIER,20162017,VAN,19.45,0,0,0,0,0,0,2,2,0,1,4,3,2,0,0,19,9,19,9,0,1,1,15121512.88
ALEX.KILLORN,20162017,T.B,1458.2333333333333,19,11,6,17,36,30,4,12,8,177,297,99,54,24,30,1414,1204,1005,953,36,43,0.3333333333333333,30243138.45
ALEX.NYLANDER,20162017,BUF,49.31666666666666,0,1,0,1,1,1,0,1,1,4,8,1,3,0,0,47,50,46,47,1,2,0,30243030.450000003
ALEX.OVECHKIN,20162017,WSH,1759.4833333333333,38,22,16,38,76,60,0,1,1,362,721,277,198,23,29,2154,1449,1377,1312,66,51,0,30243176.48
ALEX.PETROVIC,20162017,FLA,889.3499999999999,1,4,7,11,12,5,0,0,0,55,109,106,26,14,27,758,807,715,689,30,34,0,30243095.064999998
ALEX.PIETRANGELO,20162017,STL,2333.5333333333338,14,21,16,37,51,35,0,1,1,209,387,45,108,10,16,2047,2193,1525,1553,73,64,0,30243190.6
ALEX.RADULOV,20162017,MTL,1509.5500000000002,20,28,12,40,60,48,9,15,6,157,298,95,73,22,31,1690,1202,1254,1069,56,37,0.6,30243147.03
ALEX.STEEN,20162017,STL,1659.1666666666667,19,22,16,38,57,41,114,287,173,137,265,41,61,25,23,1431,1470,933,1037,45,40,0.397212543554007,30243163.159999996
ALEX.TUCH,20162017,MIN,64.21666666666667,0,0,0,0,0,0,0,0,0,8,15,5,5,0,0,66,64,66,64,1,4,0,30243031.299999997
ALEX.WENNBERG,20162017,CBJ,1567.4333333333334,13,28,19,47,60,41,644,1367,723,119,207,62,57,17,10,1610,1234,1108,1033,48,41,0.47110460863204096,30243172.555
ALEXEI.EMELIN,20162017,MTL,1656.2666666666667,3,3,5,8,11,6,0,0,0,84,204,249,74,19,33,1367,1661,1305,1274,44,44,0,30243147.115000002
ALEXEY.MARCHENKO,20162017,DET,539.4166666666667,0,1,5,6,6,1,0,0,0,27,56,8,15,2,6,397,581,383,434,18,12,0,30243069.695
ALEXEY.MARCHENKO,20162017,TOR,155.58333333333331,1,0,1,1,2,1,0,0,0,9,24,14,6,1,0,152,166,150,160,6,5,0,30243041.435000002
ANDERS.LEE,20162017,NYI,1262.65,34,11,7,18,52,45,7,18,11,191,288,172,37,15,24,1445,1053,1085,983,54,41,0.3888888888888889,30243149.205
ANDRE.BURAKOVSKY,20162017,WSH,1035.1499999999999,15,11,15,26,41,26,3,9,6,138,274,49,88,9,9,1216,801,999,755,42,24,0.3333333333333333,30243095.585
ANDREAS.ATHANASIOU,20162017,DET,861.7166666666667,18,5,6,11,29,23,37,83,46,120,236,30,55,15,10,778,764,582,643,28,28,0.4457831325301205,30243105.78
ANDREAS.ENGLUND,20162017,OTT,52.95,0,0,0,0,0,0,0,0,0,3,7,18,1,0,1,37,51,31,44,1,4,0,30243030.55
ANDREAS.MARTINSEN,20162017,COL,529.85,3,3,1,4,7,6,NA,NA,NA,NA,NA,NA,NA,5,13,376,562,338,452,9,20,NA,NA
ANDREAS.MARTINSEN,20162017,MTL,127.56666666666666,0,0,0,0,0,0,0,1,1,17,25,36,2,0,0,90,131,90,131,0,5,0,30243041.25
ANDREI.MARKOV,20162017,MTL,1510.7333333333333,6,22,9,31,37,28,0,0,0,106,241,43,90,10,9,1543,1322,1193,1036,48,31,0,30243124.275
ANDREJ.NESTRASIL,20162017,CAR,207.16666666666666,1,3,1,4,5,4,3,10,7,27,39,10,6,0,2,192,167,168,163,6,8,0.3,30243044.145
ANDREJ.SEKERA,20162017,EDM,1951.55,9,14,13,27,36,23,0,0,0,146,358,68,143,7,9,1868,1877,1326,1407,52,43,0,30243164.695
ANDREJ.SUSTR,20162017,T.B,1407.1166666666668,3,5,5,10,13,8,0,1,1,93,164,45,45,4,21,1121,1419,1069,1114,37,47,0,30243139.965
ANDREW.COGLIANO,20162017,ANA,1476.25,17,12,9,21,38,29,13,23,10,210,354,94,83,20,15,1446,1417,1344,1145,47,43,0.5652173913043478,30243143.045
ANDREW.COPP,20162017,WPG,789.95,9,6,2,8,17,15,95,191,96,77,126,87,23,4,9,612,762,556,583,24,18,0.4973821989528796,30243096.939999998
ANDREW.DESJARDINS,20162017,CHI,432.4666666666667,0,0,1,1,1,0,39,69,30,46,84,73,25,9,8,390,437,379,378,10,16,0.5652173913043478,30243062.775
ANDREW.LADD,20162017,NYI,1261.6999999999998,23,7,1,8,31,30,4,10,6,141,276,112,71,10,20,1240,1225,910,1043,32,44,0.4,30243151.435000002
ANDREW.MACDONALD,20162017,PHI,1467.9,2,12,4,16,18,14,0,0,0,65,159,39,64,10,12,1141,1558,1057,1145,33,43,0,30243143.3
ANDREW.POTURALSKI,20162017,CAR,24.53333333333333,0,0,0,0,0,0,12,24,12,1,1,1,0,0,0,17,33,17,32,0,3,0.5,30243029.98
ANDREW.SHAW,20162017,MTL,1108.75,12,7,10,17,29,19,250,472,222,140,244,159,58,25,30,1191,869,957,790,33,32,0.5296610169491526,30243115.85
ANDY.ANDREOFF,20162017,L.A,381.46666666666664,0,2,0,2,2,2,41,69,28,38,81,70,24,10,20,364,309,350,301,6,8,0.5942028985507246,30243055.740000002
ANDY.GREENE,20162017,N.J,1448.3000000000002,4,6,3,9,13,10,0,0,0,83,190,50,53,6,5,1105,1455,917,1000,28,42,0,30243128.785
ANTHONY.BEAUVILLIER,20162017,NYI,859.3833333333333,9,8,7,15,24,17,123,297,174,101,170,81,35,5,5,755,889,691,873,37,34,0.41414141414141414,30243135.645
ANTHONY.BITETTO,20162017,NSH,342.3,0,3,4,7,7,3,0,0,0,17,45,43,16,2,11,289,362,277,348,14,16,0,30243063.82
ANTHONY.DEANGELO,20162017,ARI,666.6,5,4,5,9,14,9,0,0,0,60,111,31,29,6,9,678,650,501,595,14,24,0,30243093.735
ANTHONY.DUCLAIR,20162017,ARI,771.3666666666667,5,6,4,10,15,11,4,8,4,75,145,22,40,9,10,728,750,619,713,26,27,0.5,30243104.200000003
ANTHONY.MANTHA,20162017,DET,954.7,17,6,13,19,36,23,5,11,6,133,216,46,31,17,15,952,688,732,640,38,26,0.45454545454545453,30243100.045
ANTOINE.ROUSSEL,20162017,DAL,931.0999999999999,12,11,4,15,27,23,7,16,9,82,161,68,40,32,35,908,905,764,634,36,32,0.4375,30243095.799999997
ANTOINE.VERMETTE,20162017,ANA,1382.7666666666669,10,11,10,21,31,21,927,1496,569,118,212,71,43,11,18,1369,1264,1023,1016,33,40,0.6196524064171123,30243157.04
ANTON.BLIDH,20162017,BOS,166.76666666666665,1,1,0,1,2,2,0,0,0,26,47,41,10,5,2,167,135,162,122,3,4,0,30243036.65
ANTON.LANDER,20162017,EDM,215.03333333333336,1,1,2,3,4,2,79,141,62,12,21,28,4,0,2,139,209,129,132,7,7,0.5602836879432624,30243041.810000002
ANTON.LINDHOLM,20162017,COL,177.01666666666668,0,0,0,0,0,0,0,0,0,7,22,38,8,0,1,136,154,133,136,3,12,0,30243038.1
ANTON.RODIN,20162017,VAN,26.733333333333334,0,0,1,1,1,0,0,0,0,2,5,0,2,0,0,17,23,16,23,1,0,0,30243027.875
ANTON.SLEPYSHEV,20162017,EDM,591.8666666666667,7,3,3,6,13,10,2,5,3,71,147,76,52,2,3,493,602,482,591,18,12,0.4,30243090.475
ANTON.STRALMAN,20162017,T.B,1671.7333333333331,5,8,9,17,22,13,0,0,0,130,257,106,74,9,10,1446,1551,1158,1101,49,48,0,30243130.965
ANZE.KOPITAR,20162017,L.A,1578.2333333333333,12,22,17,39,51,34,892,1693,801,150,290,78,68,26,13,1734,1287,1143,951,39,43,0.5268753691671589,30243157.565
ARTEM.ANISIMOV,20162017,CHI,1211.5833333333333,22,12,10,22,44,34,431,973,542,111,202,22,53,10,15,1191,1052,854,883,43,37,0.44295991778006166,30243154.29
ARTEMI.PANARIN,20162017,CHI,1680.0833333333335,31,28,16,44,75,59,2,10,8,222,416,26,101,20,10,1927,1243,1342,1113,63,48,0.2,30243152.23
ARTTURI.LEHKONEN,20162017,MTL,1104.9499999999998,20,3,8,11,31,23,2,5,3,177,310,85,76,9,5,1130,949,984,860,35,35,0.4,30243114.72
AUSTIN.CZARNIK,20162017,BOS,637.7833333333333,5,5,2,7,12,10,57,133,76,66,119,19,20,13,6,631,475,456,384,12,19,0.42857142857142855,30243069.46
AUSTIN.WATSON,20162017,NSH,1256.9333333333334,9,12,5,17,26,21,18,45,27,118,195,249,45,23,34,850,1333,781,980,33,25,0.4,30243147.425
AUSTON.MATTHEWS,20162017,TOR,1567.5833333333335,44,21,9,30,74,65,562,1193,631,293,507,30,97,23,7,1833,1374,1325,1240,54,49,0.471081307627829,30243207.485
BARCLAY.GOODROW,20162017,S.J,33.916666666666664,0,0,0,0,0,0,0,0,0,3,6,3,2,1,0,19,34,19,33,0,0,0,30243029.36
BEAU.BENNETT,20162017,N.J,881.2666666666667,8,7,4,11,19,15,3,16,13,101,184,77,37,9,10,851,649,708,619,22,23,0.1875,30243091.11
BEN.CHIAROT,20162017,WPG,903.95,2,4,5,9,11,6,0,0,0,49,102,78,42,5,14,654,952,606,738,28,32,0,30243103.975
BEN.HARPUR,20162017,OTT,272.98333333333335,0,0,2,2,2,0,0,0,0,11,28,24,15,3,2,236,232,228,209,9,13,0,30243042.880000003
BEN.HUTTON,20162017,VAN,1455.15,5,6,7,13,18,11,0,0,0,130,268,46,93,7,14,1285,1222,1007,1092,32,47,0,30243136.195
BEN.LOVEJOY,20162017,N.J,1703.4833333333333,1,4,2,6,7,5,0,0,0,83,148,82,37,5,18,1090,1816,1024,1300,32,41,0,30243168.9
BEN.SMITH,20162017,COL,43.08333333333333,0,0,0,0,0,0,21,40,19,1,2,1,0,0,0,13,51,12,35,1,3,0.525,30243030.79
BEN.SMITH,20162017,TOR,415.56666666666666,2,1,1,2,4,3,220,428,208,29,54,28,12,3,2,286,535,270,357,8,13,0.514018691588785,30243074.555
BEN.STREET,20162017,DET,49.5,0,1,0,1,1,1,0,0,0,8,11,3,0,0,0,53,47,53,46,1,0,0,30243030.549999997
BEN.THOMSON,20162017,N.J,32.66666666666667,0,0,0,0,0,0,0,1,1,7,8,7,0,1,2,29,23,28,23,0,4,0,30243028.26
BENOIT.POULIOT,20162017,EDM,1106.1,8,5,1,6,14,13,11,33,22,95,174,57,39,19,19,950,1077,793,838,25,32,0.3333333333333333,30243119.155
BLAKE.COLEMAN,20162017,N.J,295.4666666666667,1,1,0,1,2,2,96,225,129,29,46,51,8,7,11,187,275,180,227,3,10,0.4266666666666667,30243058.810000002
BLAKE.COMEAU,20162017,COL,1153,NA,6,6,12,NA,NA,NA,NA,NA,NA,NA,NA,NA,31,25,945,1085,833,796,26,49,NA,NA
BLAKE.PIETILA,20162017,N.J,130.36666666666667,0,1,0,1,1,1,23,45,22,9,18,16,6,2,2,84,124,81,104,3,7,0.5111111111111111,30243037.89
BLAKE.SPEERS,20162017,N.J,28.450000000000003,0,0,0,0,0,0,0,2,2,3,3,1,0,0,0,15,30,15,25,0,0,0,30243028.75
BLAKE.WHEELER,20162017,WPG,1651.65,26,33,15,48,74,59,43,94,51,259,419,100,74,19,21,1800,1367,1190,980,51,50,0.4574468085106383,30243150.134999998
BO.HORVAT,20162017,VAN,1460.6,20,22,10,32,52,42,755,1497,742,158,286,65,50,14,12,1265,1441,928,1027,44,40,0.5043420173680695,30243185.29
BOBBY.FARNHAM,20162017,MTL,24.816666666666666,0,0,0,0,0,0,1,1,0,4,4,8,0,1,3,18,35,15,34,0,0,1,30243030.5
BOBBY.RYAN,20162017,OTT,1290.5333333333333,19,16,5,21,40,35,8,16,8,153,292,156,82,25,12,1392,1119,1003,1034,44,41,0.5,30243144.045
BOONE.JENNER,20162017,CBJ,1406.0833333333335,20,10,7,17,37,30,92,185,93,227,393,241,94,25,24,1347,1432,1190,1207,52,39,0.4972972972972973,30243164.105
BORNA.RENDULIC,20162017,VAN,4.85,0,0,0,0,0,0,0,0,0,1,1,0,0,0,0,9,1,9,1,0,0,0,15121512.5
BOYD.GORDON,20162017,PHI,106.31666666666666,1,0,0,0,1,1,48,86,38,8,13,4,3,0,1,72,128,67,80,1,7,0.5581395348837209,30243036.22
BRACKEN.KEARNS,20162017,NYI,22.383333333333333,0,0,0,0,0,0,10,17,7,3,5,5,0,0,1,10,30,10,30,0,1,0.5882352941176471,15121517.3
BRAD.HUNT,20162017,NSH,51.650000000000006,0,0,1,1,1,0,0,0,0,2,4,0,2,0,0,28,69,28,67,3,2,0,30243033.575
BRAD.HUNT,20162017,STL,122.36666666666667,1,1,2,3,4,2,0,0,0,12,23,0,5,0,1,119,95,110,88,5,6,0,30243033.85
BRAD.MARCHAND,20162017,BOS,1695.9833333333333,40,26,23,49,89,66,13,36,23,244,449,56,97,28,36,2007,1296,1370,922,61,49,0.3611111111111111,30243134.525
BRAD.RICHARDSON,20162017,ARI,245.53333333333333,5,1,2,3,8,6,121,230,109,25,44,19,12,4,5,187,278,166,211,6,9,0.5260869565217391,30243056.630000003
BRADY.AUSTIN,20162017,BUF,80.44999999999999,0,0,0,0,0,0,0,0,0,8,10,6,1,0,2,75,70,75,67,3,3,0,30243031.9
BRADY.SKJEI,20162017,NYR,1627.9333333333334,9,14,20,34,43,23,0,1,1,146,265,179,67,14,25,1534,1372,1241,1241,75,55,0,30243155.04
BRANDON.CARLO,20162017,BOS,1706.7,6,4,5,9,15,10,0,0,0,88,179,87,49,6,28,1487,1649,1354,1244,60,63,0,30243143.485
BRANDON.DAVIDSON,20162017,EDM,431.06666666666666,0,1,0,1,1,1,0,0,0,29,60,31,19,0,4,344,418,335,353,14,12,0,30243059.35
BRANDON.DAVIDSON,20162017,MTL,204.58333333333334,0,1,1,2,2,1,0,0,0,15,35,12,15,1,2,211,162,209,161,6,10,0,30243037.735
BRANDON.DUBINSKY,20162017,CBJ,1521.3666666666668,13,22,7,29,42,35,815,1576,761,123,222,277,56,25,32,1443,1566,1179,1171,48,41,0.5171319796954315,30243189.424999997
BRANDON.MANNING,20162017,PHI,1173.65,3,4,5,9,12,7,0,1,1,84,192,121,76,23,27,1055,1092,1004,937,32,44,0,30243112.854999997
BRANDON.MONTOUR,20162017,ANA,795.4666666666667,2,5,6,11,13,7,0,0,0,87,182,28,53,9,9,855,733,680,659,35,11,0,30243087.54
BRANDON.PIRRI,20162017,NYR,736.6333333333333,8,6,4,10,18,14,140,243,103,96,201,41,55,10,11,813,568,488,527,22,28,0.5761316872427984,30243088.1
BRANDON.SAAD,20162017,CBJ,1476.2666666666667,25,19,11,30,55,44,4,9,5,220,391,30,88,11,4,1483,1162,1219,1003,55,38,0.4444444444444444,30243134.245
BRANDON.SUTTER,20162017,VAN,1523.0333333333333,17,7,10,17,34,24,787,1451,664,160,272,78,45,22,6,1298,1372,865,1037,33,46,0.5423845623707788,30243177.05
BRANDON.TANEV,20162017,WPG,544.5166666666667,2,0,2,2,4,2,1,1,0,54,82,127,14,15,6,320,580,300,403,7,13,1,30243073.09
BRAYDEN.MCNABB,20162017,L.A,738.2,2,0,2,2,4,2,0,0,0,47,125,110,51,11,18,798,560,783,516,18,18,0,30243060.11
BRAYDEN.POINT,20162017,T.B,1164.9666666666667,18,8,14,22,40,26,238,532,294,122,214,39,43,11,8,1236,911,899,806,40,33,0.4473684210526316,30243126.78
BRAYDEN.SCHENN,20162017,PHI,1405.6833333333334,25,16,12,28,53,41,232,494,262,177,316,188,56,19,15,1749,1185,989,1056,36,41,0.46963562753036436,30243169.92
BRAYDON.COBURN,20162017,T.B,1338.8666666666668,5,4,2,6,11,9,0,0,0,102,219,109,78,8,21,1086,1277,1033,999,39,40,0,30243120.33
BRENDAN.GALLAGHER,20162017,MTL,1070.2333333333333,11,13,8,21,32,24,30,76,46,206,355,86,91,24,18,1234,861,987,801,32,25,0.39473684210526316,30243108.54
BRENDAN.GAUNCE,20162017,VAN,541,0,2,3,5,5,2,83,163,80,51,81,94,17,6,11,451,473,439,415,11,14,0.50920245398773,30243070.354999997
BRENDAN.GUHLE,20162017,BUF,49.05,0,0,0,0,0,0,0,0,0,4,9,3,4,0,0,39,53,38,52,2,0,0,30243030.7
BRENDAN.PERLINI,20162017,ARI,845.7833333333333,14,3,4,7,21,17,1,2,1,92,176,42,45,7,12,750,811,583,755,24,21,0.5,30243117.509999998
BRENDAN.SMITH,20162017,DET,618.4333333333334,2,3,0,3,5,5,0,0,0,39,97,43,40,14,14,554,551,417,425,17,19,0,30243067.09
BRENDAN.SMITH,20162017,NYR,599.15,1,6,1,7,8,7,0,0,0,34,75,41,23,11,20,470,569,435,467,24,13,0,30243075.634999998
BRENDEN.DILLON,20162017,S.J,1418.9833333333333,2,1,7,8,10,3,0,0,0,89,214,186,82,14,25,1314,1257,1271,1123,35,40,0,30243123.665
BRENT.BURNS,20162017,S.J,2163.8999999999996,29,29,20,49,78,58,0,0,0,342,819,78,312,12,23,2553,1966,1772,1533,78,52,0,30243166.77
BRENT.SEABROOK,20162017,CHI,1819.1,3,16,19,35,38,19,0,1,1,138,313,124,111,7,14,1827,1787,1360,1353,53,49,0,30243157.295
BRETT.CONNOLLY,20162017,WSH,765.4833333333333,15,7,1,8,23,22,4,14,10,87,140,96,33,10,20,789,630,726,612,33,16,0.2857142857142857,30243093.435000002
BRETT.KULAK,20162017,CGY,299.08333333333337,0,2,1,3,3,2,0,0,0,19,53,14,23,1,6,269,261,259,255,7,11,0,30243049.335
BRETT.LERNOUT,20162017,MTL,37.983333333333334,0,0,0,0,0,0,0,0,0,3,4,8,0,0,0,28,25,27,24,1,2,0,30243027.75
BRETT.PESCE,20162017,CAR,1738.75,2,7,10,17,19,9,0,0,0,109,267,57,103,12,9,1587,1515,1393,1188,67,52,0,30243121.47
BRETT.RITCHIE,20162017,DAL,1005.9166666666667,16,4,4,8,24,20,1,2,1,167,312,153,77,12,17,1061,874,861,830,34,21,0.5,30243115.060000002
BRIAN.BOYLE,20162017,T.B,739.6666666666666,13,5,4,9,22,18,175,330,155,109,176,83,27,8,10,706,622,542,473,26,19,0.5303030303030303,30243086.58
BRIAN.BOYLE,20162017,TOR,312.45,0,3,2,5,5,3,176,326,150,35,57,48,11,5,9,256,330,242,244,6,9,0.5398773006134969,30243058.14
BRIAN.CAMPBELL,20162017,CHI,1539.0500000000002,5,6,5,11,16,11,0,0,0,77,174,44,61,9,12,1426,1348,1207,1258,60,44,0,30243148.615000002
BRIAN.DUMOULIN,20162017,PIT,1987.9833333333333,2,11,8,19,21,13,0,0,0,103,235,156,95,8,11,1677,1935,1515,1533,65,65,0,30243170.630000003
BRIAN.FLYNN,20162017,MTL,630.9,6,3,1,4,10,9,79,164,85,49,94,20,25,4,2,465,630,446,484,19,16,0.4817073170731707,30243081.375
BRIAN.GIONTA,20162017,BUF,1361.6333333333332,15,14,5,19,34,29,46,106,60,149,243,54,39,7,11,1114,1436,884,1077,32,44,0.4339622641509434,30243162.485
BRIAN.LASHOFF,20162017,DET,62.56666666666666,0,0,0,0,0,0,0,0,0,1,5,8,3,0,0,52,40,50,38,1,4,0,30243028.15
BRIAN.STRAIT,20162017,WPG,79.65,0,2,0,2,2,2,0,0,0,3,10,5,3,0,0,69,92,68,87,3,3,0,30243035.5
BROCK.BOESER,20162017,VAN,145.91666666666666,4,1,0,1,5,5,0,0,0,25,38,5,10,0,0,144,106,115,104,6,6,0,30243037.55
BROCK.MCGINN,20162017,CAR,683.85,7,6,3,9,16,13,1,4,3,74,142,91,41,14,3,609,658,586,578,19,31,0.25,30243086.755000003
BROCK.NELSON,20162017,NYI,1267.5,20,14,10,24,44,34,345,789,444,173,305,50,90,23,17,1154,1225,857,1047,41,45,0.4372623574144487,30243172.68
BROOKS.ORPIK,20162017,WSH,1612.2,0,6,9,15,15,6,0,0,0,108,215,221,69,13,23,1389,1529,1308,1161,55,37,0,30243128.605
BRYAN.BICKELL,20162017,CAR,114.85000000000001,1,0,0,0,1,1,0,2,2,8,20,16,6,0,1,106,104,80,97,3,5,0,30243036.049999997
BRYAN.LITTLE,20162017,WPG,1035.8666666666666,21,15,9,24,45,36,610,1097,487,119,189,35,31,7,9,1041,927,732,704,38,39,0.5560619872379216,30243133.395
BRYAN.RUST,20162017,PIT,1144.1,22,11,4,15,37,33,2,7,5,152,256,142,56,22,9,1052,1149,964,955,49,44,0.2857142857142857,30243135.95
BUDDY.ROBINSON,20162017,OTT,27.78333333333333,0,0,0,0,0,0,0,0,0,4,5,9,0,0,1,15,24,15,24,0,0,0,30243028.7
BYRON.FROESE,20162017,T.B,47.28333333333333,0,0,0,0,0,0,19,36,17,4,6,3,1,0,0,41,42,37,42,0,3,0.5277777777777778,30243030.66
BYRON.FROESE,20162017,TOR,16.016666666666666,0,0,0,0,0,0,7,20,13,2,3,0,1,1,1,13,22,13,21,0,0,0.35,15121515.94
C.J..SMITH,20162017,BUF,23.066666666666666,0,1,0,1,1,1,0,0,0,2,4,0,1,0,0,23,33,20,32,2,3,0,15121516.75
CAL.CLUTTERBUCK,20162017,NYI,923.8166666666666,5,10,5,15,20,15,3,8,5,115,197,222,46,14,13,721,1001,636,694,29,26,0.375,30243103.985
CAL.O'REILLY,20162017,BUF,87.25,0,1,0,1,1,1,32,66,34,3,5,2,2,1,0,65,79,49,78,1,7,0.48484848484848486,30243036.39
CALLE.JARNKROK,20162017,NSH,1629.85,17,10,9,19,36,27,605,1225,620,160,283,70,68,20,12,1391,1468,1164,1072,42,46,0.49387755102040815,30243164.625
CALVIN.DE HAAN,20162017,NYI,1627.5500000000002,5,11,9,20,25,16,0,0,0,116,251,139,77,11,16,1386,1685,1259,1357,65,51,0,30243163.335
CAM.ATKINSON,20162017,CBJ,1580.75,37,18,9,27,64,55,2,3,1,253,427,39,105,10,11,1633,1561,1103,1158,44,36,0.6666666666666666,30243172.605
CAM.FOWLER,20162017,ANA,2332.383333333333,13,15,17,32,45,28,0,0,0,212,428,35,144,7,10,2283,2207,1550,1554,64,64,0,30243180.695
CAMERON.GAUNCE,20162017,PIT,150.21666666666667,1,3,0,3,4,4,0,0,0,8,17,23,3,3,5,145,156,143,138,6,5,0,30243041.23
CARL.GUNNARSSON,20162017,STL,891.95,0,3,2,5,5,3,0,0,0,35,81,46,29,7,3,649,728,634,660,15,22,0,30243090.27
CARL.HAGELIN,20162017,PIT,1127.1166666666668,8,8,8,16,24,16,3,8,5,148,238,99,39,17,12,991,1101,922,823,39,34,0.375,30243111.34
CARL.SODERBERG,20162017,COL,1075.6166666666668,6,4,4,8,14,10,365,702,337,NA,NA,NA,NA,15,10,901,974,742,866,23,50,0.51994301994302,NA
CARTER.ROWNEY,20162017,PIT,542.0166666666667,3,4,3,7,10,7,120,247,127,46,70,144,12,0,4,409,525,397,425,18,13,0.48582995951417,30243077.475
CASEY.BAILEY,20162017,OTT,55.96666666666667,0,0,0,0,0,0,0,1,1,10,12,4,2,1,0,46,48,46,48,0,1,0,30243030.66
CASEY.CIZIKAS,20162017,NYI,820.5,8,13,4,17,25,21,420,846,426,82,127,144,25,13,15,642,916,586,639,27,21,0.49645390070921985,30243120.880000003
CASEY.NELSON,20162017,BUF,138.65,0,0,0,0,0,0,0,0,0,10,19,15,7,0,2,119,109,118,106,3,5,0,30243034.799999997
CEDRIC.PAQUETTE,20162017,T.B,668.3666666666667,4,3,3,6,10,7,200,433,233,68,132,143,33,16,21,542,689,507,513,13,18,0.4618937644341801,30243091.235
CHAD.RUHWEDEL,20162017,PIT,674.1166666666666,2,6,2,8,10,8,0,0,0,56,116,48,39,1,6,605,624,534,551,24,19,0,30243080.560000002
CHANDLER.STEPHENSON,20162017,WSH,35.516666666666666,0,0,0,0,0,0,12,25,13,3,4,0,1,0,0,32,23,32,21,0,0,0.48,30243027.58
CHARLES.HUDON,20162017,MTL,35.78333333333333,0,1,1,2,2,1,0,0,0,3,3,11,0,0,1,31,35,27,35,2,1,0,30243030.025
CHARLIE.COYLE,20162017,MIN,1455.4833333333331,20,26,12,38,58,46,120,257,137,173,288,116,53,24,14,1476,1217,1099,1074,53,45,0.4669260700389105,30243161.59
CHARLIE.MCAVOY,20162017,BOS,157.11666666666667,0,1,2,3,3,1,0,0,0,5,21,12,11,0,1,157,114,114,103,3,5,0,30243034.25
CHRIS.BUTLER,20162017,STL,21.46666666666667,0,0,0,0,0,0,0,0,0,1,3,0,2,0,0,13,25,12,21,1,1,0,15121514.9
CHRIS.DIDOMENICO,20162017,OTT,33.050000000000004,0,0,0,0,0,0,2,3,1,5,7,2,1,2,3,32,26,30,22,1,0,0.6666666666666666,15121515
CHRIS.KELLY,20162017,OTT,989.8499999999999,5,6,1,7,12,11,225,505,280,87,131,72,25,6,10,608,1164,573,814,8,31,0.44554455445544555,30243138.535
CHRIS.KREIDER,20162017,NYR,1477.7666666666667,31,19,7,26,57,50,7,12,5,216,368,165,54,24,33,1698,1139,1198,1067,54,47,0.5833333333333334,30243158.295
CHRIS.KUNITZ,20162017,PIT,1398.7833333333333,11,16,12,28,39,27,4,19,15,162,269,277,58,15,26,1343,1246,1118,1091,43,41,0.21052631578947367,30243148.36
CHRIS.NEIL,20162017,OTT,405.5333333333333,1,1,2,3,4,2,0,0,0,42,66,110,15,15,22,334,393,328,388,5,16,0,30243071.25
CHRIS.STEWART,20162017,MIN,859.9000000000001,13,4,3,7,20,17,2,11,9,84,140,96,27,19,24,625,870,604,860,25,22,0.18181818181818182,30243136.445
CHRIS.TANEV,20162017,VAN,1078.1666666666665,2,3,4,7,9,5,0,0,0,39,92,19,29,6,7,744,1045,672,736,28,28,0,30243100.16
CHRIS.TERRY,20162017,MTL,138.3,2,1,1,2,4,3,1,2,1,15,24,10,4,2,2,118,101,113,97,5,6,0.5,30243036.185
CHRIS.THORBURN,20162017,WPG,446.4666666666667,3,1,0,1,4,4,13,26,13,36,63,90,18,19,27,306,433,290,363,8,16,0.5,30243070.759999998
CHRIS.TIERNEY,20162017,S.J,1237.0333333333333,11,8,4,12,23,19,414,858,444,93,160,56,38,20,3,1011,1267,935,931,35,34,0.4825174825174825,30243143.21
CHRIS.VANDEVELDE,20162017,PHI,936.45,6,3,5,8,14,9,22,42,20,69,121,113,33,13,8,613,1010,578,642,15,21,0.5238095238095238,30243097.485
CHRIS.WAGNER,20162017,ANA,589.2333333333333,9,1,0,1,10,10,82,188,106,58,103,155,14,8,6,385,597,357,455,13,10,0.43617021276595747,30243087.060000002
CHRIS.WIDEMAN,20162017,OTT,1256.0833333333333,6,10,5,15,21,16,0,0,0,147,290,82,98,13,23,1254,1031,1041,958,36,33,0,30243118.055
CHRISTIAN.DVORAK,20162017,ARI,1218.1,15,10,8,18,33,25,471,1006,535,88,164,72,25,16,11,1047,1297,828,1082,38,33,0.46819085487077533,30243181.799999997
CHRISTIAN.FISCHER,20162017,ARI,86.28333333333333,3,0,0,0,3,3,0,0,0,10,15,9,3,0,0,55,87,55,85,3,3,0,30243037.2
CHRISTIAN.FOLIN,20162017,MIN,784.4333333333334,2,2,3,5,7,4,0,0,0,40,97,72,39,5,14,646,805,633,710,28,24,0,30243097.174999997
CHRISTOPH.BERTSCHY,20162017,MIN,40.666666666666664,0,0,1,1,1,0,0,0,0,5,5,7,0,0,2,25,35,25,35,1,1,0,30243029.975
CLARKE.MACARTHUR,20162017,OTT,342.1166666666667,3,4,2,6,9,7,3,9,6,37,63,32,17,3,6,325,256,244,233,9,6,0.3333333333333333,30243051.85
CLAUDE.GIROUX,20162017,PHI,1566.9833333333333,14,23,21,44,58,37,976,1746,770,199,365,68,85,22,18,1992,1211,1155,1068,34,47,0.5589919816723941,30243175.735
CLAYTON.KELLER,20162017,ARI,38,0,1,1,2,2,1,0,0,0,0,0,0,0,0,0,25,42,20,40,1,4,0,30243030.975
CLAYTON.STONER,20162017,ANA,245.71666666666667,1,1,0,1,2,2,0,0,0,16,29,35,10,3,4,195,225,186,177,5,5,0,30243043.18
CODY.BASS,20162017,NSH,60.900000000000006,0,0,0,0,0,0,0,2,2,1,3,14,2,4,5,27,70,27,64,0,1,0,30243034.39
CODY.CECI,20162017,OTT,2281.616666666667,2,6,10,16,18,8,1,1,0,166,349,136,116,6,11,1772,2516,1518,1818,51,76,1,30243212.7
CODY.EAKIN,20162017,DAL,1008.9166666666667,3,7,2,9,12,10,524,1001,477,82,168,65,38,15,16,944,1012,758,776,21,27,0.5234765234765235,30243126.509999998
CODY.FRANSON,20162017,BUF,1256.8000000000002,3,5,9,14,17,8,0,0,0,93,200,87,67,4,17,1137,1076,976,940,37,40,0,30243114.865000002
CODY.GOLOUBEF,20162017,COL,560.6500000000001,NA,2,3,5,NA,NA,NA,NA,NA,NA,NA,NA,NA,4,11,470,562,409,449,12,27,NA,NA
CODY.MCLEOD,20162017,COL,164.56666666666666,1,0,0,0,1,1,0,0,0,12,21,50,3,11,14,89,138,89,137,1,3,0,30243044.509999998
CODY.MCLEOD,20162017,NSH,360.66666666666663,5,0,1,1,6,5,0,3,3,29,43,152,8,20,30,245,361,239,354,13,15,0,30243073.375
COLE.SCHNEIDER,20162017,BUF,28.56666666666667,0,1,0,1,1,1,0,0,0,5,7,3,2,0,0,27,25,27,25,2,0,0,30243028.1
COLIN.MCDONALD,20162017,PHI,27.066666666666666,1,0,0,0,1,1,0,1,1,5,6,9,0,0,0,23,23,23,23,1,0,0,30243028.65
COLIN.MILLER,20162017,BOS,1026.9833333333333,6,4,4,8,14,10,0,0,0,89,247,92,93,19,20,1154,713,948,644,30,26,0,30243070.59
COLIN.WHITE,20162017,OTT,30.066666666666666,0,0,0,0,0,0,7,24,17,1,3,0,0,0,0,29,24,20,23,1,0,0.2916666666666667,30243028.630000003
COLIN.WILSON,20162017,NSH,1260.25,14,19,6,25,39,33,16,43,27,133,218,60,45,7,9,1351,1003,1012,939,51,40,0.37209302325581395,30243131.310000002
COLTON.PARAYKO,20162017,STL,1978.0166666666669,6,19,14,33,39,25,0,0,0,215,438,98,149,14,17,1734,1731,1368,1356,65,52,0,30243157.54
COLTON.SCEVIOUR,20162017,FLA,1170.6833333333334,9,9,6,15,24,18,31,58,27,172,264,108,44,12,10,968,1121,797,832,22,41,0.5344827586206896,30243123.509999998
COLTON.SISSONS,20162017,NSH,976.4499999999999,14,7,1,8,22,21,321,648,327,70,119,155,23,10,7,751,935,700,811,32,21,0.49537037037037035,30243135.415
CONNOR.BROWN,20162017,TOR,1438.25,20,10,7,17,37,30,2,7,5,146,264,55,55,13,5,1367,1464,1107,1113,47,44,0.2857142857142857,30243150.235
CONNOR.CARRICK,20162017,TOR,1168.15,2,4,2,6,8,6,0,0,0,91,225,75,80,11,22,1246,1079,1128,1015,51,43,0,30243113.41
CONNOR.JONES,20162017,NYI,47.38333333333333,0,0,0,0,0,0,8,13,5,2,9,13,6,2,1,39,36,38,35,1,0,0.6153846153846154,30243028.240000002
CONNOR.MCDAVID,20162017,EDM,2024.1166666666668,35,45,29,74,109,80,387,914,527,289,492,49,114,57,14,2296,1731,1541,1424,86,55,0.4234135667396061,30243223.075
CONNOR.MURPHY,20162017,ARI,1476.7333333333333,2,7,7,14,16,9,0,0,0,81,186,200,67,14,20,1145,1567,1061,1235,40,58,0,30243154.615000002
CONOR.SHEARY,20162017,PIT,1283.2666666666669,25,15,20,35,60,40,0,0,0,200,314,58,63,18,13,1379,1162,1143,1091,65,48,0,30243152.18
COREY.PERRY,20162017,ANA,1756.5333333333333,23,23,18,41,64,46,7,21,14,258,463,102,87,36,43,1954,1413,1337,1276,58,47,0.3333333333333333,30243178.740000002
COREY.TROPP,20162017,ANA,9.466666666666667,0,0,0,0,0,0,0,0,0,0,0,2,0,0,0,10,4,10,4,0,1,0,15121512.85
CORY.CONACHER,20162017,T.B,127.18333333333334,1,3,0,3,4,4,1,2,1,16,26,1,3,4,2,105,95,82,91,3,3,0.5,30243037.68
CRAIG.SMITH,20162017,NSH,1206.5666666666666,13,14,5,19,32,27,51,112,61,176,354,108,92,15,14,1325,1021,1163,979,46,34,0.45535714285714285,30243124.265
CRISTOVAL.NIEVES,20162017,NYR,11.733333333333333,0,0,0,0,0,0,3,10,7,0,1,0,0,0,0,8,15,7,15,0,0,0.3,15121514.97
CURTIS.LAZAR,20162017,CGY,54.36666666666667,1,1,1,2,3,2,13,28,15,2,8,9,4,0,0,38,49,36,48,2,1,0.4642857142857143,30243032.045
CURTIS.LAZAR,20162017,OTT,290.85,0,0,1,1,1,0,28,75,47,24,40,57,8,8,2,194,296,188,281,4,15,0.37333333333333335,30243060.174999997
CURTIS.MCKENZIE,20162017,DAL,575.1166666666667,6,5,5,10,16,11,3,6,3,66,116,103,22,22,19,533,616,513,522,21,19,0.5,30243085.515
DALE.WEISE,20162017,PHI,824.4333333333334,8,4,2,6,14,12,3,3,0,94,144,135,22,9,9,794,643,704,617,28,25,1,30243089.41
DALTON.PROUT,20162017,CBJ,195.88333333333333,0,1,2,3,3,1,0,0,0,6,18,24,10,2,7,148,203,141,155,12,8,0,30243040.47
DALTON.PROUT,20162017,N.J,209.14999999999998,0,1,2,3,3,1,0,0,0,7,17,20,4,2,10,157,156,156,149,8,14,0,30243040.82
DAMON.SEVERSON,20162017,N.J,1628.1833333333334,3,12,15,27,30,15,0,0,0,125,278,79,95,15,26,1540,1314,1188,1162,36,50,0,30243140.875
DAN.GIRARDI,20162017,NYR,1468.7333333333333,4,3,9,12,16,7,0,0,0,72,161,134,59,11,9,1190,1702,1099,1358,40,47,0,30243169.585
DAN.HAMHUIS,20162017,DAL,1529.4333333333334,1,6,7,13,14,7,0,0,0,83,201,93,84,7,10,1532,1491,1242,1151,45,51,0,30243126.945
DAN.RENOUF,20162017,DET,13.516666666666667,0,0,0,0,0,0,0,0,0,1,1,3,0,0,0,6,10,6,10,0,0,0,15121514
DANIEL.CARR,20162017,MTL,338.43333333333334,2,5,2,7,9,7,2,3,1,44,73,19,10,5,3,292,273,281,271,13,9,0.6666666666666666,30243055.68
DANIEL.O'REGAN,20162017,S.J,34.650000000000006,1,0,0,0,1,1,15,32,17,5,6,1,0,0,0,32,44,29,42,0,2,0.46875,30243032
DANIEL.SEDIN,20162017,VAN,1507.6,15,22,7,29,44,37,3,6,3,216,345,20,60,8,16,1485,1169,1005,1052,40,47,0.5,30243154.575
DANIEL.WINNIK,20162017,WSH,1072.6166666666668,12,9,3,12,24,21,11,24,13,93,152,36,20,22,16,757,1004,681,675,27,20,0.4583333333333333,30243107.035
DANNY.DEKEYSER,20162017,DET,1800.1999999999998,4,6,2,8,12,10,0,0,0,85,177,100,52,10,15,1312,1787,1132,1313,50,73,0,30243163.4
DANTON.HEINEN,20162017,BOS,105.86666666666667,0,0,0,0,0,0,0,0,0,7,12,6,1,0,1,106,82,87,74,1,3,0,30243032.45
DARNELL.NURSE,20162017,EDM,975.0999999999999,5,3,4,7,12,8,0,0,0,102,193,143,54,5,15,878,968,830,807,34,34,0,30243104.700000003
DARREN.HELM,20162017,DET,768.4666666666667,8,3,6,9,17,11,216,420,204,98,166,71,37,17,8,644,744,517,565,24,29,0.5142857142857142,30243097.259999998
DAVID.BACKES,20162017,BOS,1371.8,18,15,9,24,42,33,71,141,70,189,310,254,48,22,27,1545,1072,1139,916,50,44,0.5035460992907801,30243129.285
DAVID.DESHARNAIS,20162017,EDM,328,2,4,1,5,7,6,130,249,119,21,35,10,9,3,3,273,301,260,294,14,13,0.5220883534136547,30243063.005000003
DAVID.DESHARNAIS,20162017,MTL,406.1166666666667,4,1,5,6,10,5,76,159,83,30,48,2,11,4,3,380,335,334,318,13,7,0.4779874213836478,30243062.005000003
DAVID.KREJCI,20162017,BOS,1537.9,23,23,8,31,54,46,671,1306,635,161,317,42,83,13,12,1700,1219,1173,1037,45,53,0.5137825421133231,30243167.57
DAVID.PASTRNAK,20162017,BOS,1474.0833333333335,36,22,15,37,73,58,2,5,3,272,503,86,117,36,18,1832,1100,1290,985,55,43,0.4,30243138.165
DAVID.PERRON,20162017,STL,1577.3833333333332,18,16,13,29,47,34,34,69,35,168,290,102,51,28,31,1383,1241,1049,1043,42,45,0.4927536231884058,30243152.665
DAVID.SAVARD,20162017,CBJ,1740.0833333333335,6,9,8,17,23,15,0,0,0,144,283,142,70,6,23,1570,1805,1447,1362,69,47,0,30243157.060000002
DAVID.SCHLEMKO,20162017,S.J,1125.1,3,9,8,17,20,12,0,0,0,124,270,40,98,6,8,1183,912,943,816,35,29,0,30243095.91
DAVID.WARSOFSKY,20162017,PIT,110.13333333333334,0,1,0,1,1,1,0,0,0,14,31,3,8,0,3,116,123,103,106,4,6,0,30243036.15
DENIS.GURIANOV,20162017,DAL,13.1,0,0,0,0,0,0,0,0,0,0,3,1,2,0,0,7,16,7,16,0,1,0,15121514.5
DENIS.MALGIN,20162017,FLA,528.2,6,1,3,4,10,7,67,184,117,67,102,34,21,14,4,503,419,396,388,11,16,0.3641304347826087,30243073.345
DENNIS.RASMUSSEN,20162017,CHI,845.0333333333333,5,4,0,4,9,9,166,372,206,82,121,66,24,12,6,648,901,624,661,17,24,0.44623655913978494,30243106.759999998
DENNIS.SEIDENBERG,20162017,NYI,1418.15,5,5,12,17,22,10,0,0,0,89,166,154,55,7,17,1196,1522,1134,1248,64,44,0,30243152.37
DENNIS.WIDEMAN,20162017,CGY,1153.0833333333333,5,6,5,11,16,11,0,0,0,87,191,61,74,7,13,962,1023,804,802,29,38,0,30243103.695
DEREK.DORSETT,20162017,VAN,139.05,1,2,1,3,4,3,1,1,0,24,33,35,7,7,8,115,105,115,98,5,11,1,30243036.985
DEREK.FORBORT,20162017,L.A,1649.5166666666669,2,6,9,15,17,8,1,1,0,100,212,180,70,15,19,1366,1526,1279,1203,47,43,1,30243137.815
DEREK.GRANT,20162017,BUF,396.8333333333333,0,2,1,3,3,2,173,331,158,34,58,25,7,3,8,253,487,218,287,5,8,0.5226586102719033,30243066.125
DEREK.GRANT,20162017,NSH,52.13333333333333,0,0,1,1,1,0,28,52,24,6,8,2,0,1,1,39,56,30,50,1,3,0.5384615384615384,30243032.805
DEREK.MACKENZIE,20162017,FLA,1030.3166666666666,6,7,3,10,16,13,386,772,386,91,155,192,30,21,17,684,1106,597,781,16,32,0.5,30243136.925
DEREK.RYAN,20162017,CAR,997.7333333333333,11,9,8,17,28,20,391,707,316,73,135,33,33,9,10,1000,813,747,720,29,32,0.553041018387553,30243117.23
DEREK.STEPAN,20162017,NYR,1759.1666666666665,19,25,17,42,61,44,806,1737,931,242,389,40,78,7,10,1816,1563,1238,1220,52,40,0.46401842256764536,30243207.585
DERICK.BRASSARD,20162017,OTT,1753.2833333333333,18,13,19,32,50,31,747,1497,750,243,419,123,93,20,15,1906,1406,1409,1229,60,51,0.49899799599198397,30243182.255000003
DERRICK.POULIOT,20162017,PIT,163.73333333333335,0,0,0,0,0,0,0,0,0,11,20,14,5,0,2,142,159,123,132,3,6,0,30243038.8
DERYK.ENGELLAND,20162017,CGY,1545.8166666666666,4,6,6,12,16,10,1,1,0,109,225,143,81,22,26,1098,1670,1018,1166,40,48,1,30243147.46
DEVANTE.SMITH-PELLY,20162017,N.J,715.8333333333333,4,2,3,5,9,6,29,71,42,76,111,94,11,8,6,491,730,403,584,9,25,0.4084507042253521,30243100.665
DEVIN.SETOGUCHI,20162017,L.A,559.8833333333334,4,4,4,8,12,8,2,4,2,60,110,53,25,11,7,623,462,574,454,18,20,0.5,30243067.99
DEVIN.SHORE,20162017,DAL,1159.1166666666668,13,13,7,20,33,26,220,469,249,115,213,44,42,14,6,1170,1051,879,960,34,33,0.4690831556503198,30243147.965
DILLON.SIMPSON,20162017,EDM,32.65,0,0,0,0,0,0,0,0,0,2,5,3,2,0,1,25,27,25,27,1,1,0,30243028.1
DION.PHANEUF,20162017,OTT,2309.15,10,12,13,25,35,22,0,0,0,184,370,178,116,29,50,2085,2396,1549,1768,57,74,0,30243218.865000002
DMITRIJ.JASKIN,20162017,STL,617.2666666666667,2,5,5,10,12,7,5,10,5,64,115,105,23,10,9,554,465,508,447,19,15,0.5,30243070.225
DMITRY.KULIKOV,20162017,BUF,1029.3833333333332,2,1,2,3,5,3,0,0,0,42,114,60,45,5,12,837,1085,722,894,16,34,0,30243120.4
DMITRY.ORLOV,20162017,WSH,1880.1166666666668,6,20,9,29,35,26,0,0,0,146,306,148,107,11,24,1899,1533,1681,1419,82,55,0,30243152.835
DOMINIC.MOORE,20162017,BOS,1158.0666666666666,11,8,7,15,26,19,381,699,318,100,160,74,37,15,24,874,1166,771,843,25,34,0.5450643776824035,30243137.565
DOMINIK.SIMON,20162017,PIT,26.083333333333332,0,1,0,1,1,1,0,0,0,2,5,2,1,0,0,22,26,21,26,1,2,0,15121515.95
DOUGIE.HAMILTON,20162017,CGY,1683.5,13,17,19,36,49,30,0,0,0,232,450,73,134,6,36,1825,1369,1421,1146,58,48,0,30243134.485
DRAKE.CAGGIULA,20162017,EDM,994.0166666666667,10,6,5,11,21,16,124,304,180,115,210,121,46,19,15,923,910,677,779,25,24,0.40789473684210525,30243124.475
DREW.DOUGHTY,20162017,L.A,2225.833333333333,12,16,15,31,43,28,1,1,0,181,365,129,120,15,22,2324,1792,1647,1321,55,43,1,30243145.865000002
DREW.MILLER,20162017,DET,565.4833333333333,5,1,1,2,7,6,2,3,1,43,69,71,13,1,8,375,630,354,470,9,19,0.6666666666666666,30243082.515
DREW.SHORE,20162017,VAN,167.51666666666665,0,2,0,2,2,2,38,71,33,11,18,22,2,1,2,121,159,116,145,3,6,0.5352112676056338,30243043.93
DREW.STAFFORD,20162017,BOS,339.35,6,3,1,4,10,9,3,10,7,55,77,32,12,2,7,338,293,291,283,16,11,0.3,30243059.265
DREW.STAFFORD,20162017,WPG,531.9166666666666,4,6,2,8,12,10,3,12,9,68,97,37,15,5,7,473,448,354,406,13,14,0.25,30243075.67
DUNCAN.KEITH,20162017,CHI,2151.55,6,20,26,46,52,26,0,0,0,189,403,29,155,1,9,2064,1984,1460,1439,61,52,0,30243163.91
DUNCAN.SIEMENS,20162017,COL,36.93333333333334,0,0,0,0,0,0,0,0,0,2,4,10,1,0,1,29,35,28,32,0,2,0,30243029
DUSTIN.BROWN,20162017,L.A,1280.0166666666667,14,9,12,21,35,23,2,5,3,175,326,190,75,22,10,1246,1126,1020,874,38,41,0.4,30243114.9
DUSTIN.BYFUGLIEN,20162017,WPG,2195.5666666666666,13,20,17,37,50,33,0,0,0,241,452,182,110,20,45,2106,1907,1436,1395,68,68,0,30243176.625
DWIGHT.KING,20162017,L.A,944.5166666666667,8,4,3,7,15,12,4,13,9,89,141,94,21,3,5,798,853,743,681,27,27,0.3076923076923077,30243096.965
DWIGHT.KING,20162017,MTL,283.29999999999995,1,0,0,0,1,1,0,3,3,27,53,40,10,1,1,222,263,210,240,6,10,0,30243050.96
DYLAN.DEMELO,20162017,S.J,397.3166666666666,1,5,2,7,8,6,0,0,0,32,70,36,24,4,7,375,348,313,325,15,12,0,30243059.04
DYLAN.LARKIN,20162017,DET,1291.8333333333335,17,7,7,14,31,24,196,432,236,178,310,67,69,25,15,1221,1081,884,951,31,51,0.4537037037037037,30243146.465
DYLAN.MCILRATH,20162017,FLA,47.86666666666667,1,0,0,0,1,1,0,0,0,3,11,13,5,2,2,38,41,38,40,1,3,0,30243029.869999997
DYLAN.MCILRATH,20162017,NYR,9.233333333333334,0,0,0,0,0,0,0,0,0,0,0,2,0,1,2,1,12,1,12,0,0,0,15121514.81
DYLAN.STROME,20162017,ARI,95.71666666666667,0,1,0,1,1,1,31,77,46,6,16,3,4,1,1,91,102,76,94,2,5,0.4025974025974026,30243037.9
ELIAS.LINDHOLM,20162017,CAR,1309.05,11,29,5,34,45,40,353,635,282,151,272,99,52,14,8,1407,1102,1000,918,40,43,0.5559055118110237,30243142.884999998
EMERSON.ETEM,20162017,ANA,26.416666666666664,0,0,0,0,0,0,0,1,1,0,0,4,0,0,1,12,25,11,20,1,0,0,30243028
ERIC.FEHR,20162017,PIT,568.45,6,3,2,5,11,9,75,150,75,61,95,78,17,2,7,376,656,337,462,15,12,0.5,30243086.27
ERIC.FEHR,20162017,TOR,10.733333333333334,0,0,0,0,0,0,4,4,0,1,2,4,1,0,0,9,14,9,12,0,1,1,15121513.96
ERIC.GELINAS,20162017,COL,312.7,0,0,1,1,1,0,NA,NA,NA,NA,NA,NA,NA,1,NA,264,286,253,273,10,14,NA,NA
ERIC.GRYBA,20162017,EDM,688,2,3,1,4,6,5,0,0,0,45,104,162,38,10,23,604,671,591,556,19,25,0,30243079.725
ERIC.STAAL,20162017,MIN,1620.3,28,25,13,38,66,53,614,1243,629,223,382,51,91,19,17,1677,1435,1171,1098,56,47,0.49396621078037006,30243183.125
ERIK.BURGDOERFER,20162017,BUF,22.333333333333336,0,0,0,0,0,0,0,0,0,2,3,5,0,0,0,19,21,19,21,0,1,0,30243027.799999997
ERIK.CONDRA,20162017,T.B,125.31666666666666,0,0,0,0,0,0,1,1,0,8,15,5,4,3,2,109,123,106,114,2,5,1,30243037.119999997
ERIK.GUDBRANSON,20162017,VAN,609.75,1,4,0,4,5,5,0,0,0,40,88,66,33,8,6,459,617,436,476,15,27,0,30243073.78
ERIK.HAULA,20162017,MIN,1056.1666666666667,15,8,4,12,27,23,418,773,355,143,224,46,40,10,10,955,971,889,810,37,34,0.5407503234152652,30243128.52
ERIK.JOHNSON,20162017,COL,1015.75,2,7,7,14,16,9,0,0,0,96,204,87,74,6,3,955,966,737,696,25,36,0,30243089.285
ERIK.KARLSSON,20162017,OTT,2600.8,19,32,37,69,88,51,0,0,0,270,644,88,225,28,19,2641,2343,1813,1786,82,66,0,30243207.005000003
ESA.LINDELL,20162017,DAL,1596.5833333333335,6,5,6,11,17,11,0,1,1,99,223,91,72,8,11,1453,1633,1210,1274,52,45,0,30243151.63
EVAN.MCENENY,20162017,VAN,15.133333333333333,0,0,0,0,0,0,0,0,0,1,1,0,0,0,0,10,11,10,11,1,2,0,15121513.8
EVAN.RODRIGUES,20162017,BUF,387.6333333333333,4,2,0,2,6,6,104,250,146,51,94,12,20,6,2,306,378,288,325,6,13,0.416,30243069.02
EVANDER.KANE,20162017,BUF,1344.1333333333332,28,8,7,15,43,36,55,122,67,260,440,109,99,21,37,1272,1344,969,1066,38,52,0.45081967213114754,30243162.485
EVGENI.MALKIN,20162017,PIT,1606,43,33,24,57,100,76,516,1167,651,252,413,71,88,36,50,1847,1324,1181,1129,67,42,0.442159383033419,30243210.45
EVGENY.KUZNETSOV,20162017,WSH,1647.7833333333333,24,25,20,45,69,49,539,1225,686,213,402,80,110,24,27,1762,1339,1321,1208,67,45,0.44,30243190
EVGENY.SVECHNIKOV,20162017,DET,26.25,0,0,0,0,0,0,0,0,0,4,6,2,1,0,0,27,20,26,20,0,0,0,30243027.25
FEDOR.TYUTIN,20162017,COL,1306.75,1,1,10,11,12,2,NA,NA,NA,NA,NA,NA,NA,5,19,910,1298,823,936,27,56,NA,NA
FILIP.FORSBERG,20162017,NSH,1958.3833333333332,40,22,12,34,74,62,6,20,14,305,593,126,129,31,21,2156,1615,1518,1216,69,52,0.3,30243162.65
FRANCOIS.BEAUCHEMIN,20162017,COL,1742.7666666666667,NA,8,5,13,NA,NA,NA,NA,NA,NA,NA,NA,NA,7,16,1423,1796,1193,1306,43,63,NA,NA
FRANK.CORRADO,20162017,PIT,15.083333333333332,0,0,0,0,0,0,0,0,0,1,4,2,1,1,1,17,14,15,14,0,1,0,15121514.16
FRANK.CORRADO,20162017,TOR,28,0,0,0,0,0,0,0,0,0,2,7,2,1,1,3,29,32,28,31,1,1,0,30243029.01
FRANK.VATRANO,20162017,BOS,660.6333333333334,11,2,6,8,19,13,2,7,5,122,203,68,36,10,12,738,474,589,439,19,22,0.2857142857142857,30243071.13
FRANS.NIELSEN,20162017,DET,1354.6833333333334,17,12,11,23,40,29,651,1212,561,160,272,64,55,13,8,1284,1224,858,865,35,45,0.5371287128712872,30243149.045
FREDDIE.HAMILTON,20162017,CGY,260.9666666666667,2,0,0,0,2,2,75,126,51,31,52,49,11,5,4,191,224,187,212,5,7,0.5952380952380952,30243050.95
FREDERICK.GAUDREAU,20162017,NSH,169.85000000000002,3,0,1,1,4,3,33,73,40,15,24,8,5,1,0,160,162,156,161,8,5,0.4520547945205479,30243044.505000003
FREDERIK.GAUTHIER,20162017,TOR,203.55,2,0,1,1,3,2,120,235,115,15,25,17,5,2,6,142,208,136,158,7,5,0.5106382978723404,30243048.295
FREDRIK.CLAESSON,20162017,OTT,640.6333333333333,3,4,5,9,12,7,0,0,0,32,92,88,42,2,4,603,581,572,520,19,13,0,30243072.645
GABRIEL.BOURQUE,20162017,COL,67.2,0,0,0,0,0,0,0,1,1,4,9,17,3,0,0,38,81,35,53,1,1,0,30243031.35
GABRIEL.CARLSSON,20162017,CBJ,89.05,0,0,1,1,1,0,0,0,0,5,11,6,2,0,0,87,81,81,80,5,6,0,30243032.725
GABRIEL.DUMONT,20162017,T.B,377.1166666666667,2,2,0,2,4,4,133,242,109,34,66,83,18,14,9,307,344,298,310,6,6,0.5495867768595041,30243063.310000002
GABRIEL.LANDESKOG,20162017,COL,1352.2666666666669,NA,7,8,15,NA,NA,NA,NA,NA,NA,NA,NA,NA,23,25,1312,1136,887,841,29,47,NA,NA
GARNET.HATHAWAY,20162017,CGY,237.61666666666667,1,2,2,4,5,3,10,19,9,22,40,56,9,10,12,179,220,170,212,7,8,0.5263157894736842,30243051.7
GARRETT.MITCHELL,20162017,WSH,8.8,0,0,0,0,0,0,0,1,1,0,0,2,0,0,0,5,5,5,5,0,0,0,15121513.3
GEMEL.SMITH,20162017,DAL,230.95,3,1,2,3,6,4,25,59,34,19,32,6,5,6,5,203,251,183,205,4,8,0.423728813559322,30243051.759999998
GREG.MCKEGG,20162017,FLA,316.5,3,2,1,3,6,5,43,83,40,28,39,33,6,3,4,230,302,216,267,11,15,0.5180722891566265,30243059.075
GREG.MCKEGG,20162017,T.B,139.01666666666665,0,1,0,1,1,1,47,97,50,8,15,15,2,5,4,83,154,82,146,4,1,0.4845360824742268,30243046.03
GREG.PATERYN,20162017,DAL,210.09999999999997,0,0,3,3,3,0,0,0,0,14,30,25,8,0,3,180,190,175,181,5,9,0,30243043.325000003
GREG.PATERYN,20162017,MTL,345.1,1,1,4,5,6,2,0,0,0,28,60,44,17,0,2,340,339,337,304,16,13,0,30243052.549999997
GRIFFEN.MOLINO,20162017,VAN,52.93333333333334,0,0,0,0,0,0,0,0,0,3,7,1,1,2,0,41,56,41,56,0,2,0,30243031.87
GRIFFIN.REINHART,20162017,EDM,13.383333333333333,0,0,1,1,1,0,0,0,0,1,1,5,0,0,0,14,19,14,19,1,1,0,15121514.875
GUSTAV.FORSLING,20162017,CHI,563.1166666666667,2,2,1,3,5,4,0,0,0,48,121,16,55,3,2,490,490,437,456,17,13,0,30243066.555
GUSTAV.NYQUIST,20162017,DET,1325.0333333333333,12,22,13,35,47,34,4,5,1,165,292,54,64,16,8,1336,1033,938,944,53,43,0.8,30243133.744999997
GUSTAV.OLOFSSON,20162017,MIN,175.26666666666665,0,0,3,3,3,0,0,0,0,7,21,10,8,0,1,165,172,143,168,6,7,0,30243042.174999997
HAMPUS.LINDHOLM,20162017,ANA,1855.75,7,7,8,15,22,14,2,2,0,118,260,124,90,12,23,1794,1680,1437,1224,63,39,1,30243133.1
HARRY.ZOLNIERCZYK,20162017,NSH,309.96666666666664,3,2,2,4,7,5,8,19,11,25,44,44,16,10,7,217,345,215,341,8,7,0.42105263157894735,30243068.520000003
HENRIK.SEDIN,20162017,VAN,1561.3333333333335,15,13,22,35,50,28,611,1246,635,99,160,15,31,8,13,1511,1190,1025,1060,39,55,0.49036918138041735,30243174.67
HENRIK.ZETTERBERG,20162017,DET,1617.4,17,35,16,51,68,52,705,1361,656,194,334,58,78,16,11,1572,1180,1102,1069,63,41,0.5180014695077149,30243179.21
HUDSON.FASCHING,20162017,BUF,104.08333333333333,0,1,0,1,1,1,0,0,0,6,13,17,4,2,1,87,91,82,83,1,2,0,30243034.119999997
HUNTER.SHINKARUK,20162017,CGY,74.08333333333333,0,0,1,1,1,0,0,0,0,5,11,3,4,1,1,56,72,56,72,1,4,0,30243033.235
IAN.COLE,20162017,PIT,2076.4,5,15,15,30,35,20,0,0,0,112,279,208,86,21,42,1742,2211,1629,1706,89,66,0,30243198.685000002
IAN.MCCOSHEN,20162017,FLA,39.766666666666666,0,0,1,1,1,0,0,0,0,0,1,3,1,0,0,29,28,29,28,1,1,0,30243028.025
IIRO.PAKARINEN,20162017,EDM,133.36666666666667,2,1,1,2,4,3,0,1,1,15,25,34,3,1,1,89,121,86,110,4,3,0,30243039.634999998
IVAN.BARBASHEV,20162017,STL,430.54999999999995,5,4,3,7,12,9,104,258,154,24,46,45,12,5,2,388,380,328,368,15,10,0.40310077519379844,30243074.384999998
IVAN.PROVOROV,20162017,PHI,1802.2,6,15,9,24,30,21,0,0,0,161,331,111,111,7,15,1509,1719,1203,1247,39,50,0,30243153.395
J.T..BROWN,20162017,T.B,663.7333333333333,3,1,2,3,6,4,12,38,26,67,116,103,28,17,21,517,635,494,540,11,19,0.3157894736842105,30243086.6
J.T..COMPHER,20162017,COL,302.2833333333333,3,1,1,2,5,4,74,157,83,30,58,8,15,5,1,252,259,191,222,6,7,0.4713375796178344,30243053.935000002
J.T..MILLER,20162017,NYR,1540.5500000000002,22,23,14,37,59,45,170,387,217,149,270,127,55,17,19,1379,1566,1059,1271,50,43,0.4392764857881137,30243196.17
JACCOB.SLAVIN,20162017,CAR,1921.85,5,14,15,29,34,19,0,0,0,99,231,35,75,4,6,1708,1702,1418,1252,69,48,0,30243139.015
JACK.EICHEL,20162017,BUF,1215.1333333333332,24,19,14,33,57,43,310,796,486,249,428,26,95,25,11,1322,1116,880,984,37,44,0.38944723618090454,30243173.15
JACK.JOHNSON,20162017,CBJ,1918.7666666666664,6,7,11,18,24,13,1,1,0,131,249,105,79,13,14,1660,2026,1497,1517,66,53,1,30243174.095
JACK.ROSLOVIC,20162017,WPG,8.4,0,0,0,0,0,0,1,6,5,1,1,0,0,0,0,7,13,7,13,0,1,0.16666666666666666,15121514.64
JACK.SKILLE,20162017,VAN,483.95,5,4,0,4,9,9,2,2,0,73,121,74,20,5,6,413,433,411,429,13,13,1,30243074.63
JACOB.DE LA ROSE,20162017,MTL,98.16666666666666,0,0,0,0,0,0,17,34,17,4,9,23,1,0,2,61,103,57,75,1,3,0.5,30243034.78
JACOB.JOSEFSON,20162017,N.J,465.4,1,3,6,9,10,4,162,313,151,42,82,31,12,4,8,403,411,341,368,15,16,0.5175718849840255,30243071.67
JACOB.LARSSON,20162017,ANA,65.71666666666667,0,0,0,0,0,0,0,0,0,2,11,1,6,0,1,51,66,44,49,0,1,0,15121517.25
JACOB.TROUBA,20162017,WPG,1496.6,7,10,14,24,31,17,0,0,0,153,322,107,105,17,20,1315,1474,1041,1048,49,52,0,30243129.82
JADEN.SCHWARTZ,20162017,STL,1711.5333333333333,23,26,15,41,64,49,70,149,79,212,364,89,75,11,9,1777,1388,1251,1118,59,37,0.4697986577181208,30243157.384999998
JAKE.DOTCHIN,20162017,T.B,645.0166666666667,0,3,8,11,11,3,0,0,0,50,113,85,36,11,16,657,525,566,501,22,14,0,30243070.909999996
JAKE.GARDINER,20162017,TOR,1937.55,10,15,19,34,44,25,0,0,0,136,358,74,155,8,20,2159,1706,1636,1532,77,54,0,30243165.255000003
JAKE.GUENTZEL,20162017,PIT,1072.9166666666665,29,18,7,25,54,47,8,20,12,134,227,92,48,20,11,1138,995,912,941,55,49,0.4,30243145.395
JAKE.MCCABE,20162017,BUF,1573.5833333333335,3,10,7,17,20,13,0,0,0,79,175,73,56,12,13,1335,1632,1138,1321,53,61,0,30243164.545
JAKE.MUZZIN,20162017,L.A,1828.1333333333332,9,8,10,18,27,17,0,0,0,184,388,162,129,14,22,1951,1521,1456,1161,46,64,0,30243124.69
JAKE.VIRTANEN,20162017,VAN,101.45,0,0,1,1,1,0,3,3,0,13,25,17,8,1,1,75,90,71,89,1,0,1,30243034.805
JAKOB.CHYCHRUN,20162017,ARI,1133.3333333333335,7,5,7,12,19,12,0,0,0,86,197,109,58,7,18,941,1203,835,1022,32,45,0,30243138.795
JAKOB.FORSBACKA KARLSSON,20162017,BOS,8.416666666666666,0,0,0,0,0,0,1,2,1,0,0,0,0,0,0,6,5,6,5,0,0,0.5,15121513.24
JAKOB.SILFVERBERG,20162017,ANA,1798.4833333333333,32,18,13,31,63,50,1,7,6,287,488,65,108,17,13,1855,1694,1368,1293,59,49,0.14285714285714285,30243176.035
JAKUB.KINDL,20162017,FLA,572.7666666666667,0,3,1,4,4,3,0,0,0,41,77,49,19,1,14,483,526,462,511,17,27,0,30243079.535
JAKUB.NAKLADAL,20162017,CAR,43.5,0,0,0,0,0,0,0,0,0,3,7,2,3,0,0,32,47,32,46,0,4,0,15121517.75
JAKUB.VORACEK,20162017,PHI,1564.0666666666666,20,26,15,41,61,46,3,14,11,253,480,30,134,26,16,1935,1233,1142,1101,37,62,0.21428571428571427,30243153.155
JAKUB.VRANA,20162017,WSH,233.2833333333333,3,2,1,3,6,5,0,3,3,32,56,6,7,1,1,282,179,205,171,5,3,0,30243044.285
JAMES.NEAL,20162017,NSH,1632.6333333333332,29,15,6,21,50,44,4,7,3,268,449,133,101,18,24,1778,1253,1268,1149,41,50,0.5714285714285714,30243159.439999998
JAMES.VAN RIEMSDYK,20162017,TOR,1408.75,31,18,16,34,65,49,1,5,4,259,430,67,80,19,17,1682,1225,1196,1131,60,48,0.2,30243163.03
JAMIE.BENN,20162017,DAL,1491.7833333333333,26,26,17,43,69,52,211,410,199,200,358,89,81,22,24,1627,1369,1017,1050,38,40,0.5146341463414634,30243169.735
JAMIE.MCBAIN,20162017,ARI,50,0,0,0,0,0,0,0,0,0,3,8,0,3,0,0,52,58,40,51,2,3,0,30243030.55
JAMIE.MCGINN,20162017,ARI,948.4333333333333,9,4,4,8,17,13,1,3,2,116,173,116,23,11,10,841,946,743,911,24,41,0.3333333333333333,30243134.25
JAMIE.OLEKSIAK,20162017,DAL,664.6333333333333,5,0,2,2,7,5,0,0,0,33,67,51,22,8,12,602,677,563,574,20,22,0,30243084.33
JANNIK.HANSEN,20162017,S.J,326.7,2,4,2,6,8,6,0,1,1,27,50,37,8,6,2,299,340,268,268,14,15,0,30243054.509999998
JANNIK.HANSEN,20162017,VAN,457.65,6,7,0,7,13,13,0,0,0,56,101,20,24,13,8,373,452,351,378,18,13,0,30243070.53
JARED.BOLL,20162017,ANA,332.5666666666667,0,3,0,3,3,3,0,1,1,16,33,82,9,24,22,211,316,208,312,6,10,0,30243065.69
JARED.MCCANN,20162017,FLA,337.4166666666667,1,6,0,6,7,7,41,105,64,44,78,28,18,8,2,324,279,281,271,11,12,0.3904761904761905,30243057.119999997
JARED.SPURGEON,20162017,MIN,1953.1833333333332,10,17,12,29,39,27,0,0,0,156,296,55,81,10,10,1870,1785,1435,1343,72,49,0,30243158.9
JAROME.IGINLA,20162017,COL,899.7166666666667,8,8,2,10,18,16,NA,NA,NA,NA,NA,NA,NA,13,20,910,722,627,651,19,30,NA,NA
JAROME.IGINLA,20162017,L.A,310.45,6,2,1,3,9,8,4,11,7,34,65,37,14,6,5,334,269,237,251,8,14,0.36363636363636365,30243056.195
JAROMIR.JAGR,20162017,FLA,1393.9666666666667,16,20,10,30,46,36,1,2,1,181,295,21,54,20,28,1611,988,1109,913,53,42,0.5,30243127.39
JASON.CHIMERA,20162017,NYI,1071.1666666666665,20,7,6,13,33,27,16,34,18,121,180,149,30,8,15,899,1231,843,1026,44,44,0.47058823529411764,30243153.57
JASON.DEMERS,20162017,FLA,1588.4833333333333,9,8,9,17,26,17,0,1,1,97,198,106,46,11,22,1356,1394,1080,1126,44,57,0,30243146.585
JASON.DICKINSON,20162017,DAL,117.89999999999999,2,0,0,0,2,2,4,13,9,9,19,8,5,3,0,102,88,101,88,2,5,0.3076923076923077,30243034.89
JASON.GARRISON,20162017,T.B,1299.4833333333333,1,6,1,7,8,7,0,0,0,96,193,93,42,3,7,984,1310,922,979,31,42,0,30243125.255
JASON.POMINVILLE,20162017,MIN,1180.0833333333333,13,20,15,35,48,33,42,88,46,186,326,46,76,10,2,1232,1017,1047,877,47,44,0.4772727272727273,30243119.055
JASON.SPEZZA,20162017,DAL,1099.6166666666668,15,15,20,35,50,30,354,678,324,149,285,13,65,8,13,1263,967,845,840,40,46,0.5221238938053098,30243135.89
JASON.ZUCKER,20162017,MIN,1293.85,23,16,9,25,48,39,1,5,4,192,321,82,53,36,15,1198,1192,1112,1060,68,34,0.2,30243148.725
JAY.BEAGLE,20162017,WSH,1256.1833333333334,13,13,4,17,30,26,703,1251,548,106,172,74,26,13,13,842,1326,742,854,34,24,0.5619504396482814,30243151.799999997
JAY.BOUWMEESTER,20162017,STL,2081.616666666667,1,7,6,13,14,8,0,0,0,114,224,78,75,4,16,1499,2125,1391,1549,67,66,0,30243180.14
JAY.MCCLEMENT,20162017,CAR,739.8666666666667,5,2,1,3,8,7,253,525,272,37,87,49,22,5,9,503,783,458,558,13,24,0.4819047619047619,30243100.045
JAYCOB.MEGNA,20162017,ANA,15.333333333333334,0,0,0,0,0,0,0,0,0,0,1,0,1,0,0,13,17,13,16,1,0,0,15121514.2
JAYSON.MEGNA,20162017,VAN,721.1833333333333,4,3,1,4,8,7,2,16,14,72,107,87,19,13,3,575,643,513,628,13,17,0.125,30243098.634999998
JEAN-GABRIEL.PAGEAU,20162017,OTT,1669.8833333333334,20,10,12,22,42,30,740,1354,614,212,327,214,41,25,18,1346,1787,1153,1298,50,43,0.5465288035450517,30243206.15
JEAN-SEBASTIEN.DEA,20162017,PIT,11.3,0,0,0,0,0,0,1,2,1,1,3,3,1,0,1,9,11,9,11,0,0,0.5,15121514.04
JEFF.CARTER,20162017,L.A,1478.6166666666668,32,21,12,33,65,53,735,1414,679,250,468,86,110,11,19,1731,1223,1104,911,45,38,0.5198019801980198,30243160.61
JEFF.PETRY,20162017,MTL,1917.6333333333332,9,11,8,19,28,20,0,0,0,184,396,190,124,5,12,1957,1664,1632,1357,61,57,0,30243143.7
JEFF.SKINNER,20162017,CAR,1401.35,37,19,7,26,63,56,10,27,17,281,490,33,111,33,16,1524,1210,1162,1106,61,56,0.37037037037037035,30243161.905
JESPER.FAST,20162017,NYR,1117.9,9,12,6,18,27,21,21,53,32,69,120,132,24,8,7,855,1084,786,851,37,34,0.39622641509433965,30243124.02
JESSE.PULJUJARVI,20162017,EDM,315.1166666666667,1,6,0,6,7,7,0,1,1,41,69,11,13,3,4,308,237,265,233,11,5,0,30243050.33
JIMMY.HAYES,20162017,BOS,535.35,2,2,1,3,5,4,14,55,41,74,134,74,36,8,9,520,464,484,453,17,20,0.2545454545454545,30243070.915
JIMMY.VESEY,20162017,NYR,1263.95,17,9,6,15,32,26,2,7,5,131,242,82,55,23,13,1128,1154,922,1109,37,48,0.2857142857142857,30243158.21
JIRI.HUDLER,20162017,DAL,379.20000000000005,3,5,3,8,11,8,3,5,2,27,55,9,17,4,2,416,333,294,315,13,12,0.6,30243060.384999998
JOAKIM.NORDSTROM,20162017,CAR,1042.9333333333334,7,2,3,5,12,9,9,29,20,104,185,148,40,12,7,809,980,738,764,17,29,0.3103448275862069,30243108.155
JOE.COLBORNE,20162017,COL,663.3333333333333,4,4,0,4,8,8,NA,NA,NA,NA,NA,NA,NA,14,17,547,581,447,504,11,32,NA,NA
JOE.MORROW,20162017,BOS,375,0,1,1,2,2,1,0,0,0,25,51,44,12,3,6,326,342,313,299,6,10,0,30243054.805
JOE.PAVELSKI,20162017,S.J,1656.6833333333334,31,25,15,40,71,56,474,897,423,247,449,144,84,27,14,1953,1393,1250,1172,53,40,0.5284280936454849,30243185.955
JOE.THORNTON,20162017,S.J,1482.6,7,18,26,44,51,25,388,768,380,85,154,57,29,15,16,1807,1152,1170,1007,46,38,0.5052083333333334,30243145.47
JOEL.ARMIA,20162017,WPG,862.8166666666666,10,6,3,9,19,16,3,7,4,111,195,68,52,14,10,695,881,593,678,21,30,0.42857142857142855,30243104.485
JOEL.EDMUNDSON,20162017,STL,1458.1,6,6,7,13,19,12,0,0,0,90,199,132,67,13,31,1193,1470,1126,1220,49,33,0,30243152.105
JOEL.ERIKSSON EK,20162017,MIN,181.91666666666669,3,2,2,4,7,5,57,135,78,20,33,27,4,1,2,139,185,139,181,7,6,0.4222222222222222,30243052.04
JOEL.HANLEY,20162017,MTL,71.1,0,0,0,0,0,0,0,0,0,5,5,8,0,1,1,57,57,55,56,1,4,0,30243031.41
JOEL.VERMIN,20162017,T.B,196.68333333333334,0,0,3,3,3,0,2,3,1,12,25,17,5,3,2,151,202,139,174,6,4,0.6666666666666666,30243044.185
JOEL.WARD,20162017,S.J,1316.7666666666667,10,8,14,22,32,18,235,480,245,112,223,69,48,11,17,1245,1275,1005,972,36,35,0.4895833333333333,30243139.06
JOHAN.LARSSON,20162017,BUF,606.6833333333334,6,2,3,5,11,8,261,533,272,49,93,33,20,9,10,482,628,438,510,20,24,0.4896810506566604,30243094.655
JOHN-MICHAEL.LILES,20162017,BOS,682.3833333333333,0,5,2,7,7,5,2,2,0,40,100,30,36,5,2,645,545,511,449,16,14,1,30243064.729999997
JOHN.CARLSON,20162017,WSH,1926.3000000000002,11,18,11,29,40,29,0,0,0,218,439,78,118,13,7,1863,1831,1335,1297,59,45,0,30243157.255
JOHN.HAYDEN,20162017,CHI,145.86666666666667,1,3,0,3,4,4,0,0,0,22,34,46,6,3,2,122,113,118,109,6,3,0,30243037.93
JOHN.KLINGBERG,20162017,DAL,1868.4666666666667,13,21,15,36,49,34,1,1,0,124,312,42,118,10,19,2039,1668,1438,1463,68,54,1,30243176.064999998
JOHN.MITCHELL,20162017,COL,816,3,1,2,3,6,4,298,538,240,NA,NA,NA,NA,4,17,672,722,620,632,11,24,0.5539033457249071,NA
JOHN.MOORE,20162017,N.J,1195.5166666666667,12,4,5,9,21,16,0,0,0,102,228,68,73,8,12,945,1181,785,899,34,43,0,30243123.005000003
JOHN.QUENNEVILLE,20162017,N.J,164.38333333333333,1,2,1,3,4,3,0,0,0,21,35,15,4,2,1,139,120,92,110,2,2,0,30243039.595
JOHN.TAVARES,20162017,NYI,1572.2166666666667,28,21,17,38,66,49,824,1628,804,260,470,42,109,30,18,1783,1378,1232,1094,56,50,0.5061425061425061,30243183.634999998
JOHNNY.BOYCHUK,20162017,NYI,1368.25,6,10,7,17,23,16,1,1,0,155,339,160,104,6,9,1330,1403,1034,1089,45,36,1,30243134.175
JOHNNY.GAUDREAU,20162017,CGY,1410.7666666666669,18,31,14,45,63,49,0,0,0,190,325,9,69,37,2,1585,1094,1024,974,41,45,0,30243144.77
JOHNNY.ODUYA,20162017,CHI,355.1,1,0,0,0,1,1,0,0,0,16,49,10,25,2,4,283,413,264,324,5,11,0,30243058.52
JOHNNY.ODUYA,20162017,DAL,672.4,1,3,3,6,7,4,0,0,0,24,83,21,32,3,5,544,771,515,548,21,25,0,30243078.555
JON.MERRILL,20162017,N.J,946.8833333333334,1,1,4,5,6,2,0,0,0,48,96,39,25,5,12,687,844,651,686,22,34,0,30243094.6
JONAS.BRODIN,20162017,MIN,1425.7,3,7,14,21,24,10,0,0,0,89,197,21,68,5,10,1251,1250,1014,973,48,41,0,30243116.35
JONATHAN.DROUIN,20162017,T.B,1292.5833333333333,21,17,15,32,53,38,96,220,124,183,323,50,77,12,9,1376,951,917,849,35,38,0.43636363636363634,30243131.235
JONATHAN.ERICSSON,20162017,DET,980.25,1,4,4,8,9,5,0,0,0,43,95,86,26,13,22,729,1008,686,790,37,36,0,30243109.03
JONATHAN.HUBERDEAU,20162017,FLA,555.5,10,8,6,14,24,18,4,9,5,86,136,18,25,6,5,648,409,434,369,21,20,0.4444444444444444,30243069.42
JONATHAN.MARCHESSAULT,20162017,FLA,1268.3000000000002,30,10,10,20,50,40,122,270,148,193,315,105,65,16,20,1388,967,927,867,42,55,0.45185185185185184,30243139.39
JONATHAN.TOEWS,20162017,CHI,1533.35,22,21,17,38,60,43,900,1640,740,209,325,51,66,17,16,1611,1375,1153,1071,47,42,0.5487804878048781,30243180.795
JONNY.BRODZINSKI,20162017,L.A,73.71666666666667,0,1,1,2,2,1,0,0,0,17,30,10,7,1,1,86,50,75,48,3,0,0,30243029.085
JOONAS.DONSKOI,20162017,S.J,895.3666666666667,6,6,7,13,19,12,8,16,8,100,181,27,39,17,4,926,704,754,661,22,29,0.5,30243091.915
JORDAN.EBERLE,20162017,EDM,1563.9333333333334,20,16,17,33,53,36,16,30,14,230,423,42,94,25,10,1796,1285,1289,1195,46,44,0.5333333333333333,30243157.165
JORDAN.MARTINOOK,20162017,ARI,1207.3000000000002,11,10,4,14,25,21,460,1037,577,109,199,50,39,11,20,961,1343,835,964,34,39,0.44358727097396333,30243163.71
JORDAN.NOLAN,20162017,L.A,499.3666666666667,4,2,2,4,8,6,2,6,4,39,89,61,21,10,16,453,399,432,396,10,13,0.3333333333333333,30243067.33
JORDAN.OESTERLE,20162017,EDM,34.56666666666666,0,0,0,0,0,0,0,0,0,2,9,2,6,0,0,43,27,42,27,0,1,0,30243026.65
JORDAN.SCHMALTZ,20162017,STL,138.36666666666665,0,1,1,2,2,1,0,0,0,5,10,4,2,0,2,132,126,111,119,5,5,0,30243037.925
JORDAN.SCHROEDER,20162017,MIN,361.83333333333337,6,4,3,7,13,10,19,40,21,37,55,29,6,4,0,282,373,280,372,14,10,0.475,30243073.675
JORDAN.STAAL,20162017,CAR,1399.6166666666668,16,11,18,29,45,27,688,1165,477,164,272,139,43,22,15,1529,1080,1085,850,44,42,0.590557939914163,30243131.939999998
JORDAN.WEAL,20162017,PHI,329.15,8,2,2,4,12,10,14,28,14,49,73,7,11,2,5,363,264,306,242,14,11,0.5,30243053.38
JORDIE.BENN,20162017,DAL,1079.4333333333334,2,6,6,12,14,8,0,0,0,59,155,52,53,7,12,1026,1178,859,883,26,31,0,30243113.119999997
JORDIE.BENN,20162017,MTL,340.91666666666663,2,0,0,0,2,2,0,0,0,18,48,17,22,4,5,328,328,314,265,8,12,0,30243048.14
JORDIN.TOOTOO,20162017,CHI,349.7833333333333,2,0,1,1,3,2,1,1,0,45,85,54,24,11,8,314,331,311,327,5,11,1,30243059.674999997
JORI.LEHTERA,20162017,STL,1067.8833333333332,8,7,11,18,26,15,433,900,467,72,108,79,27,17,17,982,924,800,797,37,37,0.4811111111111111,30243131.064999998
JOSEPH.BLANDISI,20162017,N.J,360.7166666666667,3,4,2,6,9,7,76,169,93,24,50,37,11,4,8,343,294,264,270,6,12,0.44970414201183434,30243061.03
JOSEPH.CRAMAROSSA,20162017,ANA,480.95000000000005,4,3,3,6,10,7,6,7,1,26,46,108,8,18,11,304,467,283,406,11,12,0.8571428571428571,30243077.195
JOSEPH.CRAMAROSSA,20162017,VAN,105.85,0,0,0,0,0,0,0,0,0,10,16,25,4,2,3,69,114,69,111,2,3,0,30243038.770000003
JOSEPH.LABATE,20162017,VAN,87.93333333333334,0,0,0,0,0,0,1,1,0,5,13,23,4,5,6,67,87,66,87,2,4,1,30243035.54
JOSH.ANDERSON,20162017,CBJ,1006.1500000000001,18,8,4,12,30,26,9,32,23,130,212,164,39,29,37,852,986,836,943,45,31,0.28125,30243143.25
JOSH.ARCHIBALD,20162017,PIT,140.04999999999998,3,0,0,0,3,3,0,1,1,15,30,37,6,3,3,107,132,104,123,5,4,0,30243040.48
JOSH.BAILEY,20162017,NYI,1506.4666666666667,13,30,13,43,56,43,8,15,7,173,304,37,75,11,5,1631,1329,1186,1153,60,55,0.5333333333333333,30243155.255
JOSH.GORGES,20162017,BUF,1218.1833333333334,1,2,2,4,5,3,0,1,1,40,80,143,26,10,19,872,1354,825,990,26,31,0,30243131.9
JOSH.JOORIS,20162017,ARI,555.3,3,3,4,7,10,6,191,390,199,64,97,28,18,9,5,404,653,384,479,14,19,0.4897435897435897,30243089.48
JOSH.JOORIS,20162017,NYR,103.26666666666667,1,0,1,1,2,1,30,59,29,10,21,21,7,3,3,68,123,68,115,3,2,0.5084745762711864,30243040.755000003
JOSH.LEIVO,20162017,TOR,163.46666666666667,2,6,2,8,10,8,1,2,1,27,47,5,7,4,2,188,122,140,113,8,4,0.5,30243039.78
JOSH.MANSON,20162017,ANA,1876.55,5,6,9,15,20,11,0,0,0,115,238,280,67,23,38,1619,1814,1525,1325,59,54,0,30243148.255000003
JOSH.MORRISSEY,20162017,WPG,1597.0666666666666,6,8,5,13,19,14,0,0,0,99,216,145,83,9,20,1417,1436,1291,1235,63,64,0,30243141.314999998
JOSHUA.HO-SANG,20162017,NYI,345.58333333333337,4,5,1,6,10,9,0,2,2,22,44,4,12,6,5,375,280,291,265,13,11,0,30243054.585
JT.COMPHER,20162017,COL,11.216666666666667,0,0,0,0,0,0,4,7,3,0,1,3,1,0,1,13,3,11,3,0,1,0.5714285714285714,15121512.76
JUJHAR.KHAIRA,20162017,EDM,92.56666666666666,1,0,0,0,1,1,7,19,12,10,18,20,3,0,1,76,71,75,69,2,1,0.3684210526315789,30243033.23
JULIAN.MELCHIORI,20162017,WPG,330.6,0,1,1,2,2,1,0,0,0,15,33,30,10,1,4,252,323,246,277,11,10,0,30243053.585
JULIUS.HONKA,20162017,DAL,269.9,1,4,0,4,5,5,0,0,0,34,61,9,17,2,2,290,209,235,198,8,11,0,30243044.619999997
JUSSI.JOKINEN,20162017,FLA,1201.3333333333335,11,11,6,17,28,22,75,144,69,118,199,28,41,16,18,1263,977,899,788,26,40,0.5208333333333334,30243114.36
JUSTIN.ABDELKADER,20162017,DET,1066.15,7,9,4,13,20,16,5,17,12,104,160,144,20,35,22,938,933,640,751,17,35,0.29411764705882354,30243120.15
JUSTIN.BAILEY,20162017,BUF,340.23333333333335,2,1,1,2,4,3,0,1,1,36,75,27,26,9,2,283,371,278,367,11,10,0,30243065.365000002
JUSTIN.BRAUN,20162017,S.J,1738,4,5,5,10,14,9,0,0,0,98,245,144,87,5,13,1307,1849,1226,1378,41,48,0,30243164.525
JUSTIN.DOWLING,20162017,DAL,94.23333333333333,0,1,1,2,2,1,38,69,31,11,21,1,7,0,2,84,71,76,64,1,2,0.5507246376811594,30243032.744999997
JUSTIN.FALK,20162017,BUF,712.3,0,2,5,7,7,2,0,0,0,33,86,101,28,3,13,610,666,600,582,19,21,0,30243080.855
JUSTIN.FAULK,20162017,CAR,1735.55,17,10,7,17,34,27,0,0,0,225,457,116,139,11,15,1846,1409,1360,1244,46,61,0,30243147.884999998
JUSTIN.SCHULTZ,20162017,PIT,2009.4666666666667,16,20,27,47,63,36,0,0,0,181,356,83,118,5,19,2155,1731,1566,1561,84,62,0,30243187.225
JUSTIN.WILLIAMS,20162017,WSH,1480.3833333333332,27,11,19,30,57,38,70,126,56,196,352,42,74,19,26,1621,1144,1214,1033,59,40,0.5555555555555556,30243142.165
JYRKI.JOKIPAKKA,20162017,CGY,548.4000000000001,1,1,4,5,6,2,0,0,0,29,56,25,19,5,6,442,534,422,500,18,21,0,30243077.799999997
JYRKI.JOKIPAKKA,20162017,OTT,42.96666666666667,0,0,0,0,0,0,0,0,0,0,4,5,2,0,0,34,36,34,36,0,1,0,15121516.15
KALLE.KOSSILA,20162017,ANA,6.9,0,0,0,0,0,0,3,7,4,1,2,1,1,0,0,7,2,7,2,0,0,0.42857142857142855,15121512.77
KARL.ALZNER,20162017,WSH,1733.1166666666668,3,5,5,10,13,8,0,0,0,82,169,114,47,9,15,1262,1804,1173,1300,60,39,0,30243157.465
KARL.STOLLERY,20162017,N.J,186.1,0,0,3,3,3,0,0,0,0,11,23,26,7,4,5,161,145,121,137,5,9,0,30243039.765
KASPERI.KAPANEN,20162017,TOR,150.35000000000002,3,0,0,0,3,3,1,1,0,19,32,17,7,3,0,119,141,117,113,3,7,1,30243038.17
KEITH.YANDLE,20162017,FLA,1807.2666666666667,5,19,16,35,40,24,0,0,0,178,393,28,127,20,18,1895,1536,1244,1223,43,46,0,30243148.2
KENNY.AGOSTINO,20162017,STL,89.43333333333334,1,2,0,2,3,3,0,0,0,17,26,9,2,1,1,97,66,86,65,3,3,0,30243033.009999998
KEVAN.MILLER,20162017,BOS,1183.5666666666666,3,3,5,8,11,6,0,0,0,58,124,141,42,14,20,982,1060,897,810,31,35,0,30243101.365000002
KEVIN.BIEKSA,20162017,ANA,1654.35,3,3,12,15,18,6,0,0,0,104,217,191,57,20,29,1337,1695,1164,1400,53,53,0,30243175.2
KEVIN.CONNAUTON,20162017,ARI,315.16666666666663,0,1,0,1,1,1,0,0,0,21,51,48,16,2,8,258,352,252,304,10,11,0,30243057.42
KEVIN.FIALA,20162017,NSH,799.1833333333334,13,3,2,5,18,16,0,0,0,126,203,48,43,8,10,861,642,751,612,22,18,0,30243088.78
KEVIN.GRAVEL,20162017,L.A,693.3666666666667,1,2,3,5,6,3,0,0,0,52,116,73,32,6,3,685,543,609,500,21,15,0,30243067.235
KEVIN.HAYES,20162017,NYR,1471.2166666666667,17,20,14,34,51,37,544,1165,621,164,291,57,79,9,11,1209,1478,890,1176,48,48,0.4669527896995708,30243197.85
KEVIN.KLEIN,20162017,NYR,1076.4166666666665,3,7,5,12,15,10,0,0,0,54,117,139,41,7,10,923,1070,860,916,41,45,0,30243118.195
KEVIN.LABANC,20162017,S.J,737.0333333333333,8,10,1,11,19,18,2,4,2,68,147,18,41,5,11,732,664,611,617,28,20,0.5,30243093.505
KEVIN.PORTER,20162017,PIT,22.5,0,0,0,0,0,0,7,19,12,0,2,5,1,0,0,16,21,16,16,0,1,0.3684210526315789,15121514.73
KEVIN.ROONEY,20162017,N.J,40.75,0,0,0,0,0,0,10,27,17,2,5,4,1,1,2,24,34,24,30,0,3,0.37037037037037035,30243029.81
KEVIN.SHATTENKIRK,20162017,STL,1211.3333333333333,11,11,17,28,39,22,0,0,0,115,245,70,88,4,17,1150,849,795,712,35,35,0,30243097.465
KEVIN.SHATTENKIRK,20162017,WSH,623.8333333333333,3,11,5,16,19,14,0,0,0,82,137,38,27,1,8,724,474,516,430,17,14,0,30243071.435000002
KLAS.DAHLBECK,20162017,CAR,597.2,2,2,2,4,6,4,0,0,0,37,98,77,36,3,15,489,598,471,561,14,27,0,30243085.380000003
KORBINIAN.HOLZER,20162017,ANA,491.6666666666667,2,2,3,5,7,4,0,0,0,14,39,78,13,3,15,333,490,320,436,15,16,0,30243076.405
KRIS.LETANG,20162017,PIT,1046.2333333333333,5,9,20,29,34,14,0,0,0,122,227,70,64,12,16,1107,934,758,656,32,31,0,30243090.17
KRIS.RUSSELL,20162017,EDM,1729.0833333333335,1,4,10,14,15,5,0,0,0,84,198,88,72,15,12,1367,1885,1213,1434,48,40,0,30243171.75
KRIS.VERSTEEG,20162017,CGY,1077.5,16,13,11,24,40,29,58,111,53,148,272,5,80,18,17,1080,844,696,766,27,28,0.5225225225225225,30243120.925
KURTIS.GABRIEL,20162017,MIN,75.65,0,0,1,1,1,0,0,0,0,3,6,26,1,5,7,39,84,39,84,2,2,0,30243037.025
KYLE.BRODZIAK,20162017,STL,896.2833333333333,8,3,5,8,16,11,386,792,406,63,107,61,24,10,12,565,921,532,662,24,26,0.48737373737373735,30243120.115000002
KYLE.CLIFFORD,20162017,L.A,782.8,6,6,0,6,12,12,2,5,3,122,199,146,33,20,25,753,574,730,564,14,16,0.4,30243084.23
KYLE.CONNOR,20162017,WPG,244.41666666666666,2,1,2,3,5,3,1,2,1,24,41,1,4,2,2,211,209,160,201,6,13,0.5,30243049.810000002
KYLE.OKPOSO,20162017,BUF,1233.0333333333333,19,13,13,26,45,32,54,99,45,156,284,53,71,9,11,1313,1063,825,932,32,33,0.5454545454545454,30243141.275
KYLE.PALMIERI,20162017,N.J,1387.9166666666665,26,13,13,26,52,39,12,29,17,192,372,124,96,29,16,1292,1194,874,950,42,28,0.41379310344827586,30243142.945
KYLE.QUINCEY,20162017,CBJ,356.4666666666667,2,1,1,2,4,3,0,0,0,19,43,30,18,2,7,283,384,261,315,8,9,0,30243059.845
KYLE.QUINCEY,20162017,N.J,987.8333333333334,4,4,4,8,12,8,0,0,0,61,123,73,50,7,18,745,958,685,753,30,32,0,30243103.32
KYLE.RAU,20162017,FLA,230.39999999999998,2,0,1,1,3,2,2,3,1,21,33,24,7,1,1,190,200,174,198,5,8,0.6666666666666666,30243047.415
KYLE.TURRIS,20162017,OTT,1925.8166666666666,31,25,8,33,64,56,847,1587,740,231,451,69,131,17,25,1979,1764,1362,1469,52,56,0.5337114051669817,30243230.35
LANCE.BOUMA,20162017,CGY,722.0833333333334,3,1,3,4,7,4,4,12,8,56,98,132,18,14,14,476,707,447,512,17,21,0.3333333333333333,30243082.975
LARS.ELLER,20162017,WSH,1311.7666666666667,12,9,8,17,29,21,493,1054,561,137,265,95,62,29,22,1203,1253,1100,885,43,29,0.46774193548387094,30243135.009999998
LAURENT.DAUPHIN,20162017,ARI,261.83333333333337,2,1,0,1,3,3,37,82,45,32,41,31,5,2,5,198,297,182,214,4,6,0.45121951219512196,30243053.35
LAURI.KORPIKOSKI,20162017,CBJ,74.19999999999999,0,0,0,0,0,0,0,0,0,4,8,3,2,1,0,59,74,59,72,1,0,0,30243033.11
LAURI.KORPIKOSKI,20162017,DAL,781.8666666666666,8,9,3,12,20,17,0,7,7,104,170,34,37,2,5,658,878,594,705,27,22,0,30243109.045
LAWSON.CROUSE,20162017,ARI,855.7833333333333,5,5,2,7,12,10,1,2,1,84,155,160,27,14,18,665,985,638,768,17,38,0.5,30243115.68
LEE.STEMPNIAK,20162017,CAR,1299.1999999999998,16,13,11,24,40,29,3,8,5,131,249,113,62,14,21,1312,1074,1028,1012,50,45,0.375,30243138.335
LEO.KOMAROV,20162017,TOR,1517.6833333333334,14,12,7,19,33,26,102,221,119,124,196,262,29,18,13,1467,1553,1059,1115,49,47,0.46153846153846156,30243158.285
LEON.DRAISAITL,20162017,EDM,1801.3166666666666,35,36,20,56,91,71,554,1140,586,195,353,62,72,23,14,2032,1532,1326,1292,71,58,0.48596491228070177,30243213.189999998
LIAM.O'BRIEN,20162017,WSH,6.133333333333334,0,0,0,0,0,0,0,0,0,0,0,1,0,0,0,9,7,9,7,0,0,0,15121513.35
LINDEN.VEY,20162017,CGY,44.06666666666667,0,0,0,0,0,0,9,24,15,1,5,1,2,0,0,43,27,30,25,0,2,0.375,15121515.41
LOGAN.COUTURE,20162017,S.J,1377.6,27,20,6,26,53,47,312,785,473,182,347,61,90,10,5,1510,1258,927,977,43,26,0.3974522292993631,30243166.58
LOGAN.SHAW,20162017,ANA,619.6833333333334,3,3,3,6,9,6,56,145,89,66,104,75,17,2,6,435,619,393,471,13,14,0.38620689655172413,30243084.085
LOUI.ERIKSSON,20162017,VAN,1213.75,11,10,3,13,24,21,0,1,1,132,212,11,53,12,4,1118,1051,840,818,32,36,0,30243114.245
LUCA.SBISA,20162017,VAN,1555.7666666666669,2,4,7,11,13,6,0,0,0,75,197,129,92,11,17,1110,1577,1060,1248,42,46,0,30243150.135
LUCAS.WALLMARK,20162017,CAR,86.9,0,0,2,2,2,0,31,58,27,11,19,14,5,0,1,77,80,75,79,3,2,0.5344827586206896,30243034.29
LUKAS.SEDLAK,20162017,CBJ,619.3666666666666,7,3,3,6,13,10,239,455,216,59,119,66,31,12,10,534,555,514,470,23,19,0.5252747252747253,30243081.955
LUKE.GAZDIC,20162017,N.J,78.44999999999999,0,0,0,0,0,0,0,0,0,3,5,16,1,4,3,34,73,33,73,0,2,0,30243035.29
LUKE.GLENDENING,20162017,DET,955.7166666666667,3,9,2,11,14,12,307,568,261,76,122,150,15,9,12,600,1068,546,722,17,26,0.5404929577464789,30243124.57
LUKE.SCHENN,20162017,ARI,1407.8166666666666,1,2,4,6,7,3,0,0,0,94,213,286,78,14,27,1116,1667,1062,1325,37,47,0,30243164.89
LUKE.WITKOWSKI,20162017,T.B,335.6,0,0,4,4,4,0,0,0,0,24,42,81,11,6,16,311,317,307,312,10,10,0,30243057.759999998
MACKENZIE.WEEGAR,20162017,FLA,52.333333333333336,0,0,0,0,0,0,0,0,0,3,5,4,0,0,2,43,34,34,33,1,1,0,30243029.05
MAGNUS.PAAJARVI,20162017,STL,489.8333333333333,9,4,3,7,16,13,1,3,2,60,93,39,20,7,4,413,439,392,401,21,12,0.3333333333333333,30243072.385
MARC-EDOUARD.VLASIC,20162017,S.J,1710.1666666666667,6,14,10,24,30,20,0,0,0,152,339,20,112,13,13,1473,1695,1132,1214,49,44,0,30243149.18
MARC.METHOT,20162017,OTT,1747.7833333333333,2,6,7,13,15,8,0,0,0,85,146,244,43,11,17,1424,1803,1302,1426,61,51,0,30243170.835
MARC.STAAL,20162017,NYR,1611.7833333333333,3,4,3,7,10,7,0,1,1,82,170,114,49,15,18,1301,1678,1202,1379,55,52,0,30243168.175
MARCO.SCANDELLA,20162017,MIN,1416.65,4,4,3,7,11,8,0,0,0,98,221,61,83,9,12,1215,1410,1110,1140,49,52,0,30243133.215
MARCUS.FOLIGNO,20162017,BUF,1237.7333333333333,13,4,6,10,23,17,1,5,4,97,175,279,36,31,23,1015,1237,959,1062,35,39,0.2,30243146.75
MARCUS.JOHANSSON,20162017,WSH,1646.9833333333331,26,21,19,40,66,47,14,32,18,152,277,61,77,20,6,1798,1211,1232,1081,65,40,0.4375,30243145.384999998
MARCUS.KRUGER,20162017,CHI,1042.75,5,5,8,13,18,10,376,779,403,90,138,33,24,9,16,803,1069,759,739,31,26,0.48267008985879334,30243120.38
MARCUS.SORENSEN,20162017,S.J,271.23333333333335,2,1,3,4,6,3,4,5,1,32,56,19,16,4,2,238,266,233,223,7,6,0.8,30243047.975
MAREK.HRIVIK,20162017,NYR,166.55,0,1,1,2,2,1,32,80,48,15,28,19,4,2,1,173,138,169,133,3,6,0.4,30243039.575000003
MARIAN.GABORIK,20162017,L.A,828.1833333333334,10,9,2,11,21,19,0,1,1,123,216,21,47,5,9,923,636,761,590,25,23,0,30243084.85
MARIAN.HOSSA,20162017,CHI,1306.6499999999999,26,11,7,18,44,37,5,14,9,182,325,35,82,12,5,1149,1227,868,913,32,31,0.35714285714285715,30243137.095
MARK.BARBERIO,20162017,COL,702.4,2,4,3,7,9,6,0,0,0,52,137,10,46,4,2,705,603,554,554,19,24,0,30243077.915
MARK.BARBERIO,20162017,MTL,393.18333333333334,0,2,2,4,4,2,0,0,0,28,61,10,23,0,4,360,293,323,263,11,10,0,30243046.95
MARK.BOROWIECKI,20162017,OTT,1001.5166666666667,1,2,0,2,3,3,1,1,0,51,118,372,42,32,48,876,984,850,894,23,28,1,30243119.21
MARK.FAYNE,20162017,EDM,31.666666666666668,0,2,0,2,2,2,0,0,0,4,7,1,0,0,0,32,25,32,25,2,1,0,30243028.65
MARK.GIORDANO,20162017,CGY,2012.2,12,13,15,28,40,25,0,0,0,157,392,89,150,14,28,1938,1828,1394,1189,60,41,0,30243131.515
MARK.JANKOWSKI,20162017,CGY,10.3,0,0,0,0,0,0,5,8,3,0,0,1,0,0,0,8,9,8,9,0,0,0.625,15121513.8
MARK.LETESTU,20162017,EDM,1339.1999999999998,21,16,9,25,46,37,542,1095,553,154,284,93,70,7,7,1204,1289,670,821,27,29,0.4949771689497717,30243155.825
MARK.MCNEILL,20162017,DAL,13.816666666666666,0,0,0,0,0,0,0,2,2,1,1,0,0,0,0,9,18,9,18,0,1,0,15121515.15
MARK.PYSYK,20162017,FLA,1521.9833333333333,4,3,9,12,16,7,0,1,1,85,171,72,48,5,5,1157,1432,1086,1019,45,50,0,30243120.325
MARK.SCHEIFELE,20162017,WPG,1624.05,32,25,24,49,81,57,635,1461,826,160,278,49,61,29,19,1713,1375,1115,1089,70,55,0.4346338124572211,30243197.490000002
MARK.STONE,20162017,OTT,1710.9166666666665,27,19,16,35,62,46,16,34,18,177,300,75,56,26,22,1926,1315,1335,1148,61,44,0.47058823529411764,30243157.1
MARK.STREIT,20162017,PHI,948.1500000000001,5,4,11,15,20,9,0,0,0,88,176,25,53,5,11,1006,811,758,713,23,32,0,30243095.775
MARK.STREIT,20162017,PIT,370.1,1,3,4,7,8,4,0,0,0,28,55,16,19,1,2,421,313,314,278,9,11,0,30243051.66
MARK.STUART,20162017,WPG,523.0833333333333,2,1,1,2,4,3,0,0,0,24,52,68,19,5,11,386,648,357,445,14,13,0,30243074.375
MARKO.DANO,20162017,WPG,406.01666666666665,4,3,4,7,11,7,1,4,3,44,77,83,11,8,5,360,328,285,304,9,7,0.25,30243061.77
MARKUS.GRANLUND,20162017,VAN,1193.7333333333333,19,8,5,13,32,27,40,100,60,122,218,32,44,14,7,1070,995,834,810,31,46,0.4,30243122.015
MARKUS.HANNIKAINEN,20162017,CBJ,91.26666666666667,1,0,1,1,2,1,0,0,0,8,14,16,3,1,2,72,75,71,59,4,4,0,30243031.235
MARKUS.NUTIVAARA,20162017,CBJ,895.8833333333333,3,1,5,6,9,4,0,0,0,73,142,38,45,2,3,797,817,772,804,33,22,0,30243102.945
MARTIN.FRK,20162017,CAR,16.6,0,0,0,0,0,0,0,0,0,1,3,3,1,1,0,10,13,10,13,0,3,0,15121514.11
MARTIN.HANZAL,20162017,ARI,947.75,16,7,3,10,26,23,596,1064,468,126,205,105,35,23,20,966,886,631,695,24,36,0.5601503759398496,30243131.595
MARTIN.HANZAL,20162017,MIN,404.06666666666666,5,5,4,9,14,10,222,385,163,53,85,54,14,3,5,406,312,351,232,14,15,0.5766233766233766,30243054.46
MARTIN.MARINCIN,20162017,TOR,552.4666666666667,1,2,4,6,7,3,0,0,0,31,82,31,33,9,9,488,637,458,467,25,22,0,30243069.04
MASON.RAYMOND,20162017,ANA,35.63333333333333,0,0,0,0,0,0,0,1,1,3,5,3,1,0,0,31,33,28,33,0,2,0,15121516.35
MATHEW.BARZAL,20162017,NYI,19.5,0,0,0,0,0,0,6,13,7,0,0,1,0,0,3,12,28,11,28,0,2,0.46153846153846156,30243029.89
MATHIEU.PERREAULT,20162017,WPG,1058.75,13,18,14,32,45,31,97,189,92,134,218,97,34,20,15,1162,800,796,712,40,51,0.5132275132275133,30243114.229999997
MATS.ZUCCARELLO,20162017,NYR,1752.8666666666668,19,26,21,47,66,45,6,14,8,214,371,116,87,30,20,1891,1443,1292,1254,61,45,0.42857142857142855,30243170.314999998
MATT.BARTKOWSKI,20162017,CGY,420.26666666666665,1,0,1,1,2,1,0,0,0,21,60,57,26,4,6,341,437,335,408,13,21,0,30243066.865000002
MATT.BELESKEY,20162017,BOS,673.9833333333333,3,1,4,5,8,4,29,70,41,82,155,104,39,12,21,667,522,521,457,12,24,0.4142857142857143,30243072.43
MATT.BENNING,20162017,EDM,1235.5500000000002,3,8,6,14,17,11,0,0,0,78,176,158,63,15,20,1139,1094,1013,962,50,38,0,30243116.2
MATT.CALVERT,20162017,CBJ,924.4666666666667,11,2,3,5,16,13,2,16,14,101,169,74,31,14,17,702,973,642,747,26,29,0.125,30243114.345
MATT.CARLE,20162017,NSH,78.86666666666667,0,1,0,1,1,1,0,0,0,2,4,3,1,0,0,62,70,60,61,3,4,0,30243031.700000003
MATT.CULLEN,20162017,PIT,1360.1833333333334,15,14,10,24,39,29,619,1176,557,117,191,56,35,16,17,997,1491,861,988,38,44,0.5263605442176871,30243168.87
MATT.DUCHENE,20162017,COL,1408.6,NA,14,9,23,NA,NA,685,NA,NA,NA,NA,NA,NA,15,5,1381,1201,919,963,32,59,NA,NA
MATT.DUMBA,20162017,MIN,1664.25,11,10,13,23,34,21,0,0,0,138,311,115,119,13,25,1599,1419,1208,1259,64,48,0,30243151.455
MATT.GREENE,20162017,L.A,342.73333333333335,1,0,1,1,2,1,0,0,0,14,50,71,26,2,8,294,307,287,264,8,6,0,30243048.345
MATT.GRZELCYK,20162017,BOS,24.96666666666667,0,0,0,0,0,0,0,0,0,4,8,0,3,0,1,37,26,28,25,2,1,0,30243027.450000003
MATT.HENDRICKS,20162017,EDM,451.45,4,0,3,3,7,4,132,232,100,42,61,79,10,8,12,306,474,287,349,12,13,0.5689655172413793,30243070.884999998
MATT.HUNWICK,20162017,TOR,1448.3333333333333,1,9,8,17,18,10,0,0,0,81,198,105,74,6,10,1211,1547,1140,1150,45,41,0,30243135.009999998
MATT.IRWIN,20162017,NSH,1465.6833333333334,3,4,7,11,14,7,0,0,0,108,264,159,105,12,14,1251,1344,1200,1165,50,40,0,30243129.445
MATT.LORITO,20162017,DET,28.866666666666667,0,0,1,1,1,0,0,0,0,6,8,0,1,0,0,17,22,15,22,1,1,0,15121515.375
MATT.MARTIN,20162017,TOR,789.3,5,3,3,6,11,8,0,11,11,69,120,339,19,34,36,651,734,644,694,22,24,0,30243106.365000002
MATT.MOULSON,20162017,BUF,940.1333333333333,14,9,9,18,32,23,1,4,3,133,199,37,26,5,5,986,698,669,658,23,26,0.25,30243106.415
MATT.NIETO,20162017,COL,685.15,NA,2,2,4,NA,NA,NA,NA,NA,NA,NA,NA,NA,7,2,582,610,497,459,10,19,NA,NA
MATT.NIETO,20162017,S.J,195.41666666666669,0,1,1,2,2,1,0,2,2,24,37,23,5,1,2,171,192,164,151,4,7,0,30243040.835
MATT.NISKANEN,20162017,WSH,2024.0666666666668,6,20,16,36,42,26,0,0,0,178,396,192,149,6,20,1928,1729,1512,1266,69,50,0,30243135.46
MATT.PUEMPEL,20162017,NYR,274.35,6,2,1,3,9,8,0,0,0,32,56,18,9,4,2,232,244,196,235,8,12,0,30243055.715000004
MATT.PUEMPEL,20162017,OTT,111.4,0,0,0,0,0,0,0,1,1,12,24,10,8,2,3,125,95,114,94,0,5,0,30243033.82
MATT.READ,20162017,PHI,869.0999999999999,10,7,2,9,19,17,5,15,10,92,161,95,37,5,4,849,755,752,622,20,18,0.3333333333333333,30243089.35
MATT.STAJAN,20162017,CGY,1057.9666666666667,6,10,7,17,23,16,395,792,397,60,112,63,17,12,20,752,1016,692,723,26,28,0.49873737373737376,30243125.145
MATT.TENNYSON,20162017,CAR,597.9000000000001,0,5,1,6,6,5,0,0,0,36,82,65,32,3,3,514,594,497,549,19,33,0,30243080.455
MATTHEW.PECA,20162017,T.B,114.45,1,1,0,1,2,2,32,72,40,9,24,9,7,0,1,106,91,93,84,2,3,0.4444444444444444,30243035.630000003
MATTHEW.TKACHUK,20162017,CGY,1176.35,13,25,10,35,48,38,7,22,15,148,238,72,40,47,38,1326,897,1041,831,46,35,0.3181818181818182,30243123.049999997
MATTIAS.EKHOLM,20162017,NSH,2480.4333333333334,4,9,18,27,31,13,0,0,0,153,366,86,130,21,30,2268,2165,1916,1641,71,60,0,30243167.16
MAX.DOMI,20162017,ARI,1001.8666666666666,9,19,10,29,38,28,5,10,5,107,209,28,61,16,17,982,935,689,841,35,37,0.5,30243128.560000002
MAX.MCCORMICK,20162017,OTT,47.31666666666666,0,0,0,0,0,0,15,24,9,7,14,13,5,0,0,49,63,49,63,0,3,0.625,30243032.4
MAX.PACIORETTY,20162017,MTL,1677.6999999999998,35,19,14,33,68,54,27,50,23,296,558,74,137,21,21,1868,1374,1396,1141,56,43,0.54,30243152.939999998
MELKER.KARLSSON,20162017,S.J,931.1500000000001,11,5,6,11,22,16,2,7,5,79,144,83,29,17,13,764,945,724,721,26,21,0.2857142857142857,30243106.4
MICHAEL.BOURNIVAL,20162017,T.B,192.8,2,0,1,1,3,2,1,3,2,25,46,31,7,1,1,177,167,167,162,3,6,0.3333333333333333,30243042.925
MICHAEL.CHAPUT,20162017,VAN,749.5,4,2,3,5,9,6,203,385,182,64,113,68,33,8,13,613,734,593,667,15,26,0.5272727272727272,30243105.125
MICHAEL.DEL ZOTTO,20162017,PHI,994.7,6,7,5,12,18,13,0,1,1,92,188,173,56,12,13,940,960,831,793,34,35,0,30243104.545
MICHAEL.FROLIK,20162017,CGY,1475.9833333333331,17,12,16,28,45,29,14,31,17,209,363,63,82,7,24,1475,1291,1168,939,45,43,0.45161290322580644,30243123.43
MICHAEL.GRABNER,20162017,NYR,1239.5,31,11,4,15,46,42,7,13,6,188,300,62,49,14,5,967,1324,857,1061,51,36,0.5384615384615384,30243165.37
MICHAEL.KAPLA,20162017,N.J,87.2,0,0,0,0,0,0,0,0,0,4,10,5,5,0,0,77,70,72,60,2,3,0,30243030.05
MICHAEL.MATHESON,20162017,FLA,1705.8833333333332,7,7,3,10,17,14,1,1,0,179,314,69,68,16,18,1434,1673,1233,1264,46,56,1,30243157.125
MICHAEL.MCCARRON,20162017,MTL,312.8833333333333,1,3,1,4,5,4,76,175,99,31,56,76,11,10,13,259,256,231,248,7,12,0.4342857142857143,30243058.665
MICHAEL.RAFFL,20162017,PHI,689.6333333333333,8,2,1,3,11,10,3,10,7,63,112,91,23,12,7,705,618,698,602,19,25,0.3,30243086.015
MICHAEL.SGARBOSSA,20162017,ANA,85.21666666666667,0,1,1,2,2,1,34,81,47,7,13,6,2,1,0,74,66,68,61,1,3,0.41975308641975306,30243033.795
MICHAEL.SGARBOSSA,20162017,FLA,338.6166666666667,2,4,1,5,7,6,104,233,129,26,42,32,8,6,3,277,266,240,250,8,8,0.44635193133047213,30243059.495
MICHAEL.STONE,20162017,ARI,910.1,1,3,5,8,9,4,1,1,0,57,128,98,36,4,6,725,997,578,789,21,24,1,30243112.905
MICHAEL.STONE,20162017,CGY,433.3,3,3,1,4,7,6,0,0,0,29,74,34,29,2,10,350,426,323,357,14,11,0,30243063.244999997
MICHAEL.ZALEWSKI,20162017,VAN,8.05,0,0,0,0,0,0,0,0,0,0,1,0,0,0,0,4,10,4,10,0,1,0,15121514.05
MICHAL.KEMPNY,20162017,CHI,757.1499999999999,2,2,3,5,7,4,0,0,0,68,174,78,67,3,11,779,672,764,588,26,26,0,30243069.355
MICHAL.ROZSIVAL,20162017,CHI,340.9,1,1,0,1,2,2,0,0,0,16,26,47,4,0,7,302,319,290,273,8,11,0,30243053.25
MICHEAL.FERLAND,20162017,CGY,928.8,15,6,4,10,25,21,4,8,4,121,191,161,27,15,14,875,827,785,785,31,35,0.5,30243117.86
MICHEAL.HALEY,20162017,S.J,532.3166666666666,2,6,3,9,11,8,66,149,83,38,86,129,22,25,33,465,498,461,493,21,15,0.4429530201342282,30243085.465
MIIKKA.SALOMAKI,20162017,NSH,110.28333333333333,0,0,0,0,0,0,1,1,0,7,18,26,6,1,1,75,115,74,103,3,4,1,30243036.4
MIKA.ZIBANEJAD,20162017,NYR,1170.5333333333333,16,13,17,30,46,29,595,1165,570,153,288,43,54,16,7,1196,1051,808,855,43,34,0.5107296137339056,30243149.835
MIKAEL.BACKLUND,20162017,CGY,1505.3333333333333,23,21,12,33,56,44,755,1566,811,211,355,63,67,7,12,1514,1315,1080,903,44,41,0.4821200510855683,30243164.27
MIKAEL.GRANLUND,20162017,MIN,1627.4166666666665,26,31,13,44,70,57,16,33,17,187,341,56,79,21,7,1542,1444,1098,1115,58,41,0.48484848484848486,30243164.825
MIKE.BLUNDEN,20162017,OTT,16.233333333333334,0,0,0,0,0,0,0,0,0,1,1,6,0,0,0,10,21,10,21,0,0,0,15121515.45
MIKE.CAMMALLERI,20162017,N.J,1058.65,10,14,7,21,31,24,17,28,11,142,244,44,52,13,8,954,837,691,726,30,28,0.6071428571428571,30243111.585
MIKE.FISHER,20162017,NSH,1542.1,18,18,8,26,44,36,896,1654,758,152,253,212,45,9,19,1442,1427,1006,994,39,40,0.5417170495767836,30243174.28
MIKE.GREEN,20162017,DET,1696.05,14,14,8,22,36,28,0,0,0,125,282,67,99,15,20,1507,1410,1101,1219,47,53,0,30243158.9
MIKE.HOFFMAN,20162017,OTT,1651.0166666666664,32,29,11,40,72,61,12,23,11,273,501,69,127,12,25,1763,1300,1176,1175,65,42,0.5217391304347826,30243171.275
MIKE.LIAMBAS,20162017,NSH,4.7,0,0,0,0,0,0,0,0,0,0,0,1,0,0,0,3,4,3,4,0,1,0,15121513.2
MIKE.REILLY,20162017,MIN,210.48333333333335,1,0,0,0,1,1,0,0,0,19,47,2,17,2,1,228,185,186,175,9,8,0,30243040.369999997
MIKE.RIBEIRO,20162017,NSH,734.6166666666667,4,10,11,21,25,14,183,444,261,38,73,33,24,2,9,851,611,639,565,26,25,0.41216216216216217,30243094.415
MIKE.VECCHIONE,20162017,PHI,17,0,0,0,0,0,0,8,12,4,1,2,1,1,0,0,17,15,17,14,0,1,0.6666666666666666,30243026.77
MIKHAIL.GRIGORENKO,20162017,COL,1056.6833333333334,10,8,4,12,22,18,NA,NA,NA,NA,NA,NA,NA,2,NA,883,956,671,765,24,42,NA,NA
MIKHAIL.SERGACHEV,20162017,MTL,48.5,0,0,0,0,0,0,0,0,0,2,4,10,1,0,0,40,51,37,49,3,2,0,30243030.5
MIKKEL.BOEDKER,20162017,S.J,1202.6999999999998,11,11,6,17,28,22,5,18,13,125,229,76,51,13,6,1187,1120,941,946,41,37,0.2777777777777778,30243128.630000003
MIKKO.KOIVU,20162017,MIN,1630,19,15,25,40,59,34,1015,1818,803,146,281,37,74,6,17,1547,1472,1074,1059,54,36,0.5583058305830583,30243174.785
MIKKO.RANTANEN,20162017,COL,1353.0500000000002,20,10,8,18,38,30,NA,NA,NA,NA,NA,NA,NA,20,NA,1447,1192,962,1069,43,60,NA,NA
MILAN.LUCIC,20162017,EDM,1628.75,25,22,9,31,56,47,4,7,3,192,357,237,80,16,23,1829,1332,1241,1214,48,45,0.5714285714285714,30243169.945
MILAN.MICHALEK,20162017,TOR,71.35,1,0,1,1,2,1,0,1,1,6,10,7,2,0,1,62,75,53,60,2,4,0,30243032.525
MILES.WOOD,20162017,N.J,771.1500000000001,8,5,3,8,16,13,1,2,1,104,166,68,20,22,24,617,708,464,661,16,28,0.5,30243113.685000002
MIRCO.MUELLER,20162017,S.J,38.36666666666667,1,0,1,1,2,1,0,0,0,3,7,2,4,3,0,35,36,35,36,3,1,0,30243029.055
MITCH.CALLAHAN,20162017,DET,27.25,0,0,0,0,0,0,0,0,0,2,6,3,3,0,0,17,16,17,16,0,0,0,30243026.7
MITCH.MARNER,20162017,TOR,1401.1666666666665,20,26,19,45,65,46,13,37,24,182,342,50,77,18,16,1593,1270,1135,1155,57,50,0.35135135135135137,30243164.375
MORGAN.RIELLY,20162017,TOR,1846.1166666666666,7,17,8,25,32,24,0,1,1,187,385,60,114,13,10,1832,1968,1509,1471,56,75,0,30243171.08
NAIL.YAKUPOV,20162017,STL,425.8833333333333,3,3,3,6,9,6,0,0,0,35,68,32,15,9,7,369,342,354,331,16,16,0,30243059.665
NATE.PROSSER,20162017,MIN,525.8333333333333,2,2,3,5,7,4,0,0,0,24,58,32,15,3,7,440,523,431,487,19,19,0,30243076.905
NATE.SCHMIDT,20162017,WSH,1111.8333333333335,4,7,10,17,21,11,0,0,0,77,183,59,65,5,10,1100,950,1044,860,52,26,0,30243097.55
NATE.THOMPSON,20162017,ANA,506.51666666666665,3,2,3,5,8,5,199,379,180,31,53,110,13,7,7,317,553,292,400,15,4,0.525065963060686,30243079.805
NATHAN.BEAULIEU,20162017,MTL,1529.2333333333333,4,15,10,25,29,19,0,0,0,122,249,73,83,13,14,1501,1404,1247,1220,55,45,0,30243145.58
NATHAN.MACKINNON,20162017,COL,1635.4,16,25,12,37,53,41,NA,NA,NA,NA,NA,NA,NA,21,NA,1709,1497,1108,1089,48,59,NA,NA
NAZEM.KADRI,20162017,TOR,1475.6666666666665,33,16,14,30,63,49,592,1224,632,253,459,143,99,34,43,1712,1342,1231,1207,51,55,0.48366013071895425,30243200.57
NELSON.NOGIER,20162017,WPG,117.13333333333334,0,0,0,0,0,0,0,0,0,8,16,12,6,2,1,102,111,102,111,3,4,0,30243036.270000003
NIC.DOWD,20162017,L.A,871.9000000000001,6,10,6,16,22,16,338,707,369,78,144,144,31,7,14,951,591,747,549,15,24,0.4780763790664781,30243094.89
NIC.PETAN,20162017,WPG,588.6,1,8,4,12,13,9,145,315,170,57,108,12,24,3,5,560,424,365,389,9,19,0.4603174603174603,30243076.73
NICHOLAS.BAPTISTE,20162017,BUF,129.35000000000002,3,0,1,1,4,3,1,3,2,17,21,12,0,0,5,106,120,91,118,5,3,0.3333333333333333,30243041.765
NICK.BJUGSTAD,20162017,FLA,710.1833333333334,7,3,4,7,14,10,186,391,205,91,154,72,32,14,11,687,641,514,605,14,29,0.47570332480818417,30243105.23
NICK.BONINO,20162017,PIT,1686.3333333333335,22,14,8,22,44,36,753,1541,788,175,277,77,53,9,9,1372,1752,1024,1250,39,40,0.48864373783257625,30243213.759999998
NICK.COUSINS,20162017,PHI,720.0666666666666,6,5,5,10,16,11,89,217,128,99,164,61,38,23,16,757,622,653,590,18,22,0.41013824884792627,30243093.365000002
NICK.FOLIGNO,20162017,CBJ,1537.2333333333333,26,14,13,27,53,40,41,90,49,197,293,171,40,38,26,1583,1243,1105,1052,49,49,0.45555555555555555,30243157.744999997
NICK.HOLDEN,20162017,NYR,1861.7166666666667,13,9,16,25,38,22,0,1,1,106,260,204,88,10,18,1566,1818,1346,1487,67,62,0,30243181.4
NICK.JENSEN,20162017,DET,870.0333333333333,4,4,4,8,12,8,0,0,0,59,120,55,39,6,6,716,828,676,664,30,38,0,30243090.16
NICK.LAPPIN,20162017,N.J,504,4,1,2,3,7,5,2,7,5,57,87,36,14,5,7,387,433,353,395,12,29,0.2857142857142857,30243070.880000003
NICK.LEDDY,20162017,NYI,1840.1666666666667,11,16,17,33,44,27,0,0,0,137,288,77,81,7,6,1829,1711,1305,1430,60,60,0,30243179.195
NICK.PAUL,20162017,OTT,16.483333333333334,0,0,0,0,0,0,5,13,8,4,6,3,0,0,0,18,13,17,12,0,1,0.38461538461538464,15121514.25
NICK.RITCHIE,20162017,ANA,1201.4333333333334,18,8,6,14,32,26,5,11,6,175,308,299,58,18,34,1185,1065,1076,1024,39,37,0.45454545454545453,30243142.48
NICK.SCHMALTZ,20162017,CHI,870.4000000000001,6,16,6,22,28,22,92,286,194,68,132,24,42,6,4,790,766,694,722,32,24,0.32167832167832167,30243114.29
NICK.SCHULTZ,20162017,PHI,427.1166666666667,0,2,1,3,3,2,0,0,0,25,63,45,22,0,5,342,459,328,357,15,13,0,30243060.275
NICK.SHORE,20162017,L.A,895.2,6,6,5,11,17,12,362,721,359,79,163,58,43,6,10,777,767,711,610,24,24,0.5020804438280166,30243099.115000002
NICK.SORENSEN,20162017,ANA,54.45,0,0,1,1,1,0,1,1,0,7,9,2,1,0,1,50,48,42,46,1,2,1,15121517.815
NICKLAS.BACKSTROM,20162017,WSH,1766.9333333333334,29,37,33,70,99,66,820,1616,796,188,321,59,61,12,20,1940,1455,1284,1188,64,41,0.5074257425742574,30243207.994999997
NICKLAS.GROSSMANN,20162017,CGY,39.03333333333333,0,0,0,0,0,0,0,0,0,3,7,7,4,0,1,30,38,29,33,0,5,0,15121515.95
NICKLAS.JENSEN,20162017,NYR,64.4,0,0,0,0,0,0,0,0,0,8,18,7,7,0,0,79,41,63,41,0,2,0,30243027.85
NICOLAS.DESLAURIERS,20162017,BUF,311.46666666666664,0,2,0,2,2,2,0,3,3,26,46,109,9,7,9,198,301,194,299,4,10,0,30243062.67
NICOLAS.KERDILES,20162017,ANA,48.61666666666667,0,1,0,1,1,1,1,3,2,1,4,8,1,1,1,40,46,40,42,3,1,0.3333333333333333,30243030.05
NIKITA.KUCHEROV,20162017,T.B,1438.6666666666665,40,28,17,45,85,68,0,0,0,246,464,30,116,20,18,1662,1022,1108,895,56,38,0,30243138.424999997
NIKITA.NESTEROV,20162017,MTL,230.16666666666669,1,3,1,4,5,4,0,0,0,18,52,33,19,2,2,209,195,198,188,8,6,0,30243043.395
NIKITA.NESTEROV,20162017,T.B,580.4499999999999,3,6,3,9,12,9,0,0,0,46,96,56,38,6,10,602,460,515,428,20,22,0,30243064.735
NIKITA.SCHERBAK,20162017,MTL,34.13333333333333,1,0,0,0,1,1,0,0,0,3,8,0,4,0,0,31,38,25,34,1,0,0,30243029.450000003
NIKITA.SOSHNIKOV,20162017,TOR,607.5,5,3,1,4,9,8,2,16,14,69,132,100,27,7,9,509,587,432,478,16,15,0.125,30243079.925
NIKITA.TRYAMKIN,20162017,VAN,1104.8500000000001,2,3,4,7,9,5,0,0,0,65,162,145,56,7,27,873,1085,830,900,28,36,0,30243117.12
NIKITA.ZADOROV,20162017,COL,1066,NA,7,3,10,NA,NA,NA,NA,NA,NA,NA,NA,NA,15,32,847,1058,727,805,21,42,NA,NA
NIKITA.ZAITSEV,20162017,TOR,1892.5166666666667,4,13,17,30,34,17,0,0,0,111,316,190,127,11,18,1894,1917,1459,1521,57,74,0,30243172.685000002
NIKLAS.HJALMARSSON,20162017,CHI,1659.1000000000001,5,7,4,11,16,12,0,0,0,62,139,24,58,10,11,1274,1657,1187,1202,48,51,0,30243143.05
NIKLAS.KRONWALL,20162017,DET,1108.8333333333333,2,5,6,11,13,7,0,0,0,67,137,77,47,3,16,1045,945,760,788,29,34,0,30243104.68
NIKOLAJ.EHLERS,20162017,WPG,1433.8666666666668,25,20,18,38,63,45,0,4,4,204,378,43,81,42,19,1511,1183,1072,1056,61,55,0,30243152.52
NIKOLAY.GOLDOBIN,20162017,S.J,19.65,0,0,0,0,0,0,0,0,0,3,3,1,0,1,0,23,26,23,26,0,1,0,30243028.41
NIKOLAY.GOLDOBIN,20162017,VAN,139.53333333333336,3,0,0,0,3,3,0,0,0,10,24,0,5,0,0,127,148,103,144,5,4,0,30243043.049999997
NIKOLAY.KULEMIN,20162017,NYI,994.85,12,7,4,11,23,19,14,27,13,74,146,78,31,7,9,768,1053,705,774,39,37,0.5185185185185185,30243114.03
NINO.NIEDERREITER,20162017,MIN,1315.7166666666667,25,25,7,32,57,50,0,1,1,192,309,132,66,27,22,1409,909,1074,862,55,39,0,30243127.945
NOAH.HANIFIN,20162017,CAR,1451.5333333333333,4,16,8,24,28,20,0,0,0,108,270,57,107,4,13,1476,1225,1157,1116,44,53,0,30243131.990000002
NOEL.ACCIARI,20162017,BOS,376.98333333333335,3,1,2,3,6,4,19,48,29,27,48,102,13,4,5,279,314,275,300,10,7,0.3958333333333333,30243059.5
OLIVER.BJORKSTRAND,20162017,CBJ,430.4666666666667,6,4,4,8,14,10,1,1,0,65,111,21,32,8,2,449,295,357,281,18,15,1,30243052.619999997
OLIVER.EKMAN-LARSSON,20162017,ARI,1944.6166666666668,12,8,18,26,38,20,0,0,0,145,330,112,106,20,24,1804,1876,1217,1482,53,64,0,30243188.299999997
OLLI.MAATTA,20162017,PIT,1508.8833333333332,3,6,6,12,15,9,0,0,0,101,205,109,70,10,12,1303,1604,1181,1262,60,42,0,30243149.05
ONDREJ.KASE,20162017,ANA,719.4833333333333,7,7,3,10,17,14,2,11,9,89,163,52,43,12,11,693,609,659,595,22,22,0.18181818181818182,30243087.675
ONDREJ.PALAT,20162017,T.B,1433.8,17,17,18,35,52,34,9,34,25,162,276,141,60,31,18,1466,1231,1015,905,45,41,0.2647058823529412,30243129.619999997
OSCAR.KLEFBOM,20162017,EDM,2112.4166666666665,14,17,12,29,43,31,0,1,1,226,459,54,137,5,3,2087,1937,1496,1487,71,66,0,30243174.45
OSCAR.LINDBERG,20162017,NYR,822.7333333333333,11,7,6,13,24,18,346,667,321,103,180,134,42,10,17,717,753,696,724,31,26,0.5187406296851574,30243120.740000002
OSKAR.SUNDQVIST,20162017,PIT,91.73333333333333,0,0,0,0,0,0,16,44,28,9,10,13,1,1,1,72,97,70,89,2,6,0.36363636363636365,30243036.75
P.A..PARENTEAU,20162017,N.J,884.2333333333333,13,7,7,14,27,20,6,19,13,108,151,50,21,10,16,840,689,627,640,25,36,0.3157894736842105,30243105.215
P.A..PARENTEAU,20162017,NSH,147.4,0,1,0,1,1,1,0,2,2,20,27,12,4,2,0,139,153,135,148,3,4,0,30243041.57
P.K..SUBBAN,20162017,NSH,2171.916666666667,12,18,22,40,52,30,0,0,0,181,379,118,123,32,31,2179,1759,1661,1344,62,55,0,30243150.270000003
PATRIC.HORNQVIST,20162017,PIT,1387.9,26,17,10,27,53,43,6,15,9,267,390,280,61,21,20,1598,1136,1083,1023,54,35,0.4,30243152.799999997
PATRICE.BERGERON,20162017,BOS,1670.65,23,22,12,34,57,45,1170,1963,793,319,514,69,95,6,12,2018,1253,1300,839,49,39,0.5960264900662252,30243139.61
PATRICK.BROWN,20162017,CAR,136,0,0,0,0,0,0,9,15,6,12,22,30,4,0,0,98,123,97,123,1,7,0.6,30243039.16
PATRICK.CANNONE,20162017,MIN,23.65,0,0,0,0,0,0,11,21,10,2,3,2,1,0,0,14,26,14,26,1,1,0.5238095238095238,30243028.89
PATRICK.EAVES,20162017,ANA,432.2,13,3,2,5,18,16,0,1,1,74,125,47,24,6,7,516,387,373,356,21,10,0,30243069.259999998
PATRICK.EAVES,20162017,DAL,982.2666666666667,20,6,10,16,36,26,2,4,2,153,268,60,49,17,8,1203,831,766,727,26,30,0.5,30243112.15
PATRICK.KANE,20162017,CHI,1850.0666666666666,35,36,20,56,91,71,8,53,45,314,524,30,114,21,17,2054,1484,1414,1318,65,58,0.1509433962264151,30243192.08
PATRICK.MARLEAU,20162017,S.J,1502.05,30,7,13,20,50,37,118,231,113,200,347,99,59,12,14,1759,1244,1161,1097,51,36,0.5108225108225108,30243158.015
PATRICK.MAROON,20162017,EDM,1581.3833333333332,30,10,10,20,50,40,6,15,9,211,357,223,70,32,44,1761,1319,1367,1234,70,50,0.4,30243166.36
PATRICK.SHARP,20162017,DAL,765.2833333333333,8,4,6,10,18,12,29,61,32,146,261,24,67,10,14,838,660,607,588,17,32,0.47540983606557374,30243089.810000002
PATRICK.WIERCIOCH,20162017,COL,949.9000000000001,NA,3,4,7,NA,NA,NA,NA,NA,NA,NA,NA,NA,6,NA,772,890,653,752,18,36,NA,NA
PATRIK.BERGLUND,20162017,STL,1495.6833333333334,23,11,4,15,38,34,667,1350,683,167,303,177,56,14,21,1315,1276,1043,1036,37,50,0.49407407407407405,30243176.369999997
PATRIK.LAINE,20162017,WPG,1307.6166666666668,36,13,14,27,63,49,0,3,3,204,359,80,75,11,13,1310,1077,872,959,60,51,0,30243151.310000002
PATRIK.NEMETH,20162017,DAL,631.1500000000001,0,2,0,2,2,2,0,0,0,46,91,45,30,4,7,566,644,549,556,18,21,0,30243078.740000002
PAUL.BYRON,20162017,MTL,1321.2166666666667,23,15,6,21,44,38,10,16,6,104,171,145,37,23,12,1189,1235,1042,894,49,31,0.625,30243126.83
PAUL.CAREY,20162017,WSH,68.55,0,0,0,0,0,0,0,0,0,8,17,6,6,0,0,66,57,62,56,0,2,0,30243030.3
PAUL.LADUE,20162017,L.A,338.91666666666663,0,2,6,8,8,2,0,0,0,27,55,17,21,2,2,361,243,302,226,10,11,0,30243042.869999997
PAUL.MARTIN,20162017,S.J,1653.2,5,5,16,21,26,10,0,0,0,62,137,52,53,2,12,1600,1726,1507,1414,58,52,0,30243157.97
PAUL.POSTMA,20162017,WPG,705.5333333333333,1,7,6,13,14,8,0,0,0,50,119,36,51,0,6,631,677,624,665,27,24,0,30243090.75
PAUL.STASTNY,20162017,STL,1413.0166666666667,20,17,6,23,43,37,864,1569,705,125,195,57,31,7,18,1335,1192,906,887,44,28,0.5506692160611855,30243161.43
PAUL.THOMPSON,20162017,FLA,165.89999999999998,0,1,2,3,3,1,0,1,1,19,30,48,5,4,8,127,189,126,188,4,8,0,30243048.990000002
PAVEL.BUCHNEVICH,20162017,NYR,605.0333333333333,8,6,7,13,21,14,1,7,6,65,127,22,32,8,5,619,512,467,480,28,20,0.14285714285714285,30243078.945
PAVEL.ZACHA,20162017,N.J,1001.55,8,11,5,16,24,19,183,455,272,81,125,54,17,16,6,816,798,622,682,15,28,0.4021978021978022,30243120.805
PETER.CEHLARIK,20162017,BOS,153.05,0,1,1,2,2,1,2,3,1,8,15,7,1,1,0,148,124,124,118,6,6,0.6666666666666666,30243037.015
PETER.HOLLAND,20162017,ARI,526.25,5,3,3,6,11,8,202,446,244,66,109,34,16,6,9,484,532,407,497,15,24,0.452914798206278,30243095.314999998
PETER.HOLLAND,20162017,TOR,85.75,0,0,1,1,1,0,26,56,30,13,18,3,3,1,2,72,87,67,72,1,3,0.4642857142857143,30243034.625
PETTER.GRANBERG,20162017,NSH,96.26666666666668,0,0,0,0,0,0,0,0,0,4,6,17,1,1,5,77,95,77,89,5,5,0,30243035.060000002
PETTERI.LINDBOHM,20162017,STL,90.88333333333333,0,0,0,0,0,0,0,0,0,10,19,10,7,1,2,96,91,95,87,2,6,0,30243033.259999998
PHIL.KESSEL,20162017,PIT,1909.5500000000002,31,35,26,61,92,66,5,20,15,296,558,20,163,13,12,2114,1652,1325,1447,70,46,0.25,30243201.68
PHIL.VARONE,20162017,OTT,55.65,0,0,0,0,0,0,14,26,12,1,5,3,1,1,1,41,56,35,54,0,3,0.5384615384615384,30243032.37
PHILIP.LARSEN,20162017,VAN,427.9166666666667,1,4,1,5,6,5,0,0,0,32,87,12,38,0,2,416,366,302,332,10,14,0,30243057.875
PHILLIP.DANAULT,20162017,MTL,1377.5833333333335,13,17,11,28,41,30,589,1127,538,142,245,95,54,8,17,1451,1227,1294,1017,47,38,0.5226264418811003,30243148.215
PHILLIP.DI GIUSEPPE,20162017,CAR,442.65,1,3,3,6,7,4,0,2,2,68,113,91,20,1,6,470,373,423,355,8,21,0,30243060.385
PIERRE-EDOUARD.BELLEMARE,20162017,PHI,1063.5666666666666,4,3,1,4,8,7,401,829,428,90,172,73,43,9,7,708,1153,651,697,19,21,0.4837153196622437,30243115.755000003
PONTUS.ABERG,20162017,NSH,391.66666666666663,3,3,1,4,7,6,1,1,0,35,71,22,22,5,2,361,315,349,311,11,14,1,30243055.665
QUINTON.HOWDEN,20162017,WPG,43.28333333333333,0,0,0,0,0,0,0,2,2,5,6,4,1,0,0,37,34,35,34,1,0,0,30243028.9
RADEK.FAKSA,20162017,DAL,1293.8,12,13,8,21,33,25,590,1221,631,132,248,101,45,24,24,1183,1326,1036,965,39,46,0.4832104832104832,30243158.09
RADIM.VRBATA,20162017,ARI,1368.6833333333334,20,24,11,35,55,44,17,47,30,233,409,48,96,6,8,1394,1231,936,1086,40,51,0.3617021276595745,30243163.465000004
RADKO.GUDAS,20162017,PHI,1292.5833333333335,6,10,7,17,23,16,0,0,0,113,299,280,118,23,35,1220,1218,1164,997,49,43,0,30243113.155
RASMUS.ANDERSSON,20162017,CGY,18.55,0,0,0,0,0,0,0,0,0,0,1,4,1,0,0,15,15,15,15,0,1,0,15121514.1
RASMUS.RISTOLAINEN,20162017,BUF,2090.9666666666667,6,17,22,39,45,23,0,0,0,186,359,195,112,12,18,1901,2295,1277,1638,51,61,0,30243210.22
REID.BOUCHER,20162017,N.J,110.28333333333333,0,2,0,2,2,2,0,0,0,11,26,11,11,1,1,83,102,63,91,3,3,0,30243035.71
REID.BOUCHER,20162017,NSH,26.116666666666667,1,0,0,0,1,1,0,0,0,3,3,1,0,1,0,24,19,24,19,1,0,0,15121515.11
REID.BOUCHER,20162017,VAN,328.75,5,1,1,2,7,6,0,1,1,55,83,8,11,4,2,346,281,251,267,7,13,0,30243057.565
REILLY.SMITH,20162017,FLA,1468.2666666666667,15,9,13,22,37,24,3,6,3,160,287,75,75,9,8,1453,1227,1024,922,33,42,0.5,30243122.235
REMI.ELIE,20162017,DAL,281.25,1,2,4,6,7,3,1,1,0,15,40,30,17,0,4,231,283,223,241,9,6,1,30243050.04
RENE.BOURQUE,20162017,COL,906.3666666666667,12,3,3,6,18,15,0,5,5,112,194,75,37,9,20,857,795,678,745,25,44,0,30243113.265
RICHARD.PANIK,20162017,CHI,1271.2166666666667,22,12,11,23,45,34,2,7,5,161,282,162,68,19,21,1255,1102,996,1017,51,41,0.2857142857142857,30243144.845
RICK.NASH,20162017,NYR,1324.0333333333333,26,15,2,17,43,41,0,1,1,238,394,80,73,22,15,1252,1338,918,1040,44,41,0,30243159.07
RICKARD.RAKELL,20162017,ANA,1520.1999999999998,40,18,6,24,64,58,63,151,88,225,411,112,80,10,6,1620,1234,1200,1141,67,41,0.41721854304635764,30243168.97
RILEY.BARBER,20162017,WSH,25.733333333333334,0,0,0,0,0,0,0,0,0,2,3,1,1,0,0,17,27,17,27,0,0,0,30243028.65
RILEY.NASH,20162017,BOS,1222.8166666666666,7,9,3,12,19,16,304,612,308,134,227,73,44,14,8,959,1139,874,823,20,28,0.49673202614379086,30243126.125
RILEY.SHEAHAN,20162017,DET,1117.7333333333333,2,5,6,11,13,7,236,466,230,109,197,81,38,4,6,909,1022,748,867,22,44,0.5064377682403434,30243129.28
ROB.O'GARA,20162017,BOS,48.03333333333333,0,0,0,0,0,0,0,0,0,2,3,3,0,0,0,33,56,31,41,1,0,0,15121517.3
ROBBIE.RUSSO,20162017,DET,305.31666666666666,0,0,0,0,0,0,0,0,0,18,40,24,9,2,2,264,265,246,223,8,6,0,30243045.32
ROBBY.FABBRI,20162017,STL,796.0666666666666,11,12,6,18,29,23,13,24,11,91,160,64,34,14,14,787,605,592,548,25,30,0.5416666666666666,30243091.21
ROBERT.BORTUZZO,20162017,STL,650.45,1,2,1,3,4,3,0,0,0,50,105,94,26,4,8,532,571,516,502,23,13,0,30243073.265
ROBERT.HAGG,20162017,PHI,21.316666666666666,0,0,0,0,0,0,0,0,0,5,9,4,3,0,0,23,17,22,16,1,1,0,15121513.7
ROCCO.GRIMALDI,20162017,COL,44,0,1,0,1,1,1,0,0,0,11,18,1,5,3,1,42,53,40,53,1,4,0,30243031.83
ROMAN.JOSI,20162017,NSH,2372.133333333333,18,22,22,44,62,40,0,0,0,294,569,78,176,17,14,2462,2198,1810,1674,78,70,0,30243191.32
ROMAN.LYUBIMOV,20162017,PHI,450.18333333333334,4,1,1,2,6,5,1,7,6,41,84,28,17,5,4,381,414,372,371,12,14,0.14285714285714285,30243064.615000002
ROMAN.POLAK,20162017,TOR,1378.6999999999998,4,2,4,6,10,6,0,1,1,64,166,241,65,7,24,1117,1611,1059,1159,42,33,0,30243141.47
RON.HAINSEY,20162017,CAR,1250.2166666666667,4,7,2,9,13,11,0,0,0,62,150,79,57,7,7,1082,1245,966,947,27,49,0,30243117.67
RON.HAINSEY,20162017,PIT,863.8166666666667,2,3,5,8,10,5,0,0,0,38,86,51,38,2,5,643,945,602,726,30,22,0,30243100.195
RYAN.CALLAHAN,20162017,T.B,254.56666666666666,2,1,1,2,4,3,5,9,4,22,42,48,9,6,6,195,296,179,212,5,9,0.5555555555555556,30243050.485
RYAN.CARPENTER,20162017,S.J,102,2,1,0,1,3,3,33,70,37,18,21,14,1,1,2,100,92,96,78,5,1,0.4714285714285714,30243036.18
RYAN.DZINGEL,20162017,OTT,1347.5166666666667,16,14,5,19,35,30,11,35,24,130,223,97,51,22,14,1324,1220,1118,1150,47,43,0.3142857142857143,30243156.585
RYAN.ELLIS,20162017,NSH,2216.3166666666666,21,18,11,29,50,39,0,0,0,187,383,93,123,31,15,2118,2236,1626,1671,73,65,0,30243202.785
RYAN.GARBUTT,20162017,ANA,247.28333333333333,2,0,1,1,3,2,7,11,4,26,57,53,14,4,10,183,269,172,214,6,10,0.6363636363636364,30243050.445
RYAN.GETZLAF,20162017,ANA,1970.0833333333335,23,48,20,68,91,71,652,1281,629,191,394,140,100,18,23,2086,1741,1355,1297,67,51,0.5089773614363778,30243209.36
RYAN.HARTMAN,20162017,CHI,1016.5333333333333,19,8,4,12,31,27,27,65,38,175,272,127,48,29,27,997,884,934,833,38,30,0.4153846153846154,30243123.57
RYAN.JOHANSEN,20162017,NSH,1835.2333333333333,17,33,24,57,74,50,968,1775,807,169,300,100,62,14,31,2139,1440,1516,1175,66,47,0.5453521126760563,30243182.51
RYAN.JOHNSTON,20162017,MTL,69.08333333333333,0,0,0,0,0,0,0,0,0,3,8,1,4,0,2,62,69,62,69,0,3,0,30243032.6
RYAN.KESLER,20162017,ANA,2109.9333333333334,23,25,16,41,64,48,1236,2171,935,230,432,177,89,27,44,2181,2086,1427,1384,58,54,0.5693228926761861,30243223.509999998
RYAN.MCDONAGH,20162017,NYR,2203.6,8,24,15,39,47,32,0,0,0,179,394,118,134,20,22,2160,2173,1450,1652,58,51,0,30243204.375
RYAN.MURPHY,20162017,CAR,355.6333333333333,0,1,1,2,2,1,0,0,0,17,41,2,17,4,4,307,320,292,310,5,14,0,30243056.215
RYAN.MURRAY,20162017,CBJ,1099.9833333333333,2,5,4,9,11,7,0,0,0,52,110,23,39,0,12,848,1128,764,888,34,35,0,30243118.4
RYAN.NUGENT-HOPKINS,20162017,EDM,1690.0833333333333,18,16,12,28,46,34,642,1460,818,233,392,65,98,11,13,1672,1677,1161,1183,36,47,0.4397260273972603,30243195.29
RYAN.O'REILLY,20162017,BUF,1545,20,21,14,35,55,41,1038,1790,752,189,297,21,52,24,4,1543,1497,996,1021,38,38,0.5798882681564246,30243179.46
RYAN.PULOCK,20162017,NYI,3.95,0,0,0,0,0,0,0,0,0,0,1,1,1,0,0,3,5,1,5,1,0,0,15121513.15
RYAN.REAVES,20162017,STL,816.1166666666667,7,5,1,6,13,12,0,5,5,66,116,281,24,26,30,608,716,607,711,27,23,0,30243110.185000002
RYAN.SPOONER,20162017,BOS,1151.65,11,14,16,30,41,25,85,217,132,145,223,30,43,5,7,1346,860,864,752,32,31,0.391705069124424,30243114.549999997
RYAN.SPROUL,20162017,DET,408.98333333333335,1,4,2,6,7,5,0,0,0,46,81,12,14,2,3,349,340,258,310,11,14,0,30243061.17
RYAN.STROME,20162017,NYI,1007.9333333333334,13,10,7,17,30,23,147,344,197,114,203,59,47,8,17,1036,880,673,809,27,32,0.4273255813953488,30243133.935000002
RYAN.SUTER,20162017,MIN,2353.3166666666666,10,10,22,32,42,20,0,0,0,179,364,78,118,5,23,2266,2142,1708,1634,85,60,0,30243181.35
RYAN.WHITE,20162017,ARI,503.73333333333335,7,4,2,6,13,11,35,81,46,43,71,138,17,8,17,394,545,385,512,17,24,0.43209876543209874,30243091.93
RYAN.WHITE,20162017,MIN,210.25,2,0,1,1,3,2,5,12,7,19,38,61,7,4,6,195,167,194,167,4,12,0.4166666666666667,30243042.865000002
SAM.BENNETT,20162017,CGY,1268.6333333333334,15,7,6,13,28,22,391,857,466,132,226,140,46,25,35,1057,1105,860,907,28,45,0.456242707117853,30243153.74
SAM.GAGNER,20162017,CBJ,1174.1999999999998,18,23,11,34,52,41,217,466,249,191,324,31,69,13,11,1368,873,915,778,40,30,0.4656652360515021,30243127.785
SAM.REINHART,20162017,BUF,1360.15,17,23,7,30,47,40,86,210,124,178,280,21,47,13,4,1505,1136,989,1031,39,43,0.4095238095238095,30243157.845
SAMI.VATANEN,20162017,ANA,1803.7166666666667,4,11,13,24,28,15,0,0,0,139,294,97,94,19,16,1777,1755,1190,1275,44,44,0,30243155.915
SAMUEL.HENLEY,20162017,COL,5.3,1,0,0,0,1,1,0,1,1,1,1,2,0,0,1,4,6,4,6,1,0,0,15121514.25
SAMUEL.MORIN,20162017,PHI,17.78333333333333,0,0,0,0,0,0,0,0,0,2,4,7,1,0,0,14,8,14,6,0,0,0,15121512.9
SCOTT.HARRINGTON,20162017,CBJ,323.3666666666667,1,0,2,2,3,1,0,0,0,18,41,28,13,2,5,264,309,261,283,13,10,0,30243053.52
SCOTT.HARTNELL,20162017,CBJ,983.4333333333334,13,15,9,24,37,28,3,6,3,108,179,102,37,20,23,981,776,822,746,42,30,0.5,30243111.645
SCOTT.LAUGHTON,20162017,PHI,20.483333333333334,0,0,0,0,0,0,11,20,9,4,5,3,1,0,0,25,10,23,10,2,2,0.55,30243025.939999998
SCOTT.MAYFIELD,20162017,NYI,353.5,2,3,4,7,9,5,0,0,0,39,80,37,25,6,9,358,338,352,336,19,21,0,30243058.41
SCOTT.WILSON,20162017,PIT,1093.0833333333335,11,12,9,21,32,23,5,8,3,155,269,233,54,26,15,1022,1040,966,1021,43,41,0.625,30243141.134999998
SCOTTIE.UPSHALL,20162017,STL,929.1833333333334,9,6,2,8,17,15,4,13,9,95,157,129,34,15,24,582,951,556,712,22,29,0.3076923076923077,30243114.759999998
SEAN.COUTURIER,20162017,PHI,1217.4166666666667,14,10,10,20,34,24,587,1066,479,120,195,41,33,10,15,1202,1023,957,793,44,37,0.550656660412758,30243127.53
SEAN.KURALY,20162017,BOS,123.25,2,0,1,1,3,2,9,29,20,21,32,18,6,4,3,115,89,109,88,3,4,0.3103448275862069,30243035.825
SEAN.MALONE,20162017,BUF,12.2,0,0,0,0,0,0,5,8,3,1,2,0,1,0,0,10,6,10,5,0,0,0.625,15121513
SEAN.MONAHAN,20162017,CGY,1515.3,31,16,16,32,63,47,780,1522,742,208,368,37,86,11,10,1645,1242,1081,1054,45,44,0.5124835742444153,30243182.91
SEBASTIAN.AHO,20162017,CAR,1376.5166666666669,24,12,11,23,47,36,17,35,18,214,362,51,76,21,12,1476,1037,1045,917,41,42,0.4857142857142857,30243130.915
SERGEY.KALININ,20162017,N.J,550.1333333333333,2,2,0,2,4,4,72,173,101,38,56,53,8,6,6,342,544,305,384,3,18,0.4161849710982659,30243075.89
SERGEY.TOLCHINSKY,20162017,CAR,22.95,0,1,0,1,1,1,0,0,0,2,3,0,1,0,0,29,28,29,28,1,1,0,30243028.6
SETH.GRIFFITH,20162017,FLA,277.2166666666667,0,4,1,5,5,4,2,8,6,18,40,27,7,4,4,285,215,222,197,10,4,0.25,30243045.495
SETH.GRIFFITH,20162017,TOR,28.4,0,0,0,0,0,0,0,0,0,3,10,3,3,0,0,38,20,34,20,0,0,0,30243026.5
SETH.HELGESON,20162017,N.J,121.21666666666667,1,0,0,0,1,1,0,0,0,3,11,16,3,3,3,89,111,88,99,4,2,0,30243036.23
SETH.JONES,20162017,CBJ,1885.5666666666666,12,14,17,31,43,26,0,0,0,164,326,70,94,11,11,1771,1714,1441,1304,58,58,0,30243153.585
SHANE.DOAN,20162017,ARI,1113.5500000000002,6,17,4,21,27,23,94,199,105,144,238,101,47,10,19,1060,1036,864,972,30,27,0.4723618090452261,30243144.86
SHANE.HARPER,20162017,FLA,144.2,2,1,0,1,3,3,0,0,0,13,23,19,5,5,5,113,116,112,115,3,4,0,30243039.35
SHANE.PRINCE,20162017,NYI,648.5333333333333,5,7,6,13,18,12,4,7,3,71,124,36,35,16,9,613,648,491,605,20,27,0.5714285714285714,30243096.42
SHAWN.MATTHIAS,20162017,WPG,610.2,8,3,1,4,12,11,5,16,11,51,86,47,13,5,5,482,620,463,485,20,20,0.3125,30243081.325
SHAWN.THORNTON,20162017,FLA,384.48333333333335,2,0,2,2,4,2,5,15,10,42,81,52,19,12,18,265,387,253,385,6,13,0.3333333333333333,30243073.770000003
SHAYNE.GOSTISBEHERE,20162017,PHI,1488.1166666666668,7,17,15,32,39,24,0,0,0,198,445,43,142,16,15,1894,1140,1128,1006,28,47,0,30243122.185000002
SHEA.THEODORE,20162017,ANA,832.5833333333333,4,7,4,11,15,11,0,0,0,84,177,19,51,5,15,870,739,626,645,27,29,0,30243092.7
SHEA.WEBER,20162017,MTL,2122.6499999999996,18,10,17,27,45,28,0,0,0,198,463,156,158,8,20,1990,1940,1436,1358,49,32,0,30243158.705
SIDNEY.CROSBY,20162017,PIT,1956.2166666666667,52,40,23,63,115,92,1118,2309,1191,318,521,107,110,26,17,2357,1692,1597,1430,80,62,0.4841922910350801,30243258.855
SIMON.DESPRES,20162017,ANA,16.133333333333333,0,0,0,0,0,0,0,0,0,1,2,1,0,0,0,11,14,5,12,0,0,0,15121514.35
SLATER.KOEKKOEK,20162017,T.B,376.5333333333333,0,2,2,4,4,2,0,0,0,27,68,25,28,4,4,307,350,301,334,12,16,0,30243057.79
SONNY.MILANO,20162017,CBJ,53.516666666666666,0,0,0,0,0,0,0,0,0,2,6,3,2,0,0,45,47,41,46,1,4,0,30243030
SPENCER.ABBOTT,20162017,CHI,8.566666666666666,0,0,0,0,0,0,0,0,0,1,2,0,1,0,0,12,7,12,7,0,0,0,15121513.1
STEFAN.NOESEN,20162017,ANA,78.61666666666667,2,0,0,0,2,2,21,55,34,12,15,10,1,0,0,53,53,47,50,3,1,0.38181818181818183,30243033.54
STEFAN.NOESEN,20162017,N.J,410.9,6,1,1,2,8,7,5,12,7,51,77,40,8,4,7,331,355,320,320,13,9,0.4166666666666667,30243063.115000002
STEPHEN.GIONTA,20162017,NYI,291.3833333333333,1,5,0,5,6,6,55,119,64,17,28,56,8,5,1,198,289,189,232,14,7,0.46218487394957986,30243054.700000003
STEPHEN.JOHNS,20162017,DAL,1113.5833333333333,4,2,4,6,10,6,0,0,0,91,200,159,62,9,15,998,1124,924,880,33,41,0,30243108.14
STEVE.OLEKSY,20162017,PIT,150.66666666666666,0,0,1,1,1,0,0,0,0,11,27,20,9,4,9,148,147,142,129,6,4,0,30243037.515
STEVE.OTT,20162017,DET,439.3,3,2,1,3,6,5,102,176,74,33,58,101,14,16,21,280,476,262,316,5,13,0.5795454545454546,30243067.865000002
STEVE.OTT,20162017,MTL,205.41666666666669,0,0,1,1,1,0,71,145,74,15,23,68,7,2,3,154,208,145,176,2,4,0.4896551724137931,30243047.585
STEVEN.KAMPFER,20162017,FLA,16.799999999999997,0,0,0,0,0,0,0,0,0,0,2,1,1,0,2,20,10,19,8,0,1,0,15121513.15
STEVEN.KAMPFER,20162017,NYR,129.03333333333333,1,1,0,1,2,2,0,0,0,10,21,22,7,4,1,115,111,111,111,4,5,0,30243036.89
STEVEN.SANTINI,20162017,N.J,611.1666666666667,2,2,3,5,7,4,0,0,0,46,75,83,13,2,7,440,581,423,480,15,21,0,30243078.244999997
STEVEN.STAMKOS,20162017,T.B,303.9,9,9,2,11,20,18,106,198,92,58,100,21,24,4,7,357,224,233,181,14,10,0.5353535353535354,30243054.23
SVEN.ANDRIGHETTO,20162017,COL,332.4666666666667,5,5,6,11,16,10,7,10,3,37,63,13,21,2,4,333,281,251,259,14,12,0.7,30243055.8
SVEN.ANDRIGHETTO,20162017,MTL,310.0333333333333,2,4,2,6,8,6,0,0,0,31,67,27,18,4,2,283,251,276,248,8,7,0,30243050.64
SVEN.BAERTSCHI,20162017,VAN,1079.55,18,8,9,17,35,26,1,1,0,114,185,52,36,12,5,974,955,739,861,39,37,1,30243130.685
T.J..OSHIE,20162017,WSH,1485.7166666666667,37,20,11,31,68,57,110,233,123,170,305,142,45,25,20,1641,1217,1096,983,62,33,0.4721030042918455,30243156.625
TANNER.GLASS,20162017,NYR,189.13333333333333,2,0,4,4,6,2,2,2,0,13,29,69,5,8,6,160,169,160,160,6,5,1,30243043.16
TANNER.KERO,20162017,CHI,688.3833333333333,6,6,4,10,16,12,232,510,278,64,110,49,25,11,4,567,762,539,584,25,18,0.4549019607843137,30243101.939999998
TANNER.PEARSON,20162017,L.A,1305.6,24,14,6,20,44,38,10,24,14,187,364,124,90,21,5,1536,1004,1068,812,37,36,0.4166666666666667,30243110.71
TANNER.RICHARD,20162017,T.B,38.11666666666667,0,0,0,0,0,0,13,30,17,1,3,6,1,0,1,30,25,28,24,0,2,0.43333333333333335,30243028.47
TAYLOR.BECK,20162017,EDM,17.65,0,0,0,0,0,0,0,0,0,0,1,3,1,0,1,9,17,9,17,0,1,0,30243027.6
TAYLOR.BECK,20162017,NYR,26.4,0,0,0,0,0,0,0,1,1,5,10,2,5,0,0,24,27,22,27,0,2,0,30243028
TAYLOR.CHORNEY,20162017,WSH,256.75,1,1,3,4,5,2,0,0,0,19,34,27,6,1,4,216,267,204,245,12,5,0,30243052.384999998
TAYLOR.FEDUN,20162017,BUF,360.81666666666666,0,2,4,6,6,2,0,0,0,24,45,7,13,0,7,357,277,302,264,12,8,0,30243049.9
TAYLOR.HALL,20162017,N.J,1391.8333333333335,20,22,11,33,53,42,8,18,10,238,392,59,90,24,14,1446,1083,1028,923,38,35,0.4444444444444444,30243134.935000002
TAYLOR.LEIER,20162017,PHI,90.6,1,0,1,1,2,1,0,1,1,7,14,7,4,2,2,62,78,61,73,2,3,0,30243033.994999997
TEDDY.PURCELL,20162017,L.A,154.7,0,1,1,2,2,1,3,3,0,10,20,7,7,0,0,130,142,107,136,4,3,1,30243039.994999997
TEEMU.PULKKINEN,20162017,ARI,39.03333333333333,1,0,0,0,1,1,0,1,1,6,8,2,1,1,1,35,41,33,40,1,2,0,30243030.759999998
TEEMU.PULKKINEN,20162017,MIN,84.48333333333333,1,0,0,0,1,1,0,0,0,4,12,2,4,1,1,73,73,59,71,5,6,0,30243032.91
TEUVO.TERAVAINEN,20162017,CAR,1315.3833333333332,15,12,14,26,41,27,192,412,220,169,298,27,61,10,8,1448,927,1025,830,37,40,0.46601941747572817,30243121.03
THOMAS.CHABOT,20162017,OTT,7.15,0,0,0,0,0,0,0,0,0,1,2,1,0,0,0,8,12,8,12,0,2,0,15121514.2
THOMAS.HICKEY,20162017,NYI,1331.4166666666665,4,5,11,16,20,9,0,0,0,87,199,89,69,20,15,1219,1467,1067,1150,48,57,0,30243140.275
THOMAS.VANEK,20162017,DET,701.6000000000001,15,14,9,23,38,29,6,15,9,99,162,23,33,6,8,709,551,480,496,31,22,0.4,30243091.775
THOMAS.VANEK,20162017,FLA,277.8833333333333,2,7,1,8,10,9,0,0,0,34,54,6,11,2,3,274,257,186,243,9,14,0,30243057.145
TIM.HEED,20162017,S.J,16.483333333333334,0,0,0,0,0,0,0,0,0,1,4,0,3,0,0,15,11,14,9,0,0,0,15121513
TIM.SCHALLER,20162017,BOS,804.8166666666666,8,6,0,6,14,14,31,64,33,96,171,85,31,9,11,713,747,644,653,20,25,0.484375,30243100.380000003
TIMO.MEIER,20162017,S.J,484.4,3,2,1,3,6,5,1,6,5,96,175,81,45,8,4,511,405,488,373,12,11,0.16666666666666666,30243057.495
TJ.BRODIE,20162017,CGY,2022.9666666666667,6,15,19,34,40,21,0,0,0,88,228,34,82,15,14,1834,1656,1274,1271,43,57,0,30243154.225
TJ.TYNAN,20162017,CBJ,22.450000000000003,0,0,0,0,0,0,0,0,0,3,7,1,2,0,0,22,21,22,21,0,1,0,30243027.4
TOBIAS.ENSTROM,20162017,WPG,1314.2666666666667,1,7,6,13,14,8,0,0,0,46,111,24,45,11,21,1020,1262,822,846,38,51,0,30243109.41
TOBIAS.RIEDER,20162017,ARI,1385.05,16,8,10,18,34,24,4,13,9,155,276,24,52,14,3,1196,1528,901,1094,29,40,0.3076923076923077,30243157.5
TOM.GILBERT,20162017,L.A,278.2166666666667,1,3,0,3,4,4,0,0,0,12,30,10,9,1,3,260,226,208,192,3,6,0,30243045.51
TOM.KUHNHACKL,20162017,PIT,734.7333333333333,5,7,6,13,18,12,2,4,2,60,117,150,28,12,11,497,824,467,570,21,16,0.5,30243092.950000003
TOM.PYATT,20162017,OTT,1467,11,9,5,14,25,20,24,61,37,105,185,63,37,16,8,1038,1653,936,1209,34,37,0.39344262295081966,30243170.645
TOM.SESTITO,20162017,PIT,71.91666666666666,0,1,1,2,2,1,0,0,0,3,6,19,3,5,9,38,61,38,61,3,3,0,30243034.025
TOM.WILSON,20162017,WSH,1240.0333333333333,10,4,8,12,22,14,3,10,7,114,196,288,52,49,56,949,1159,896,836,36,29,0.3,30243117.61
TOMAS.HERTL,20162017,S.J,959.7333333333333,10,9,5,14,24,19,297,557,260,115,216,89,52,6,8,1039,864,779,636,21,30,0.533213644524237,30243100.365000002
TOMAS.JURCO,20162017,CHI,147.86666666666667,1,0,0,0,1,1,0,0,0,23,34,15,8,0,2,151,120,149,117,2,4,0,30243036.25
TOMAS.JURCO,20162017,DET,160.53333333333333,0,0,0,0,0,0,0,1,1,12,32,6,7,1,2,130,149,115,145,0,8,0,30243041.41
TOMAS.NOSEK,20162017,DET,111.36666666666667,1,0,0,0,1,1,37,68,31,19,24,10,2,1,1,96,117,95,110,2,3,0.5441176470588235,30243039.64
TOMAS.PLEKANEC,20162017,MTL,1423.0166666666667,11,9,11,20,31,20,765,1482,717,153,260,65,61,13,12,1341,1358,1109,996,37,33,0.5161943319838057,30243156.005
TOMAS.TATAR,20162017,DET,1416.7333333333333,25,12,8,20,45,37,8,13,5,166,321,92,79,16,13,1339,1048,968,943,53,49,0.6153846153846154,30243134.03
TOMMY.CROSS,20162017,BOS,13.133333333333333,0,0,1,1,1,0,0,0,0,0,0,0,0,0,0,7,15,6,11,2,1,0,15121513.875
TOMMY.WINGELS,20162017,OTT,483.5333333333333,2,1,1,2,4,3,60,129,69,52,75,92,10,10,7,376,473,369,408,8,17,0.46511627906976744,30243074.175
TOMMY.WINGELS,20162017,S.J,360.2833333333333,5,3,0,3,8,8,59,147,88,41,58,61,7,7,6,289,350,284,303,11,13,0.4013605442176871,30243066.03
TOREY.KRUG,20162017,BOS,1748.4333333333334,8,25,15,40,48,33,0,1,1,208,462,59,165,22,14,2124,1249,1443,1069,44,49,0,30243115.595
TORREY.MITCHELL,20162017,MTL,1017.8333333333334,9,4,5,9,18,13,417,771,354,71,129,51,27,16,16,746,1006,691,736,25,22,0.5408560311284046,30243122.064999998
TRAVIS.HAMONIC,20162017,NYI,1002.3166666666666,3,5,4,9,12,8,0,0,0,74,157,58,48,11,16,768,1166,695,884,28,44,0,30243123.310000002
TRAVIS.KONECNY,20162017,PHI,986.3333333333333,11,10,7,17,28,21,0,5,5,132,233,92,51,25,17,1008,882,852,837,37,39,0,30243118.625
TRAVIS.ZAJAC,20162017,N.J,1578.0333333333333,14,21,10,31,45,35,884,1617,733,126,195,81,34,11,16,1413,1394,971,951,45,39,0.546691403834261,30243166.47
TREVOR.DALEY,20162017,PIT,1542.5833333333335,6,9,9,18,24,15,0,0,0,110,203,44,52,14,25,1357,1636,1080,1256,61,52,0,30243162.165
TREVOR.LEWIS,20162017,L.A,1170.4,12,8,4,12,24,20,44,110,66,144,246,174,38,11,15,1041,958,990,778,33,36,0.4,30243107.57
TREVOR.SMITH,20162017,NSH,7.333333333333333,0,0,0,0,0,0,0,8,8,0,0,0,0,0,0,0,11,0,11,0,0,0,15121514.8
TREVOR.VAN RIEMSDYK,20162017,CHI,1143.85,5,5,6,11,16,10,0,0,0,82,177,24,63,3,9,1046,1057,961,931,51,37,0,30243112.18
TROY.BROUWER,20162017,CGY,1256.7333333333333,13,6,8,14,27,19,32,89,57,98,168,179,27,13,14,1129,1194,734,907,26,31,0.3595505617977528,30243139.56
TROY.STECHER,20162017,VAN,1418.5,3,9,11,20,23,12,0,0,0,125,307,51,123,13,11,1394,1170,1025,1095,44,50,0,30243129.355
TY.RATTIE,20162017,CAR,67.31666666666666,0,2,0,2,2,2,0,0,0,9,14,9,2,2,0,60,67,59,66,2,4,0,30243033.42
TY.RATTIE,20162017,STL,29.333333333333336,0,0,0,0,0,0,0,0,0,1,1,1,0,1,0,22,23,22,23,0,0,0,30243027.91
TYLER.BERTUZZI,20162017,DET,63.75,0,0,0,0,0,0,1,2,1,3,8,12,1,1,0,39,54,35,54,1,2,0.5,30243031.75
TYLER.BOZAK,20162017,TOR,1394.0333333333333,20,24,15,39,59,44,832,1482,650,158,257,59,42,12,16,1635,1246,1164,1137,58,54,0.5614035087719298,30243185.775
TYLER.ENNIS,20162017,BUF,654.6333333333333,5,5,3,8,13,10,3,16,13,89,145,45,33,2,6,643,576,520,546,14,21,0.1875,30243086.814999998
TYLER.GAUDET,20162017,ARI,51.95,0,1,0,1,1,1,14,35,21,3,9,3,3,0,0,23,68,19,48,1,1,0.4,30243032.76
TYLER.GRAOVAC,20162017,MIN,511.7166666666667,7,1,1,2,9,8,163,343,180,48,84,52,13,3,5,359,543,356,541,18,11,0.4752186588921283,30243100.275
TYLER.JOHNSON,20162017,T.B,1242.2333333333333,19,12,13,25,44,31,583,1121,538,130,250,46,55,13,14,1182,1088,776,793,35,38,0.52007136485281,30243142.825000003
TYLER.MOTTE,20162017,CHI,375.76666666666665,4,3,0,3,7,7,4,10,6,46,74,27,15,4,6,261,416,254,331,11,8,0.4,30243066.5
TYLER.MYERS,20162017,WPG,244.28333333333333,2,0,3,3,5,2,0,0,0,16,40,12,17,3,5,193,245,164,154,9,4,0,30243039.705
TYLER.PITLICK,20162017,EDM,307.65,8,2,0,2,10,10,8,15,7,54,76,70,12,4,3,237,274,223,267,13,13,0.5333333333333333,30243060.810000002
TYLER.SEGUIN,20162017,DAL,1513.7666666666667,26,27,19,46,72,53,401,786,385,302,508,60,105,14,14,1793,1272,1171,1137,51,52,0.510178117048346,30243181.155
TYLER.TOFFOLI,20162017,L.A,1044.9,16,9,9,18,34,25,2,5,3,165,321,54,82,7,10,1230,798,845,634,28,28,0.4,30243088.625
TYLER.WOTHERSPOON,20162017,CGY,43.6,0,0,0,0,0,0,0,0,0,4,8,3,3,0,0,32,38,32,38,0,2,0,30243029.35
TYSON.BARRIE,20162017,COL,1724.7666666666664,7,20,9,29,36,27,0,0,0,182,409,32,130,9,9,1698,1424,1206,1255,44,72,0,30243154.465
TYSON.JOST,20162017,COL,94.04999999999998,1,0,0,0,1,1,28,70,42,9,15,3,4,2,0,90,95,72,80,2,7,0.4,30243035.99
VALENTIN.ZYKOV,20162017,CAR,12.5,1,0,0,0,1,1,0,0,0,3,4,0,0,1,0,17,10,17,9,1,0,0,15121513.96
VALTTERI.FILPPULA,20162017,PHI,342.55,5,2,1,3,8,7,126,238,112,23,36,5,8,2,1,300,332,226,268,8,13,0.5294117647058824,30243062.335
VALTTERI.FILPPULA,20162017,T.B,1032.5333333333333,7,19,7,26,33,26,429,922,493,74,111,21,11,9,12,913,933,677,688,32,36,0.46529284164859,30243130.225
VERNON.FIDDLER,20162017,N.J,477.3,1,1,1,2,3,2,244,469,225,37,62,42,11,14,12,290,504,278,332,5,15,0.5202558635394456,30243072.925
VERNON.FIDDLER,20162017,NSH,282.48333333333335,2,1,0,1,3,3,150,274,124,18,41,23,9,5,11,175,318,161,268,4,16,0.5474452554744526,30243064.950000003
VICTOR.HEDMAN,20162017,T.B,1936.25,16,34,21,55,71,50,0,0,0,166,408,93,138,22,22,1933,1611,1371,1196,58,53,0,30243150.244999997
VICTOR.RASK,20162017,CAR,1418.1333333333332,16,11,18,29,45,27,457,918,461,185,309,43,76,9,6,1483,1226,1105,1072,48,49,0.49782135076252726,30243159.770000003
VIKTOR.ARVIDSSON,20162017,NSH,1782.85,34,23,17,40,74,57,10,25,15,294,516,42,98,33,18,1983,1539,1538,1245,78,60,0.4,30243165.055
VIKTOR.STALBERG,20162017,CAR,666.7833333333333,9,3,0,3,12,12,0,3,3,71,133,120,31,11,14,526,624,475,482,15,22,0,30243081.009999998
VIKTOR.STALBERG,20162017,OTT,481.76666666666665,2,3,1,4,6,5,0,0,0,61,93,52,14,9,5,430,509,378,386,7,18,0,30243068.365000002
VINCENT.TROCHECK,20162017,FLA,1708.4833333333331,23,16,15,31,54,39,834,1663,829,229,423,164,87,32,20,1777,1427,1227,1034,46,49,0.5015033072760072,30243173.205
VINNIE.HINOSTROZA,20162017,CHI,593.7333333333333,6,4,3,7,13,10,68,171,103,76,132,32,32,10,8,523,575,500,563,18,20,0.39766081871345027,30243093.645000003
VLADIMIR.SOBOTKA,20162017,STL,208.58333333333334,3,1,3,4,7,4,39,73,34,15,29,21,8,3,1,180,216,127,163,8,4,0.5342465753424658,30243046.315
VLADIMIR.TARASENKO,20162017,STL,1743.5666666666666,42,20,19,39,81,62,5,10,5,330,613,63,151,21,6,1880,1411,1294,1196,58,42,0.5,30243168.485
VLADISLAV.KAMENEV,20162017,NSH,20.116666666666667,0,0,0,0,0,0,6,13,7,1,3,1,1,1,1,15,17,12,17,0,1,0.46153846153846156,15121515.05
VLADISLAV.NAMESTNIKOV,20162017,T.B,1094.0833333333335,10,9,9,18,28,19,209,480,271,115,197,72,40,14,15,1134,839,844,749,37,37,0.4354166666666667,30243116.325
WADE.MEGAN,20162017,STL,26.400000000000002,1,0,0,0,1,1,13,27,14,6,7,2,0,0,0,21,22,21,19,1,1,0.48148148148148145,30243028.72
WAYNE.SIMMONDS,20162017,PHI,1553.85,30,13,10,23,53,43,8,17,9,223,396,162,79,26,37,1858,1350,1035,1047,34,48,0.47058823529411764,30243160.08
WILLIAM.CARRIER,20162017,BUF,369.0333333333333,5,1,1,2,7,6,1,2,1,50,72,112,7,9,9,337,330,336,316,11,12,0.5,30243061.505
WILLIAM.KARLSSON,20162017,CBJ,1164.85,8,14,5,19,27,22,481,1046,565,108,183,39,41,11,4,911,1217,845,934,42,30,0.4598470363288719,30243154.125
WILLIAM.NYLANDER,20162017,TOR,1409.0666666666666,23,24,18,42,65,47,63,146,83,227,409,27,93,7,17,1678,1184,1227,1093,43,42,0.4315068493150685,30243155.84
XAVIER.OUELLET,20162017,DET,1186.2166666666667,3,5,4,9,12,8,0,2,2,88,177,73,53,11,17,966,1184,903,941,41,36,0,30243119.71
YANNI.GOURDE,20162017,T.B,307.35,6,2,0,2,8,8,60,163,103,30,54,11,12,6,4,302,241,267,187,7,9,0.36809815950920244,30243049.36
YANNICK.WEBER,20162017,NSH,1115.6166666666668,1,6,2,8,9,7,0,0,0,84,189,92,71,6,12,976,1037,949,989,43,42,0,30243119.509999998
YOHANN.AUVITU,20162017,N.J,390.08333333333337,2,1,1,2,4,3,0,0,0,54,87,20,20,0,1,366,298,280,282,12,9,0,30243053.875
ZAC.DALPE,20162017,MIN,77,1,0,2,2,3,1,27,59,32,8,14,5,3,3,3,61,72,61,71,5,5,0.4576271186440678,30243034.96
ZACH.BOGOSIAN,20162017,BUF,1124.8833333333332,2,4,4,8,10,6,0,0,0,73,135,59,30,8,15,959,1143,881,937,30,48,0,30243122.880000003
ZACH.HYMAN,20162017,TOR,1480.0333333333333,11,12,8,20,31,23,11,31,20,169,252,130,29,26,16,1393,1684,1257,1156,48,48,0.3548387096774194,30243151.4
ZACH.PARISE,20162017,MIN,1299.9166666666667,21,18,6,24,45,39,9,15,6,213,324,51,54,19,19,1377,1233,974,995,45,46,0.6,30243150.15
ZACH.REDMOND,20162017,MTL,196.96666666666667,0,1,4,5,5,1,0,0,0,12,35,25,16,0,1,183,140,182,137,12,6,0,30243034.35
ZACH.SANFORD,20162017,STL,202.7,2,1,2,3,5,3,8,22,14,19,38,10,7,5,3,168,186,131,179,7,4,0.36363636363636365,30243047.87
ZACH.SANFORD,20162017,WSH,62.150000000000006,2,0,0,0,2,2,0,0,0,6,9,7,2,1,1,41,61,41,61,2,1,0,30243033.86
ZACH.WERENSKI,20162017,CBJ,1701.5333333333333,12,15,19,34,46,27,0,0,0,202,416,44,140,4,9,1803,1364,1322,1161,59,45,0,30243133.265
ZACHARY.SANFORD,20162017,WSH,201.65,0,0,1,1,1,0,10,18,8,17,35,11,12,1,2,166,192,162,177,4,5,0.5555555555555556,30243043.085
ZACK.KASSIAN,20162017,EDM,1147.3166666666666,10,8,9,17,27,18,5,12,7,129,203,231,37,20,38,881,1156,831,943,41,36,0.4166666666666667,30243138.424999997
ZACK.MITCHELL,20162017,MIN,92.68333333333334,0,0,0,0,0,0,11,19,8,10,14,14,0,0,0,67,87,66,87,0,1,0.5789473684210527,30243036.04
ZACK.SMITH,20162017,OTT,1519.45,17,10,10,20,37,27,412,806,394,162,293,182,64,28,34,1383,1529,1129,1126,37,46,0.511166253101737,30243170.009999998
ZBYNEK.MICHALEK,20162017,ARI,52.983333333333334,0,0,0,0,0,0,0,0,0,3,5,7,2,0,0,31,62,30,53,1,0,0,30243031.65
ZDENO.CHARA,20162017,BOS,1922.3333333333335,10,10,10,20,30,20,0,1,1,144,302,166,101,19,26,1683,1910,1468,1332,68,68,0,30243151.14
ZEMGUS.GIRGENSONS,20162017,BUF,986.9666666666667,7,8,1,9,16,15,273,579,306,112,188,120,41,19,8,733,1000,701,799,21,28,0.47150259067357514,30243129.935000002
5EBASTIAN.AHO,20172018,NYI,357.4,1,1,2,3,4,2,0,1,1,24,54,10,21,4,3,326,340,289,325,15,19,0,30258059.04
A.J..GREER,20172018,COL,125.68333333333334,0,2,1,3,3,2,1,3,2,12,19,30,5,7,8,86,129,83,127,4,2,0.3333333333333333,30258043.685
AARON.EKBLAD,20172018,FLA,1917.9,16,6,16,22,38,22,0,0,0,189,399,69,116,12,32,1935,2041,1392,1520,69,67,0,30258187.72
AARON.NESS,20172018,WSH,101.81666666666666,0,0,1,1,1,0,0,0,0,2,3,1,1,1,4,77,112,74,102,6,4,0,30258038.335
ADAM.CLENDENING,20172018,ARI,79.66666666666666,0,0,2,2,2,0,0,0,0,4,11,2,3,0,1,75,91,74,89,4,5,0,30258036.1
ADAM.CRACKNELL,20172018,DAL,8.583333333333334,0,0,0,0,0,0,1,2,1,2,3,2,1,0,0,8,7,8,7,0,0,0.5,15129014.14
ADAM.CRACKNELL,20172018,NYR,29.96666666666667,0,0,0,0,0,0,2,4,2,4,5,10,1,0,0,19,29,19,24,0,1,0.5,30258029.78
ADAM.ERNE,20172018,T.B,232.73333333333335,3,0,1,1,4,3,5,8,3,29,49,37,7,5,5,202,182,198,171,9,9,0.625,30258044.875
ADAM.GAUDETTE,20172018,VAN,63.93333333333334,0,0,0,0,0,0,6,16,10,9,20,2,6,0,0,61,63,55,61,2,0,0.375,30258033.09
ADAM.HENRIQUE,20172018,ANA,1073.6833333333334,21,9,6,15,36,30,371,766,395,112,199,58,39,6,6,1112,979,737,773,31,16,0.48433420365535246,30258138.3
ADAM.HENRIQUE,20172018,N.J,437.9,4,7,3,10,14,11,161,342,181,49,81,17,15,3,3,407,481,248,301,8,11,0.47076023391812866,30258073.545
ADAM.LARSSON,20172018,EDM,1382.0500000000002,4,2,6,8,12,6,0,0,0,92,194,239,64,7,17,1250,1426,1149,1125,47,49,0,30258133.22
ADAM.LOWRY,20172018,WPG,895.5666666666666,8,9,6,15,23,17,468,867,399,91,144,171,23,14,7,838,803,735,572,27,27,0.5397923875432526,30258100.560000002
ADAM.MCQUAID,20172018,BOS,756.5,2,0,2,2,4,2,0,0,0,48,91,97,26,7,17,618,808,587,590,18,23,0,30258086.119999997
ADAM.PELECH,20172018,NYI,1503.3833333333332,3,6,9,15,18,9,0,0,0,106,227,100,77,5,13,1263,1691,1165,1253,53,49,0,30258150.575000003
ADRIAN.KEMPE,20172018,L.A,1138.75,16,11,10,21,37,27,274,713,439,125,225,108,56,9,25,1145,1088,938,997,41,28,0.38429172510518933,30258162.4
ALAN.QUINE,20172018,NYI,246.45,0,2,1,3,3,2,40,103,63,15,31,32,11,1,2,179,297,173,271,8,9,0.3883495145631068,30258061.134999998
ALEC.MARTINEZ,20172018,L.A,1869.7166666666667,9,10,6,16,25,19,0,1,1,119,245,111,81,3,17,1672,1951,1249,1476,49,46,0,30258187.28
ALEKSANDER.BARKOV,20172018,FLA,1743.5333333333333,27,26,22,48,75,53,908,1697,789,256,376,30,57,21,7,1950,1619,1231,1162,68,56,0.5350618738951091,30258200.28
ALES.HEMSKY,20172018,MTL,69.45,0,0,0,0,0,0,0,1,1,5,10,0,1,2,5,82,51,43,46,0,1,0,30258032.67
ALEX.BIEGA,20172018,VAN,660.9000000000001,1,4,3,7,8,5,0,0,0,79,150,126,44,5,16,616,628,591,577,18,17,0,30258084.225
ALEX.BROADHURST,20172018,CBJ,20.083333333333332,0,0,0,0,0,0,0,0,0,1,3,0,0,0,1,28,15,27,15,0,0,0,30258028.1
ALEX.BURMISTROV,20172018,VAN,287.45000000000005,2,3,1,4,6,5,87,181,94,18,38,20,13,2,6,240,263,209,225,6,10,0.48066298342541436,30258056.225
ALEX.BURROWS,20172018,OTT,829.55,6,2,6,8,14,8,8,30,22,90,156,64,29,8,18,720,770,540,626,15,24,0.26666666666666666,30258101.35
ALEX.CHIASSON,20172018,WSH,861.4833333333333,10,8,2,10,20,18,14,49,35,73,116,62,23,5,12,662,940,554,720,24,28,0.2857142857142857,30258118.91
ALEX.DEBRINCAT,20172018,CHI,1213.7666666666667,28,14,8,22,50,42,25,59,34,181,358,40,106,13,3,1415,1027,1044,898,51,38,0.423728813559322,30258124.93
ALEX.EDLER,20172018,VAN,1699.4166666666665,6,16,12,28,34,22,1,2,1,172,354,157,124,10,34,1599,1716,1092,1271,39,51,0.5,30258166.34
ALEX.FORMENTON,20172018,OTT,4.8999999999999995,0,0,0,0,0,0,0,0,0,0,0,1,0,0,0,4,8,4,8,0,0,0,15129014.5
ALEX.GALCHENYUK,20172018,MTL,1331.1333333333334,19,16,15,31,50,35,49,109,60,213,382,33,99,10,10,1575,1210,1027,1068,27,41,0.44954128440366975,30258154.935
ALEX.GOLIGOSKI,20172018,ARI,1813.85,12,16,7,23,35,28,0,0,0,119,276,114,103,7,12,1667,1938,1299,1534,39,64,0,30258196.395000003
ALEX.IAFALLO,20172018,L.A,1173.4,10,10,6,16,26,20,14,30,16,132,237,60,51,16,7,1141,1031,1016,933,42,34,0.4666666666666667,30258123.62
ALEX.KERFOOT,20172018,COL,1135.3166666666666,21,15,9,24,45,36,233,547,314,89,148,44,34,15,13,1130,949,764,865,37,31,0.4259597806215722,30258151.445
ALEX.KILLORN,20172018,T.B,1621.25,20,18,15,33,53,38,23,57,34,178,324,115,67,18,25,1790,1332,1187,955,61,38,0.40350877192982454,30258131.025
ALEX.NYLANDER,20172018,BUF,38.58333333333333,1,0,0,0,1,1,0,0,0,2,4,0,0,0,0,40,33,36,32,1,3,0,30258030.65
ALEX.OVECHKIN,20172018,WSH,2130.016666666667,64,26,23,49,113,90,3,8,5,453,913,216,239,23,21,2588,1755,1615,1564,86,64,0.375,30258219.174999997
ALEX.PETROVIC,20172018,FLA,982,2,5,5,10,12,7,0,0,0,60,147,142,52,11,28,920,895,889,836,34,34,0,30258106.884999998
ALEX.PIETRANGELO,20172018,STL,2007.4499999999998,15,19,19,38,53,34,0,0,0,216,417,48,122,18,10,2043,1893,1481,1390,61,49,0,30258168.855
ALEX.RADULOV,20172018,DAL,1650.4499999999998,27,31,13,44,71,58,6,10,4,217,388,77,85,22,36,2017,1387,1323,1220,61,50,0.6,30258175.485
ALEX.STEEN,20172018,STL,1420.7333333333333,15,18,13,31,46,33,24,59,35,168,303,53,87,17,10,1578,1223,1056,926,43,42,0.4067796610169492,30258126.555
ALEX.TUCH,20172018,VGK,1489.0333333333333,21,18,7,25,46,39,102,240,138,214,375,140,71,11,17,1777,1247,1171,1118,45,35,0.425,30258163.115000002
ALEX.WENNBERG,20172018,CBJ,1248.45,9,15,13,28,37,24,361,797,436,78,133,30,24,10,4,1369,1049,985,839,58,32,0.45294855708908405,30258129.615000002
ALEXEI.EMELIN,20172018,NSH,1396.1666666666665,1,5,3,8,9,6,1,1,0,61,148,198,50,8,20,1112,1448,1051,1205,41,34,1,30258151.345
ANDERS.BJORK,20172018,BOS,370.41666666666663,4,4,4,8,12,8,1,2,1,30,74,19,27,4,2,383,303,343,286,15,11,0.5,30258053.63
ANDERS.LEE,20172018,NYI,1415.8833333333332,40,15,6,21,61,55,11,16,5,207,316,102,44,14,22,1613,1307,1085,1188,56,67,0.6875,30258186.58
ANDRE.BURAKOVSKY,20172018,WSH,900.3166666666666,14,7,9,16,30,21,18,36,18,96,189,48,53,10,8,918,760,783,720,34,27,0.5,30258103.945
ANDREAS.ATHANASIOU,20172018,DET,1087.3,16,10,6,16,32,26,106,255,149,170,322,24,83,22,8,1094,985,835,868,34,42,0.41568627450980394,30258131.36
ANDREAS.BORGMAN,20172018,TOR,657,3,3,3,6,9,6,0,0,0,46,117,121,46,5,14,639,637,627,615,33,29,0,30258084.475
ANDREAS.ENGLUND,20172018,OTT,11.35,0,0,0,0,0,0,0,0,0,0,0,3,0,0,0,5,15,5,14,1,0,0,15129015.2
ANDREAS.JOHNSSON,20172018,TOR,173.3,3,1,1,2,5,4,4,9,5,26,41,8,6,3,1,185,144,139,131,6,7,0.4444444444444444,30258042.314999998
ANDREAS.MARTINSEN,20172018,CHI,113.76666666666667,1,0,0,0,1,1,0,0,0,14,26,35,9,2,7,118,112,117,103,2,3,0,30258037.42
ANDREI.MIRONOV,20172018,COL,110.46666666666667,1,0,1,1,2,1,0,0,0,3,9,19,5,0,6,74,135,74,103,4,2,0,30258039.225
ANDREJ.SEKERA,20172018,EDM,587.8166666666667,0,3,4,7,7,3,0,0,0,36,95,27,45,1,3,567,574,457,480,8,27,0,30258072.41
ANDREJ.SUSTR,20172018,T.B,564.9166666666667,2,5,0,5,7,7,0,0,0,45,94,9,28,0,9,531,540,520,507,20,26,0,30258077.6
ANDREW.COGLIANO,20172018,ANA,1276.2666666666667,13,15,7,22,35,28,36,72,36,185,320,88,71,11,19,1183,1377,1079,1059,42,30,0.5,30258146.475
ANDREW.COPP,20172018,WPG,1317.6999999999998,10,8,11,19,29,18,325,630,305,113,213,122,55,10,8,1113,1284,1051,914,45,38,0.5158730158730159,30258127.725
ANDREW.CRESCENZI,20172018,L.A,15.716666666666667,0,0,0,0,0,0,8,16,8,0,1,4,0,0,1,5,23,5,17,0,0,0.5,15129016.27
ANDREW.LADD,20172018,NYI,1160.2,12,11,6,17,29,23,1,10,9,112,220,76,51,7,11,1111,1083,899,833,43,29,0.1,30258115.560000002
ANDREW.MACDONALD,20172018,PHI,1423.6166666666668,8,2,11,13,21,10,0,0,0,88,207,46,79,13,17,1112,1500,1020,1175,47,46,0,30258147.955
ANDREW.MANGIAPANE,20172018,CGY,89.30000000000001,0,0,0,0,0,0,1,1,0,7,19,9,4,0,1,91,92,90,88,0,2,1,30258035.59
ANDREW.SHAW,20172018,MTL,806.2833333333333,10,6,5,11,21,16,177,326,149,94,152,80,26,12,20,921,704,660,630,23,28,0.5429447852760736,30258105.325000003
ANDY.ANDREOFF,20172018,L.A,422.53333333333336,3,4,2,6,9,7,24,53,29,47,83,77,21,14,15,349,419,346,413,10,18,0.4528301886792453,30258077.4
ANDY.GREENE,20172018,N.J,1818.15,3,6,5,11,14,9,0,0,0,101,206,93,62,10,12,1346,2079,1203,1469,50,67,0,30258183.125
ANDY.WELINSKI,20172018,ANA,148.76666666666665,0,1,1,2,2,1,0,0,0,8,23,7,8,1,0,113,158,93,143,2,5,0,30258043.335
ANTHONY.BEAUVILLIER,20172018,NYI,1031.4,20,10,5,15,35,30,72,166,94,131,218,80,49,6,9,1042,1096,913,945,47,44,0.43373493975903615,30258140.515
ANTHONY.BITETTO,20172018,NSH,430.45000000000005,1,0,2,2,3,1,0,0,0,25,54,40,16,6,11,362,460,346,440,13,13,0,30258075.16
ANTHONY.CIRELLI,20172018,T.B,462.33333333333337,7,6,1,7,14,13,171,372,201,45,82,37,20,9,5,406,440,389,319,17,8,0.4596774193548387,30258069.555
ANTHONY.DUCLAIR,20172018,ARI,443.98333333333335,9,3,3,6,15,12,0,0,0,68,116,26,26,8,5,492,405,351,375,10,14,0,30258072.705
ANTHONY.DUCLAIR,20172018,CHI,299.79999999999995,2,5,1,6,8,7,1,2,1,29,59,20,19,6,2,375,275,298,261,12,12,0.5,30258052.675
ANTHONY.MANTHA,20172018,DET,1383.3666666666668,24,16,8,24,48,40,17,52,35,190,331,91,64,8,15,1466,1120,1095,1024,51,42,0.3269230769230769,30258148.21
ANTHONY.PELUSO,20172018,WSH,9.283333333333333,0,0,0,0,0,0,0,0,0,0,0,4,0,1,2,4,5,4,5,0,0,0,15129014.36
ANTOINE.ROUSSEL,20172018,DAL,907.5,5,9,3,12,17,14,22,38,16,85,170,104,44,36,38,842,845,806,735,27,26,0.5789473684210527,30258105.865000002
ANTOINE.VERMETTE,20172018,ANA,892.6,8,4,4,8,16,12,609,1018,409,93,144,38,27,14,17,815,920,637,754,22,27,0.5982318271119843,30258130.7
ANTON.BLIDH,20172018,BOS,10.383333333333333,0,0,0,0,0,0,0,0,0,0,0,3,0,0,0,4,4,4,4,0,0,0,15129013.9
ANTON.LINDHOLM,20172018,COL,632.1166666666667,0,2,2,4,4,2,0,0,0,22,65,99,33,3,7,470,704,444,554,21,17,0,30258083.23
ANTON.SLEPYSHEV,20172018,EDM,590.6,6,5,1,6,12,11,1,7,6,73,140,61,32,9,4,632,582,597,566,21,23,0.14285714285714285,30258085.755
ANTON.STRALMAN,20172018,T.B,2094.283333333333,5,9,8,17,22,14,0,0,0,151,281,136,93,16,13,1800,2163,1629,1513,88,68,0,30258164.06
ANZE.KOPITAR,20172018,L.A,1919.0166666666667,36,32,25,57,93,68,1046,1921,875,209,367,61,90,15,11,2012,1728,1312,1222,59,46,0.5445080687142113,30258212.564999998
ARTEM.ANISIMOV,20172018,CHI,1208.7833333333333,20,8,3,11,31,28,416,910,494,130,226,15,57,12,11,1281,1177,863,885,29,41,0.45714285714285713,30258151.134999998
ARTEMI.PANARIN,20172018,CBJ,1786.5666666666666,29,38,22,60,89,67,0,7,7,242,510,20,148,23,18,2199,1390,1608,1254,64,39,0,30258161.130000003
ARTTURI.LEHKONEN,20172018,MTL,1088.0333333333333,12,7,2,9,21,19,11,30,19,164,290,71,70,7,10,1184,1071,882,788,24,28,0.36666666666666664,30258110.009999998
ASHTON.SAUTNER,20172018,VAN,66.8,0,1,1,2,2,1,0,0,0,3,5,9,1,0,1,50,61,50,60,5,1,0,30258033.525
AUSTIN.CZARNIK,20172018,BOS,109.11666666666667,0,3,1,4,4,3,14,28,14,7,12,4,1,1,0,101,80,97,70,3,4,0.5,30258034.695
AUSTIN.WATSON,20172018,NSH,1124.4333333333334,19,3,4,7,26,22,27,43,16,121,211,224,40,25,38,826,1227,749,859,29,33,0.627906976744186,30258135.83
AUSTON.MATTHEWS,20172018,TOR,1246.7166666666667,35,19,11,30,65,54,418,766,348,214,358,30,66,18,6,1422,1178,1060,1060,67,39,0.5456919060052219,30258173.825
BARCLAY.GOODROW,20172018,S.J,541.3833333333333,7,3,4,7,14,10,166,283,117,59,105,77,20,7,11,498,531,460,459,23,24,0.5865724381625441,30258082.11
BEAU.BENNETT,20172018,STL,64.81666666666666,0,0,0,0,0,0,1,3,2,6,14,9,4,0,1,75,56,63,56,0,2,0.3333333333333333,30258032.189999998
BEN.CHIAROT,20172018,WPG,1111.7,2,8,7,15,17,10,0,0,0,75,175,156,60,6,22,1010,1158,972,944,46,35,0,30258117.534999996
BEN.HARPUR,20172018,OTT,610.3333333333334,0,1,0,1,1,1,0,0,0,26,70,71,29,6,8,535,701,489,580,11,33,0,30258086.66
BEN.HUTTON,20172018,VAN,1123.2833333333333,0,1,4,5,5,1,0,1,1,103,204,40,65,9,10,974,1019,814,843,28,35,0,30258106.439999998
BEN.LOVEJOY,20172018,N.J,1021.0500000000001,3,2,4,6,9,5,0,0,0,82,154,90,42,6,12,830,1033,761,696,27,24,0,30258092.46
BEN.SEXTON,20172018,OTT,20.55,0,0,0,0,0,0,3,5,2,1,1,6,0,0,0,18,11,18,11,0,1,0.6,30258027.869999997
BENOIT.POULIOT,20172018,BUF,1012.5166666666667,14,5,0,5,19,19,12,33,21,84,146,69,28,9,11,816,1094,694,815,22,34,0.36363636363636365,30258126.47
BLAKE.COLEMAN,20172018,N.J,1214.1166666666668,15,9,2,11,26,24,255,543,288,162,263,234,46,24,24,935,1233,851,869,34,36,0.4696132596685083,30258142.189999998
BLAKE.COMEAU,20172018,COL,1346.1333333333332,15,15,5,20,35,30,114,300,186,132,233,166,53,24,26,1054,1588,971,1102,36,40,0.38,30258168.424999997
BLAKE.HILLMAN,20172018,CHI,72.11666666666667,1,0,0,0,1,1,0,0,0,5,10,5,3,0,0,50,87,49,71,0,2,0,30258035.7
BLAKE.PIETILA,20172018,N.J,18.916666666666664,0,0,0,0,0,0,0,0,0,1,4,5,0,0,0,14,16,14,16,0,0,0,30258028.75
BLAKE.WHEELER,20172018,WPG,1986.55,26,59,26,85,111,85,169,366,197,295,512,122,109,33,30,2139,1838,1428,1382,66,55,0.46174863387978143,30258216.99
BO.HORVAT,20172018,VAN,1238.3833333333332,22,16,6,22,44,38,712,1324,612,158,253,35,49,16,5,1249,1147,842,886,46,38,0.5377643504531722,30258160.490000002
BOBBY.RYAN,20172018,OTT,1019.3833333333333,11,12,10,22,33,23,12,22,10,112,236,97,70,11,7,1106,911,795,848,36,41,0.5454545454545454,30258120.740000002
BOO.NIEVES,20172018,NYR,285.56666666666666,1,4,4,8,9,5,97,219,122,23,35,30,5,1,5,231,296,224,274,13,8,0.4429223744292237,30258064.439999998
BOONE.JENNER,20172018,CBJ,1353.0833333333333,14,14,7,21,35,28,285,515,230,211,349,223,58,17,15,1228,1403,1053,1177,48,46,0.5533980582524272,30258174.645
BRAD.HUNT,20172018,VGK,748.7,3,7,7,14,17,10,0,1,1,78,154,19,46,0,3,786,569,570,520,21,24,0,30258077.325
BRAD.MALONE,20172018,EDM,55.91666666666667,0,0,0,0,0,0,21,31,10,9,10,19,1,1,3,49,35,41,32,0,0,0.6774193548387096,30258030.799999997
BRAD.MARCHAND,20172018,BOS,1587.1999999999998,38,35,29,64,102,73,58,151,93,212,363,48,80,34,29,1875,1294,1204,916,68,44,0.3841059602649007,30258149.384999998
BRAD.RICHARDSON,20172018,ARI,1122.9666666666667,3,6,5,11,14,9,543,1041,498,105,185,72,48,13,16,900,1255,832,900,23,42,0.521613832853026,30258142.775
BRADY.SKJEI,20172018,NYR,1723.2833333333333,4,8,10,18,22,12,0,0,0,153,282,127,80,15,19,1568,1782,1291,1461,42,66,0,30258181.9
BRANDON.CARLO,20172018,BOS,1462.0333333333333,0,3,2,5,5,3,1,1,0,76,144,89,41,6,21,1239,1461,1161,1069,49,46,1,30258124.6
BRANDON.DAVIDSON,20172018,EDM,399.16666666666663,3,0,1,1,4,3,0,0,0,28,50,53,13,3,5,341,416,325,325,12,14,0,30258060.105
BRANDON.DAVIDSON,20172018,MTL,194.05,0,1,0,1,1,1,0,0,0,13,27,28,9,3,3,203,179,182,142,6,9,0,30258038.630000003
BRANDON.DAVIDSON,20172018,NYI,264.51666666666665,1,1,0,1,2,2,0,0,0,22,47,24,15,2,2,213,268,200,221,6,13,0,30258049.67
BRANDON.DUBINSKY,20172018,CBJ,1025.5333333333333,6,7,3,10,16,13,572,1033,461,93,160,155,33,10,16,860,1118,787,880,26,32,0.5537270087124879,30258143.555
BRANDON.MANNING,20172018,PHI,1272.6666666666665,7,6,5,11,18,13,0,0,0,119,248,126,78,13,25,1121,1222,1049,1034,37,40,0,30258130.805
BRANDON.MONTOUR,20172018,ANA,1740.7,9,13,10,23,32,22,0,0,0,174,355,101,99,13,23,1798,1657,1327,1331,54,45,0,30258163.83
BRANDON.PIRRI,20172018,VGK,35.233333333333334,3,0,0,0,3,3,1,2,1,11,15,2,1,0,0,45,24,32,22,3,0,0.5,15129017.29
BRANDON.SAAD,20172018,CHI,1435.3333333333335,18,12,5,17,35,30,56,121,65,236,396,29,78,15,7,1698,1344,1269,1004,43,52,0.4628099173553719,30258131.265
BRANDON.SUTTER,20172018,VAN,1056.25,11,10,4,14,25,21,NA,1103,NA,106,155,55,22,17,4,723,1157,616,803,24,22,NA,NA
BRANDON.TANEV,20172018,WPG,998.7333333333333,12,4,6,10,22,16,3,11,8,111,184,232,34,24,13,789,1079,758,728,29,25,0.2727272727272727,30258108.009999998
BRAYDEN.MCNABB,20172018,VGK,1936.8833333333332,7,5,8,13,20,12,0,0,0,100,232,306,89,14,32,1686,2091,1532,1475,71,54,0,30258165.84
BRAYDEN.POINT,20172018,T.B,1930.15,39,23,20,43,82,62,616,1301,685,254,444,37,95,32,14,1999,1891,1415,1342,76,57,0.4734819369715603,30258216.56
BRAYDEN.SCHENN,20172018,STL,1617.4833333333333,28,23,19,42,70,51,660,1373,713,210,355,154,64,21,21,1907,1327,1304,1083,57,42,0.4806991988346686,30258182.685000002
BRAYDON.COBURN,20172018,T.B,1393.5166666666667,1,10,6,16,17,11,0,0,0,87,205,102,72,6,21,1153,1379,1096,1063,46,44,0,30258128.16
BRENDAN.GALLAGHER,20172018,MTL,1323.9,31,13,10,23,54,44,85,182,97,278,477,88,107,29,16,1629,1137,1154,977,41,45,0.46703296703296704,30258143.84
BRENDAN.GAUNCE,20172018,VAN,492.46666666666664,4,2,0,2,6,6,38,84,46,55,96,48,21,6,6,371,509,335,392,11,12,0.4523809523809524,30258073.78
BRENDAN.GUHLE,20172018,BUF,325.9,0,3,2,5,5,3,0,0,0,37,69,10,21,2,5,315,297,283,265,13,16,0,30258051.92
BRENDAN.LEIPSIC,20172018,VAN,236.95000000000002,3,6,0,6,9,9,3,6,3,27,56,5,16,2,5,240,222,204,207,8,10,0.5,30258051.89
BRENDAN.LEIPSIC,20172018,VGK,525.5,2,7,3,10,12,9,5,8,3,68,113,27,31,7,2,527,505,453,465,19,19,0.625,30258075.945
BRENDAN.LEMIEUX,20172018,WPG,71.46666666666667,1,0,0,0,1,1,0,0,0,6,10,12,2,4,5,47,52,44,50,3,1,0,30258033.340000004
BRENDAN.PERLINI,20172018,ARI,1074.0500000000002,17,7,6,13,30,24,5,11,6,129,280,83,79,7,12,1100,1026,827,939,35,32,0.45454545454545453,30258134.17
BRENDAN.SMITH,20172018,NYR,756,1,4,3,7,8,5,0,0,0,66,119,58,34,20,26,640,791,597,693,31,31,0,30258101.875
BRENDEN.DILLON,20172018,S.J,1578.7666666666667,4,10,11,21,25,14,0,0,0,93,218,225,68,16,28,1506,1572,1395,1320,59,67,0,30258154.335
BRENT.BURNS,20172018,S.J,2328.8333333333335,15,33,24,57,72,48,0,0,0,363,867,105,335,8,27,2931,2122,1948,1671,58,73,0,30258174.03
BRENT.SEABROOK,20172018,CHI,1635.9833333333333,7,7,10,17,24,14,0,2,2,136,307,85,112,8,19,1728,1688,1338,1264,49,49,0,30258144.88
BRETT.CONNOLLY,20172018,WSH,1112.7666666666667,20,11,4,15,35,31,15,36,21,96,200,106,55,7,14,1076,964,843,907,42,38,0.4166666666666667,30258134.57
BRETT.KULAK,20172018,CGY,921.95,2,2,4,6,8,4,0,0,0,72,169,45,56,12,12,939,885,915,840,34,38,0,30258102.07
BRETT.LERNOUT,20172018,MTL,301.05,0,0,1,1,1,0,0,0,0,14,38,56,14,0,4,243,306,237,275,5,11,0,30258054.925
BRETT.PESCE,20172018,CAR,1358.7666666666664,3,7,8,15,18,10,0,1,1,88,199,57,69,9,9,1237,1268,1146,965,40,51,0,30258110.54
BRETT.RITCHIE,20172018,DAL,769.5833333333333,7,2,5,7,14,9,0,1,1,116,211,172,54,8,18,861,548,668,517,22,16,0,30258074.755
BRIAN.BOYLE,20172018,N.J,960.1333333333334,13,6,3,9,22,19,439,876,437,122,199,139,37,5,16,993,839,692,712,21,32,0.5011415525114156,30258129.134999998
BRIAN.DUMOULIN,20172018,PIT,1902.1,6,10,8,18,24,16,0,0,0,123,251,121,78,17,16,1741,1854,1595,1371,67,77,0,30258150.17
BRIAN.GIBBONS,20172018,N.J,871.9666666666667,12,11,3,14,26,23,23,52,29,72,110,37,20,10,10,610,996,554,676,30,25,0.4423076923076923,30258114.295
BRIAN.GIONTA,20172018,BOS,272.65,2,3,1,4,6,5,6,13,7,42,60,18,9,1,1,295,212,209,185,4,4,0.46153846153846156,30258048.025
BRIAN.LASHOFF,20172018,DET,4.033333333333333,0,0,0,0,0,0,0,0,0,0,0,0,0,0,0,2,4,1,2,0,0,0,15129013.75
BROCK.BOESER,20172018,VAN,1084.5333333333333,29,13,13,26,55,42,10,39,29,179,341,29,101,9,7,1190,958,793,862,42,37,0.2564102564102564,30258135.065
BROCK.MCGINN,20172018,CAR,1159.7333333333333,16,6,8,14,30,22,17,37,20,159,326,137,82,29,7,1160,1061,1053,885,31,44,0.4594594594594595,30258115.37
BROCK.NELSON,20172018,NYI,1207.4666666666667,19,6,10,16,35,25,389,804,415,137,247,50,63,17,19,1072,1194,846,990,36,39,0.48383084577114427,30258162.43
BROOKS.LAICH,20172018,L.A,134.31666666666666,0,0,1,1,1,0,53,109,56,10,21,22,7,1,3,91,154,82,110,2,7,0.48623853211009177,30258041.355
BROOKS.ORPIK,20172018,WSH,1959.85,1,6,7,13,14,7,0,0,0,71,169,302,72,21,36,1408,2359,1317,1634,51,57,0,30258201.485
BRYAN.LITTLE,20172018,WPG,1643.9,17,17,15,32,49,34,831,1503,672,155,277,64,75,23,15,1715,1545,1248,1193,46,45,0.5528942115768463,30258183.295
BRYAN.RUST,20172018,PIT,1281.7333333333333,16,16,9,25,41,32,11,35,24,137,236,112,35,23,14,1280,1167,1139,904,41,39,0.3142857142857143,30258125.195
BYRON.FROESE,20172018,MTL,555.8166666666667,3,8,0,8,11,11,156,352,196,49,96,54,29,7,13,429,621,408,484,14,14,0.4431818181818182,30258091.96
CAL.CLUTTERBUCK,20172018,NYI,970.8166666666666,8,5,5,10,18,13,7,20,13,99,166,226,41,9,13,650,1206,595,843,30,35,0.35,30258129.345
CAL.O'REILLY,20172018,MIN,8.266666666666666,0,0,0,0,0,0,2,5,3,1,1,0,0,0,0,6,11,5,11,0,0,0.4,15129015.08
CALLE.JARNKROK,20172018,NSH,1167.2333333333333,16,11,9,20,36,27,270,529,259,112,206,37,48,8,6,1004,1218,852,857,36,23,0.5103969754253308,30258135.105
CALLE.ROSEN,20172018,TOR,51.150000000000006,0,0,1,1,1,0,0,0,0,5,13,1,5,1,2,55,38,51,36,1,3,0,30258029.585
CALVIN.DE HAAN,20172018,NYI,618.7,1,6,5,11,12,7,0,0,0,44,91,45,28,4,3,508,663,476,494,27,22,0,30258076.115000002
CAM.ATKINSON,20172018,CBJ,1388.1833333333334,26,17,7,24,50,43,24,72,48,256,429,37,91,10,7,1518,1287,1050,980,51,34,0.3333333333333333,30258144.384999998
CAM.FOWLER,20172018,ANA,1664.85,8,7,16,23,31,15,1,2,1,122,274,21,111,6,14,1593,1637,1142,1194,42,39,0.5,30258145
CARL.DAHLSTROM,20172018,CHI,192.65,0,2,1,3,3,2,1,1,0,12,30,6,15,0,0,182,182,171,156,9,11,1,30258040.015
CARL.GUNNARSSON,20172018,STL,1018.45,5,1,2,3,8,6,0,0,0,59,109,35,28,8,10,792,1000,755,859,35,22,0,30258117.380000003
CARL.HAGELIN,20172018,PIT,1416.0166666666667,12,11,9,20,32,23,23,56,33,185,278,127,51,21,14,1256,1355,1178,999,49,42,0.4107142857142857,30258131.055
CARL.SODERBERG,20172018,COL,1426.1666666666665,16,15,8,23,39,31,456,1002,546,158,275,73,59,16,14,1208,1564,902,1075,33,34,0.4550898203592814,30258182.3
CARSON.SOUCY,20172018,MIN,98.66666666666666,0,0,0,0,0,0,0,0,0,6,9,7,2,3,1,66,107,64,103,0,5,0,30258039.43
CARTER.ROWNEY,20172018,PIT,438.5,2,1,2,3,5,3,172,325,153,22,46,80,13,3,2,287,496,265,309,7,20,0.5292307692307693,30258066.560000002
CASEY.CIZIKAS,20172018,NYI,844.9166666666667,7,4,6,10,17,11,473,891,418,74,123,128,32,16,9,586,1022,532,690,22,35,0.5308641975308642,30258124.73
CASEY.MITTELSTADT,20172018,BUF,84.11666666666667,1,2,2,4,5,3,17,36,19,9,15,2,3,1,1,71,65,55,60,5,3,0.4722222222222222,30258035.39
CASEY.NELSON,20172018,BUF,694.8666666666667,3,3,1,4,7,6,0,0,0,48,103,31,37,3,4,565,629,520,558,18,34,0,30258083.305
CEDRIC.PAQUETTE,20172018,T.B,771.9,6,3,2,5,11,9,340,696,356,77,137,156,36,22,26,651,748,626,617,19,24,0.4885057471264368,30258108.369999997
CHAD.RUHWEDEL,20172018,PIT,867.25,2,1,1,2,4,3,0,0,0,76,159,92,50,10,9,819,816,780,700,22,28,0,30258089.475
CHANDLER.STEPHENSON,20172018,WSH,1147.3,8,12,5,17,25,20,77,155,78,54,90,48,13,6,8,847,1204,777,940,39,28,0.4967741935483871,30258141.015
CHARLES.HUDON,20172018,MTL,1010.0833333333334,10,13,7,20,30,23,88,219,131,178,285,125,73,26,16,1122,897,881,839,31,41,0.4018264840182648,30258125.104999997
CHARLIE.COYLE,20172018,MIN,1161.6999999999998,11,16,10,26,37,27,251,484,233,127,215,81,45,18,10,1004,1188,786,990,38,35,0.518595041322314,30258158.17
CHARLIE.MCAVOY,20172018,BOS,1683.2333333333333,8,12,16,28,36,20,0,0,0,85,217,162,75,13,28,1699,1410,1414,1180,64,43,0,30258134.43
CHASE.BALISY,20172018,FLA,78.53333333333333,0,0,0,0,0,0,11,30,19,6,13,4,4,1,0,61,78,59,56,0,2,0.36666666666666664,30258033
CHRIS.BIGRAS,20172018,COL,207.9,0,0,1,1,1,0,0,0,0,8,23,12,10,2,1,148,221,131,178,2,5,0,30258045.995
CHRIS.BUTLER,20172018,STL,79.83333333333334,0,0,0,0,0,0,0,0,0,2,7,3,5,0,1,84,71,81,65,4,3,0,30258031.6
CHRIS.DIDOMENICO,20172018,OTT,282.8666666666667,6,2,2,4,10,8,6,19,13,23,42,20,5,2,5,279,257,217,246,9,13,0.3157894736842105,30258058.91
CHRIS.KELLY,20172018,ANA,91.93333333333334,0,2,0,2,2,2,2,9,7,5,10,7,3,1,1,57,90,56,82,5,3,0.2222222222222222,30258037.14
CHRIS.KREIDER,20172018,NYR,905.8666666666667,16,11,10,21,37,27,25,60,35,137,236,102,40,12,21,1048,766,730,706,30,25,0.4166666666666667,30258115.52
CHRIS.KUNITZ,20172018,T.B,1156.3000000000002,13,9,7,16,29,22,7,21,14,97,165,163,38,6,20,1016,1020,949,914,38,33,0.3333333333333333,30258128.365000002
CHRIS.STEWART,20172018,CGY,76.36666666666667,1,0,2,2,3,1,1,4,3,9,15,11,3,2,0,89,74,81,71,2,5,0.25,30258034.310000002
CHRIS.STEWART,20172018,MIN,503.7166666666667,9,4,0,4,13,13,2,6,4,59,85,37,9,6,10,406,551,367,544,20,21,0.3333333333333333,30258099.09
CHRIS.TANEV,20172018,VAN,830.5833333333334,2,2,7,9,11,4,0,0,0,31,51,21,12,4,5,590,820,535,583,31,30,0,30258086.615000002
CHRIS.THORBURN,20172018,STL,351.9166666666667,1,5,0,5,6,6,7,12,5,35,55,99,11,11,14,293,345,293,342,11,15,0.5833333333333334,30258067.939999998
CHRIS.TIERNEY,20172018,S.J,1474.4,17,16,9,25,42,33,551,1082,531,134,210,40,30,18,5,1388,1509,1122,1156,36,45,0.5092421441774492,30258184.445
CHRIS.WAGNER,20172018,ANA,860.9333333333334,6,6,2,8,14,12,180,374,194,77,144,212,31,16,16,668,999,561,658,14,22,0.48128342245989303,30258112.86
CHRIS.WAGNER,20172018,NYI,188.03333333333336,1,0,0,0,1,1,50,96,46,15,30,41,7,2,1,122,225,114,178,2,6,0.5208333333333334,30258050.07
CHRIS.WIDEMAN,20172018,OTT,184.89999999999998,3,0,5,5,8,3,0,0,0,24,45,17,13,3,4,206,149,142,133,10,3,0,30258040.705
CHRISTIAN.DJOOS,20172018,WSH,1113.8666666666668,3,9,3,12,15,12,0,0,0,76,150,32,41,6,7,1075,1046,1025,1012,53,35,0,30258125.634999998
CHRISTIAN.DVORAK,20172018,ARI,1281.1333333333332,15,15,6,21,36,30,585,1139,554,150,241,92,30,9,11,1267,1248,921,993,36,47,0.5136084284460053,30258170.29
CHRISTIAN.FISCHER,20172018,ARI,1098.2166666666667,15,10,8,18,33,25,5,29,24,154,240,109,44,13,7,1209,995,848,917,28,31,0.1724137931034483,30258137.98
CHRISTIAN.FOLIN,20172018,L.A,1087.3833333333332,3,7,2,9,12,10,0,0,0,65,126,182,37,9,12,968,1086,932,935,33,38,0,30258121.39
CHRISTIAN.JAROS,20172018,OTT,15.933333333333334,0,0,0,0,0,0,0,0,0,0,2,4,2,1,0,10,12,10,11,0,0,0,15129014.36
CHRISTIAN.WOLANIN,20172018,OTT,146.46666666666667,1,0,2,2,3,1,0,0,0,14,20,5,4,0,0,149,119,133,115,5,8,0,30258037.799999997
CHRISTOPH.BERTSCHY,20172018,MIN,5.383333333333333,0,0,0,0,0,0,0,0,0,0,0,0,0,0,2,2,7,2,6,1,0,0,15129014.45
CLAUDE.GIROUX,20172018,PHI,1784.0333333333333,35,34,35,69,104,69,664,1143,479,204,388,33,115,27,11,2078,1398,1255,1122,78,57,0.5809273840769904,30258178.855
CLAYTON.KELLER,20172018,ARI,1482.5,23,23,19,42,65,46,37,78,41,212,385,7,82,24,12,1695,1308,1079,1151,46,45,0.47435897435897434,30258170.994999997
CODY.CECI,20172018,OTT,1912.2666666666667,5,8,6,14,19,13,0,0,0,142,314,162,110,6,7,1562,2278,1398,1758,57,82,0,30258212.310000002
CODY.EAKIN,20172018,VGK,1438.3666666666668,14,8,9,17,31,22,577,1096,519,125,228,125,58,9,13,1229,1476,1047,1130,37,47,0.5264598540145985,30258173.245
CODY.FRANSON,20172018,CHI,382.1666666666667,1,4,2,6,7,5,0,0,0,51,104,18,34,3,4,495,284,377,266,10,9,0,30258047.68
CODY.MCLEOD,20172018,NSH,156.81666666666666,1,0,1,1,2,1,0,0,0,11,14,54,1,10,15,104,156,104,156,5,5,0,30258047.975
CODY.MCLEOD,20172018,NYR,197.58333333333334,0,1,1,2,2,1,0,0,0,25,34,76,4,10,9,143,241,143,241,2,13,0,30258058.425
COLBY.CAVE,20172018,BOS,34.36666666666667,0,0,0,0,0,0,10,24,14,2,4,3,1,0,1,27,31,25,26,0,0,0.4166666666666667,30258030.35
COLIN.MILLER,20172018,VGK,1950.2166666666667,12,19,15,34,46,31,1,1,0,211,504,200,184,24,31,2165,1505,1517,1227,62,55,1,30258133.705
COLIN.WHITE,20172018,OTT,280.23333333333335,2,2,2,4,6,4,20,60,40,24,42,12,9,3,4,245,288,219,281,12,10,0.3333333333333333,30258061.33
COLIN.WILSON,20172018,COL,799.4666666666667,6,7,6,13,19,13,62,120,58,83,121,43,20,13,5,770,703,596,654,21,25,0.5166666666666667,30258104.96
COLTON.PARAYKO,20172018,STL,1854.3833333333334,6,17,10,27,33,23,0,0,0,212,394,120,107,16,4,1848,1673,1470,1304,50,58,0,30258151.21
COLTON.SCEVIOUR,20172018,FLA,1021.4,11,8,5,13,24,19,77,158,81,141,219,84,37,6,8,801,1173,719,807,27,28,0.4873417721518987,30258126.564999998
COLTON.SISSONS,20172018,NSH,1515.15,12,11,9,20,32,23,585,1056,471,137,219,165,42,18,22,1378,1459,988,989,36,37,0.5539772727272727,30258157.405
CONNOR.BRICKLEY,20172018,FLA,523.2,4,5,3,8,12,9,3,16,13,62,97,82,19,5,8,446,559,419,472,14,21,0.1875,30258082.645
CONNOR.BROWN,20172018,TOR,1341.3500000000001,15,11,4,15,30,26,62,159,97,125,222,27,37,11,9,1198,1344,979,991,45,44,0.389937106918239,30258143.189999998
CONNOR.CARRICK,20172018,TOR,711.3333333333334,4,3,5,8,12,7,0,0,0,55,138,42,58,3,12,711,614,663,593,29,24,0,30258079.155
CONNOR.MCDAVID,20172018,EDM,1765.9,41,38,28,66,107,79,376,909,533,275,434,28,77,36,8,2129,1655,1474,1334,80,60,0.4136413641364136,30258219.75
CONNOR.MURPHY,20172018,CHI,1244.3,2,5,6,11,13,7,0,0,0,109,237,138,85,12,14,1257,1214,1211,1049,40,46,0,30258117.32
CONOR.SHEARY,20172018,PIT,1243.8666666666668,18,7,6,13,31,25,5,13,8,161,278,35,58,17,7,1317,1079,1146,1027,48,47,0.38461538461538464,30258134.369999997
COREY.PERRY,20172018,ANA,1335.1166666666668,16,22,10,32,48,38,2,16,14,180,304,64,64,23,27,1456,1226,1012,1106,49,55,0.125,30258163.36
CORY.CONACHER,20172018,T.B,369.95,8,2,2,4,12,10,4,16,12,48,80,34,14,11,13,340,306,319,293,12,13,0.25,30258062.97
CRAIG.SMITH,20172018,NSH,1419.5166666666669,27,17,9,26,53,44,46,106,60,261,424,76,64,18,12,1763,1114,1315,1013,55,34,0.4339622641509434,30258141.845
CURTIS.LAZAR,20172018,CGY,640.7166666666667,2,7,3,10,12,9,48,121,73,64,123,130,30,10,9,605,603,585,552,16,23,0.39669421487603307,30258086.945
CURTIS.MCKENZIE,20172018,DAL,56.71666666666667,0,2,0,2,2,2,0,1,1,11,22,8,6,2,4,55,37,49,37,3,0,0,30258031.07
CURTIS.VALK,20172018,FLA,3.4166666666666665,0,0,0,0,0,0,0,3,3,0,0,1,0,0,0,4,4,4,4,0,0,0,15129014.05
DAKOTA.MERMIS,20172018,ARI,98.86666666666667,0,0,0,0,0,0,0,0,0,7,11,5,3,0,0,89,94,82,91,2,4,0,30258036.15
DALE.WEISE,20172018,PHI,501.08333333333337,4,3,1,4,8,7,1,2,1,44,70,86,14,10,10,423,505,387,488,9,16,0.5,30258085.765
DALTON.PROUT,20172018,N.J,55.949999999999996,0,0,0,0,0,0,0,0,0,5,9,7,2,1,5,56,54,55,50,3,5,0,30258032.009999998
DAMON.SEVERSON,20172018,N.J,1572.4833333333336,9,10,3,13,22,19,0,0,0,133,255,112,76,11,20,1553,1452,1310,1327,58,66,0,30258162.235
DAN.GIRARDI,20172018,T.B,1644.75,8,4,9,13,21,12,0,1,1,115,210,170,52,10,12,1399,1826,1288,1336,62,45,0,30258162.075
DAN.HAMHUIS,20172018,DAL,1615.2833333333333,3,7,11,18,21,10,0,1,1,66,161,82,64,9,14,1350,1616,1192,1202,46,60,0,30258143.515
DANICK.MARTEL,20172018,PHI,40.866666666666674,0,0,0,0,0,0,0,0,0,6,12,2,1,0,0,34,53,34,53,1,2,0,30258033.25
DANIEL.BRICKLEY,20172018,L.A,10.8,0,0,1,1,1,0,0,0,0,0,1,1,1,0,0,8,7,8,7,1,0,0,15129013.925
DANIEL.CARR,20172018,MTL,461.0833333333333,6,3,6,9,15,9,3,17,14,52,104,30,22,4,5,450,421,373,400,16,15,0.17647058823529413,30258073.009999998
DANIEL.CATENACCI,20172018,NYR,11.05,0,0,0,0,0,0,0,0,0,1,1,1,0,0,0,7,19,7,19,0,1,0,15129016.05
DANIEL.O'REGAN,20172018,S.J,189.55,0,3,1,4,4,3,56,114,58,17,24,5,4,1,1,159,193,125,177,6,9,0.49122807017543857,30258050.875
DANIEL.SEDIN,20172018,VAN,1236.9,23,20,11,31,54,43,18,40,22,189,310,38,52,10,16,1414,951,916,838,34,41,0.45,30258134.795
DANIEL.SPRONG,20172018,PIT,111.83333333333334,2,1,0,1,3,3,0,0,0,22,33,9,3,3,0,128,72,115,68,5,3,0,30258033.33
DANIEL.WINNIK,20172018,MIN,1166.5,6,10,8,18,24,16,106,238,132,88,164,31,43,10,13,839,1297,791,961,33,36,0.44537815126050423,30258142.490000002
DANNY.DEKEYSER,20172018,DET,1320.9333333333334,6,2,4,6,12,8,0,0,0,65,147,76,51,2,14,1090,1326,1008,1035,42,42,0,30258128.869999997
DANNY.O'REGAN,20172018,BUF,19.78333333333333,0,0,0,0,0,0,2,6,4,0,1,0,1,0,0,16,21,13,18,2,1,0.3333333333333333,30258028.78
DANTON.HEINEN,20172018,BOS,1267.8166666666666,17,12,19,31,48,29,10,23,13,143,255,49,62,13,9,1318,1009,1018,855,41,28,0.43478260869565216,30258118.005000003
DARNELL.NURSE,20172018,EDM,1824.6666666666665,6,7,8,15,21,13,0,0,0,194,366,161,89,18,29,1710,1857,1536,1475,68,57,0,30258170.78
DARREN.ARCHIBALD,20172018,VAN,401.2,4,2,2,4,8,6,0,1,1,28,54,80,10,5,4,272,461,248,330,8,10,0,30258067.55
DARREN.HELM,20172018,DET,1167.4666666666667,13,13,4,17,30,26,45,102,57,141,223,130,39,18,18,920,1257,843,944,33,36,0.4411764705882353,30258144.53
DAVID.BACKES,20172018,BOS,1034.3,16,14,6,20,36,30,132,259,127,182,272,168,30,13,20,1134,821,870,744,23,32,0.5096525096525096,30258123.759999998
DAVID.BOOTH,20172018,DET,195.18333333333334,4,1,0,1,5,5,4,10,6,33,49,23,8,1,5,135,200,133,195,4,9,0.4,30258053.82
DAVID.DESHARNAIS,20172018,NYR,927.0333333333333,6,8,14,22,28,14,386,701,315,55,98,22,28,10,9,822,863,621,825,26,43,0.550641940085592,30258137.34
DAVID.KAMPF,20172018,CHI,588.7833333333333,4,2,5,7,11,6,291,549,258,46,85,29,19,9,6,552,620,514,476,15,23,0.5300546448087432,30258085.155
DAVID.KREJCI,20172018,BOS,1289.4166666666667,20,23,11,34,54,43,587,1157,570,136,232,35,47,13,12,1408,1053,1058,910,50,43,0.5073465859982714,30258154.884999998
DAVID.PASTRNAK,20172018,BOS,1704.5,42,36,22,58,100,78,5,24,19,291,544,68,145,35,18,2099,1281,1404,1109,78,48,0.20833333333333334,30258159.05
DAVID.PERRON,20172018,VGK,1478.9833333333333,16,36,21,57,73,52,106,266,160,137,263,134,81,29,30,1537,1276,1065,1111,53,56,0.39849624060150374,30258171.455
DAVID.SAVARD,20172018,CBJ,1688.5333333333333,4,8,4,12,16,12,0,0,0,152,290,157,90,5,16,1519,1846,1420,1409,63,64,0,30258161.95
DAVID.SCHLEMKO,20172018,MTL,668.4000000000001,1,4,0,4,5,5,0,0,0,38,89,33,39,2,3,637,675,539,564,22,20,0,30258080.770000003
DAVID.WARSOFSKY,20172018,COL,250.79999999999998,0,2,3,5,5,2,0,0,0,20,47,1,20,2,1,219,253,212,225,9,6,0,30258048.295
DEAN.KUKAN,20172018,CBJ,135.98333333333335,0,1,3,4,4,1,0,0,0,12,18,2,4,2,1,166,129,164,125,9,7,0,30258037.145
DENIS.MALGIN,20172018,FLA,706.5,11,6,5,11,22,17,52,122,70,79,141,48,33,10,3,784,656,637,615,25,21,0.4262295081967213,30258097.555
DENNIS.RASMUSSEN,20172018,ANA,240.51666666666665,1,0,3,3,4,1,34,70,36,19,32,30,7,1,4,182,267,167,224,8,5,0.4857142857142857,30258053.945
DENNIS.SEIDENBERG,20172018,NYI,500.7166666666666,0,3,1,4,4,3,0,0,0,30,62,65,19,3,7,396,643,372,513,18,26,0,30258084.105
DEREK.DORSETT,20172018,VAN,305.6333333333333,7,2,0,2,9,9,0,3,3,26,39,38,2,12,17,190,309,168,212,7,10,0,30258059.17
DEREK.FORBORT,20172018,L.A,1621.4666666666667,1,10,6,16,17,11,0,0,0,77,193,142,78,11,24,1317,1661,1219,1192,54,44,0,30258139.26
DEREK.GRANT,20172018,ANA,768.2166666666667,12,6,5,11,23,18,332,626,294,74,122,74,17,7,4,676,801,563,657,27,22,0.5303514376996805,30258118.625
DEREK.MACKENZIE,20172018,FLA,848.1,3,8,3,11,14,11,315,605,290,86,120,124,12,8,10,606,972,555,608,16,29,0.5206611570247934,30258110.205
DEREK.RYAN,20172018,CAR,1248.4833333333333,15,12,11,23,38,27,531,940,409,135,247,52,45,9,14,1449,943,1101,835,40,50,0.5648936170212766,30258126.455
DEREK.STEPAN,20172018,ARI,1580.1,14,21,21,42,56,35,740,1550,810,208,343,52,66,8,13,1697,1529,1130,1176,47,45,0.4774193548387097,30258198.405
DERICK.BRASSARD,20172018,OTT,1063.9166666666667,18,15,5,20,38,33,433,873,440,164,272,78,54,12,15,1216,940,835,828,44,45,0.4959908361970218,30258144.215
DERICK.BRASSARD,20172018,PIT,374.6333333333333,4,4,4,8,12,8,145,302,157,54,83,34,13,4,4,388,353,315,310,11,12,0.48013245033112584,30258069.189999998
DERRICK.POULIOT,20172018,VAN,1267.4666666666667,3,8,10,18,21,11,0,0,0,78,185,79,61,6,13,1254,1098,1021,1012,35,51,0,30258126.51
DERYK.ENGELLAND,20172018,VGK,2011.7,5,13,5,18,23,18,0,0,0,133,276,169,85,11,17,1708,2309,1555,1620,68,69,0,30258189.634999998
DEVANTE.SMITH-PELLY,20172018,WSH,1204.7666666666667,13,7,3,10,23,20,22,47,25,131,244,225,52,15,18,931,1376,899,1167,33,42,0.46808510638297873,30258167.955
DEVIN.SHORE,20172018,DAL,1265.1,11,13,7,20,31,24,88,190,102,122,220,71,46,14,7,1172,1156,853,897,21,45,0.4631578947368421,30258135.735
DILLON.HEATHERINGTON,20172018,DAL,65.1,0,0,1,1,1,0,0,0,0,6,10,7,1,5,6,50,62,47,58,4,1,0,30258033.924999997
DION.PHANEUF,20172018,L.A,592.7333333333333,4,4,3,7,11,8,0,0,0,55,100,66,21,6,8,578,548,412,477,8,13,0,30258082.835
DION.PHANEUF,20172018,OTT,1073.65,3,6,7,13,16,9,0,0,0,86,169,108,53,11,15,921,1242,717,969,32,41,0,30258136.335
DMITRIJ.JASKIN,20172018,STL,946.0833333333333,6,6,5,11,17,12,2,13,11,124,212,207,42,10,7,892,781,850,765,33,29,0.15384615384615385,30258103.755000003
DMITRY.KULIKOV,20172018,WPG,1067.9333333333334,3,5,3,8,11,8,0,0,0,49,118,69,41,8,12,869,1192,810,800,34,35,0,30258104.655
DMITRY.ORLOV,20172018,WSH,2453.333333333333,12,9,16,25,37,21,0,0,0,168,321,167,104,21,14,2207,2321,1886,1897,93,82,0,30258212.96
DOMINIC.MOORE,20172018,TOR,529.9333333333334,6,2,3,5,11,8,199,367,168,47,85,42,19,6,8,429,528,417,422,18,17,0.5422343324250681,30258079.445
DOMINIC.TONINATO,20172018,COL,292.21666666666664,0,1,1,2,2,1,83,199,116,25,51,24,15,8,6,243,270,237,252,7,6,0.41708542713567837,30258057.475
DOMINIC.TURGEON,20172018,DET,46.166666666666664,0,0,0,0,0,0,7,21,14,3,5,3,1,0,1,20,57,20,36,0,2,0.3333333333333333,30258032.18
DOMINIK.SIMON,20172018,PIT,472.8833333333333,4,5,6,11,15,9,6,14,8,40,80,49,21,4,10,508,432,477,416,22,21,0.42857142857142855,30258068.98
DOUGIE.HAMILTON,20172018,CGY,1765.5333333333333,18,15,11,26,44,33,1,3,2,271,562,83,182,7,33,2226,1458,1702,1254,63,57,0.3333333333333333,30258133.585
DRAKE.CAGGIULA,20172018,EDM,907.7333333333333,13,5,2,7,20,18,11,53,42,104,181,146,45,11,15,870,910,711,800,25,39,0.20754716981132076,30258122.5
DREW.DOUGHTY,20172018,L.A,2285.3,10,24,24,48,58,34,0,1,1,211,413,133,127,17,26,2375,2085,1629,1453,71,62,0,30258170.47
DREW.STAFFORD,20172018,N.J,839.3499999999999,8,4,2,6,14,12,42,83,41,104,169,83,27,8,6,815,715,609,671,18,36,0.5060240963855421,30258106.21
DRYDEN.HUNT,20172018,FLA,116.18333333333334,0,0,0,0,0,0,1,4,3,12,23,22,3,2,1,101,106,100,105,0,5,0.25,30258038.21
DUNCAN.KEITH,20172018,CHI,1953.85,2,6,21,27,29,8,0,0,0,187,400,41,153,2,15,2102,1963,1567,1456,47,71,0,30258154.945
DUNCAN.SIEMENS,20172018,COL,233.83333333333334,1,0,1,1,2,1,0,0,0,15,34,28,13,3,6,176,293,162,185,3,11,0,30258046.705
DUSTIN.BROWN,20172018,L.A,1703.4333333333334,28,21,13,34,62,49,17,48,31,237,396,214,71,28,20,1799,1481,1189,1064,57,35,0.3541666666666667,30258156.585
DUSTIN.BYFUGLIEN,20172018,WPG,2129.7833333333333,13,19,27,46,59,32,0,0,0,248,475,206,112,15,46,2205,1903,1604,1495,68,56,0,30258185.075
DYLAN.DEMELO,20172018,S.J,1050.9833333333333,0,9,11,20,20,9,0,0,0,84,168,87,48,13,18,1027,1003,919,941,44,36,0,30258121.205
DYLAN.GAMBRELL,20172018,S.J,31.666666666666664,0,0,0,0,0,0,9,18,9,1,3,0,1,0,0,30,34,30,34,1,2,0.5,15129017.21
DYLAN.LARKIN,20172018,DET,1627.3000000000002,16,25,21,46,62,41,656,1314,658,232,421,76,86,26,27,1655,1593,1214,1195,57,62,0.4992389649923896,30258192.875
DYLAN.SIKURA,20172018,CHI,67,0,1,2,3,3,1,0,1,1,9,15,0,5,0,0,49,67,47,64,4,1,0,30258034.1
DYLAN.STROME,20172018,ARI,271.8833333333333,4,2,3,5,9,6,92,214,122,30,64,7,16,1,4,296,290,232,278,10,6,0.42990654205607476,30258064.615000002
EELI.TOLVANEN,20172018,NSH,36.33333333333333,0,0,0,0,0,0,0,0,0,3,6,2,1,0,0,24,37,21,36,0,0,0,30258031.35
ELIAS.LINDHOLM,20172018,CAR,1449.3166666666666,16,18,10,28,44,34,432,793,361,153,267,98,50,10,9,1643,1269,1112,979,39,49,0.544766708701135,30258149.58
ERIC.FEHR,20172018,S.J,279.5333333333333,4,2,0,2,6,6,96,189,93,35,53,41,9,5,3,260,297,241,239,12,6,0.5079365079365079,30258057.490000002
ERIC.FEHR,20172018,TOR,43.733333333333334,0,0,0,0,0,0,17,37,20,4,5,2,1,0,1,22,48,19,18,1,2,0.4594594594594595,30258029.630000003
ERIC.GRYBA,20172018,EDM,310.3,0,2,0,2,2,2,0,0,0,19,57,57,23,3,9,315,294,294,243,14,14,0,30258046.63
ERIC.ROBINSON,20172018,CBJ,11.35,0,0,0,0,0,0,0,0,0,2,3,0,0,0,0,11,7,11,7,1,0,0,15129013.95
ERIC.STAAL,20172018,MIN,1552.6,43,20,15,35,78,63,617,1188,571,256,419,53,104,14,21,1614,1542,1185,1213,64,57,0.5193602693602694,30258205.195
ERIK.BURGDOERFER,20172018,OTT,26.833333333333332,0,1,0,1,1,1,0,0,0,2,2,5,0,0,0,21,28,21,28,2,0,0,15129017
ERIK.GUDBRANSON,20172018,VAN,957.8833333333333,2,2,1,3,5,4,0,0,0,53,129,126,45,5,9,692,1057,638,828,21,28,0,30258116.025
ERIK.GUSTAFSSON,20172018,CHI,649.4,5,6,5,11,16,11,0,1,1,71,131,30,35,1,3,794,580,664,542,31,26,0,30258076.435000002
ERIK.HAULA,20172018,VGK,1637.3,32,14,17,31,63,46,617,1218,601,210,384,127,76,13,25,1784,1480,1247,1239,54,66,0.506568144499179,30258200.634999998
ERIK.JOHNSON,20172018,COL,1577.0333333333333,9,8,5,13,22,17,0,1,1,168,291,113,80,14,22,1324,1740,1072,1163,48,49,0,30258151.615000002
ERIK.KARLSSON,20172018,OTT,1898.5666666666666,9,28,25,53,62,37,0,0,0,196,477,58,181,18,16,2042,1750,1444,1402,61,81,0,30258164.755000003
ESA.LINDELL,20172018,DAL,1765.9333333333334,7,5,14,19,26,12,0,0,0,137,265,92,84,6,12,1737,1642,1425,1291,61,49,0,30258145.06
ETHAN.BEAR,20172018,EDM,335.3833333333333,1,2,1,3,4,3,0,0,0,20,45,14,17,2,5,333,373,273,341,7,17,0,30258064.545
EVAN.RODRIGUES,20172018,BUF,668.5999999999999,7,7,11,18,25,14,156,368,212,91,166,19,36,14,7,673,543,467,476,21,24,0.42391304347826086,30258090.855
EVANDER.KANE,20172018,BUF,1182.7,20,9,10,19,39,29,80,183,103,228,363,120,66,15,23,1246,1075,879,888,31,37,0.4371584699453552,30258140.75
EVANDER.KANE,20172018,S.J,507.96666666666664,13,3,3,6,19,16,56,126,70,114,182,62,34,10,16,580,472,401,403,20,15,0.4444444444444444,30258081.415
EVGENI.MALKIN,20172018,PIT,1651.7166666666667,46,35,25,60,106,81,498,1129,631,262,427,62,86,35,45,1997,1349,1257,1124,60,58,0.44109831709477415,30258210.945
EVGENY.DADONOV,20172018,FLA,1383.7166666666667,28,24,13,37,65,52,0,0,0,188,363,27,75,12,4,1680,1118,1115,972,65,45,0,30258139.945
EVGENY.KUZNETSOV,20172018,WSH,1959.9166666666667,39,43,31,74,113,82,566,1326,760,272,441,72,84,24,32,2232,1643,1418,1487,81,60,0.42684766214177977,30258258.655
EVGENY.SVECHNIKOV,20172018,DET,123.48333333333333,2,2,0,2,4,4,1,5,4,15,26,15,5,4,4,104,110,104,104,5,5,0.2,30258039.98
FILIP.CHLAPIK,20172018,OTT,201.45,1,3,0,3,4,4,50,110,60,21,38,19,5,3,3,183,176,161,170,4,8,0.45454545454545453,30258049.48
FILIP.CHYTIL,20172018,NYR,122.48333333333332,1,1,1,2,3,2,28,76,48,21,31,3,4,1,2,101,142,94,133,3,7,0.3684210526315789,30258046.005
FILIP.FORSBERG,20172018,NSH,1401.5166666666667,33,38,9,47,80,71,4,9,5,237,448,109,103,15,19,1655,1185,1147,1010,64,34,0.4444444444444444,30258155.835
FRANCOIS.BEAUCHEMIN,20172018,ANA,1244.6,3,7,6,13,16,10,0,0,0,97,201,114,61,3,13,1163,1402,1038,1101,43,39,0,30258137.880000003
FRANK.CORRADO,20172018,PIT,57.5,0,0,0,0,0,0,0,0,0,6,11,5,2,0,1,48,50,48,50,0,1,0,15129018.75
FRANK.VATRANO,20172018,BOS,236.61666666666667,2,0,0,0,2,2,6,14,8,42,68,34,11,7,11,233,171,215,167,5,7,0.42857142857142855,30258044.46
FRANK.VATRANO,20172018,FLA,207.73333333333332,5,3,0,3,8,8,4,5,1,30,53,17,14,3,7,212,185,192,179,12,5,0.8,30258048.09
FRANS.NIELSEN,20172018,DET,1250.3833333333332,16,11,6,17,33,27,483,1041,558,134,237,48,47,16,8,1054,1238,826,865,30,33,0.46397694524495675,30258152.729999997
FREDDIE.HAMILTON,20172018,ARI,82.58333333333334,0,0,0,0,0,0,25,56,31,7,13,19,3,1,0,81,73,75,65,2,1,0.44642857142857145,30258033.91
FREDDIE.HAMILTON,20172018,CGY,61.1,0,1,0,1,1,1,3,16,13,5,9,16,3,0,1,45,66,44,62,0,2,0.1875,30258035.22
FREDERICK.GAUDREAU,20172018,NSH,183.2166666666667,0,0,3,3,3,0,69,139,70,14,32,8,9,3,1,155,183,154,172,7,7,0.49640287769784175,30258046.615000002
FREDERIK.GAUTHIER,20172018,TOR,78.68333333333334,1,0,0,0,1,1,27,55,28,12,16,12,2,2,0,55,91,50,81,1,6,0.4909090909090909,30258038.65
FREDRIK.CLAESSON,20172018,OTT,982.0166666666667,1,3,3,6,7,4,0,0,0,60,126,158,42,6,8,787,985,735,827,26,34,0,30258110.935000002
GABRIEL.BOURQUE,20172018,COL,693.2333333333333,7,4,1,5,12,11,8,29,21,49,95,138,19,3,6,434,853,414,608,15,18,0.27586206896551724,30258103.924999997
GABRIEL.CARLSSON,20172018,CBJ,158.61666666666667,0,0,2,2,2,0,0,0,0,18,26,10,7,0,2,158,172,155,168,4,4,0,30258044.15
GABRIEL.DUMONT,20172018,OTT,198.73333333333335,1,0,1,1,2,1,11,39,28,27,43,48,8,1,1,146,220,138,176,4,4,0.28205128205128205,30258048.275
GABRIEL.DUMONT,20172018,T.B,72.55,0,0,0,0,0,0,30,64,34,11,18,14,2,3,2,63,65,59,59,1,1,0.46875,30258034.73
GABRIEL.LANDESKOG,20172018,COL,1694.1333333333334,29,20,18,38,67,49,235,475,240,201,337,166,70,30,20,1801,1604,1230,1256,65,46,0.49473684210526314,30258189.3
GARNET.HATHAWAY,20172018,CGY,680.4,4,7,2,9,13,11,1,10,9,68,120,153,22,21,27,663,647,636,555,23,22,0.1,30258086.6
GEMEL.SMITH,20172018,DAL,433.85,6,5,0,5,11,11,43,94,51,42,66,33,14,6,7,376,328,372,320,16,10,0.4574468085106383,30258064.18
GIOVANNI.FIORE,20172018,ANA,7.883333333333334,0,0,0,0,0,0,0,0,0,0,1,0,0,0,0,6,8,4,7,0,1,0,15129014.35
GREG.MCKEGG,20172018,PIT,251.66666666666666,2,2,0,2,4,4,115,233,118,21,32,19,5,2,4,193,238,180,204,6,10,0.49356223175965663,30258055.87
GREG.PATERYN,20172018,DAL,1432.2833333333333,1,8,4,12,13,9,0,0,0,100,216,155,72,10,23,1159,1471,1079,1094,41,42,0,30258134.15
GUSTAV.FORSLING,20172018,CHI,785.4,3,4,6,10,13,7,0,1,1,82,162,26,62,8,5,736,839,582,607,25,32,0,30258085.630000003
GUSTAV.NYQUIST,20172018,DET,1463.6666666666665,21,16,3,19,40,37,6,13,7,212,342,65,60,14,9,1460,1156,1103,1074,46,41,0.46153846153846156,30258153.155
GUSTAV.OLOFSSON,20172018,MIN,523.7333333333333,0,2,5,7,7,2,0,0,0,22,48,23,19,2,7,408,488,402,462,20,19,0,30258073.995
HAMPUS.LINDHOLM,20172018,ANA,1666.1,14,9,7,16,30,23,1,1,0,137,297,98,109,4,18,1590,1598,1247,1102,59,47,1,30258129.605
HAYDN.FLEURY,20172018,CAR,1125.2666666666669,0,2,5,7,7,2,0,0,0,86,181,85,71,3,7,1085,1099,1053,990,33,36,0,30258114.105
HENRIK.BORGSTROM,20172018,FLA,50.63333333333334,1,0,0,0,1,1,15,37,22,6,10,1,2,0,0,32,41,22,40,2,3,0.40540540540540543,30258033.25
HENRIK.HAAPALA,20172018,FLA,68.5,0,0,1,1,1,0,0,0,0,3,3,5,0,0,0,71,73,54,73,1,1,0,30258035.325
HENRIK.SEDIN,20172018,VAN,1274.9666666666667,3,13,34,47,50,16,438,942,504,67,125,18,29,11,15,1406,986,919,871,36,45,0.46496815286624205,30258140.28
HENRIK.ZETTERBERG,20172018,DET,1598.6,11,32,14,46,57,43,666,1374,708,180,332,49,79,10,7,1602,1280,1180,1185,51,44,0.4847161572052402,30258191.490000002
HUDSON.FASCHING,20172018,BUF,48.49999999999999,0,0,0,0,0,0,0,0,0,1,6,7,1,0,1,57,42,30,40,0,1,0,30258031.549999997
IAN.COLE,20172018,CBJ,479.04999999999995,2,5,3,8,10,7,0,0,0,31,59,38,19,5,13,435,458,411,353,19,13,0,30258061.625
IAN.COLE,20172018,PIT,828.1666666666666,3,4,4,8,11,7,0,0,0,63,141,69,48,10,23,694,837,649,628,33,32,0,30258087.9
IAN.MCCOSHEN,20172018,FLA,572.8833333333333,3,0,1,1,4,3,0,0,0,26,65,71,19,6,10,468,608,450,518,15,24,0,30258082.134999998
IIRO.PAKARINEN,20172018,EDM,407.73333333333335,2,1,0,1,3,3,1,6,5,50,98,72,22,2,3,315,400,280,323,7,6,0.16666666666666666,30258062.259999998
IVAN.BARBASHEV,20172018,STL,646.4666666666667,7,3,3,6,13,10,61,159,98,45,103,70,25,4,3,583,575,561,544,18,18,0.3836477987421384,30258087.905
IVAN.PROVOROV,20172018,PHI,2129.1833333333334,17,13,11,24,41,30,0,0,0,211,410,167,134,13,11,1862,2079,1446,1464,71,65,0,30258175.755000003
J.T..BROWN,20172018,ANA,230.48333333333332,1,0,2,2,3,1,0,0,0,26,46,35,9,3,2,214,203,202,187,3,9,0,30258045.63
J.T..BROWN,20172018,T.B,224.86666666666667,1,2,1,3,4,3,50,116,66,18,36,41,9,6,3,196,202,191,197,5,7,0.43103448275862066,30258050.985
J.T..COMPHER,20172018,COL,1176.4166666666667,13,9,3,12,25,22,301,668,367,135,242,50,58,10,11,1115,1187,768,852,18,33,0.4505988023952096,30258143.115000002
J.T..MILLER,20172018,NYR,1050.1166666666666,13,13,14,27,40,26,329,606,277,97,170,83,32,7,13,1060,989,762,893,38,37,0.5429042904290429,30258147.08
J.T..MILLER,20172018,T.B,625.4666666666667,12,10,4,14,26,22,184,345,161,77,123,77,15,6,11,695,530,481,426,21,18,0.5333333333333333,30258087.42
JACCOB.SLAVIN,20172018,CAR,1852.15,8,11,11,22,30,19,0,0,0,153,299,47,92,9,5,1758,1736,1560,1260,60,69,0,30258136.165
JACK.EICHEL,20172018,BUF,1349.5666666666666,25,23,16,39,64,48,347,836,489,246,434,52,96,23,12,1498,1136,884,919,39,47,0.4150717703349282,30258167.060000002
JACK.JOHNSON,20172018,CBJ,1505.0666666666666,3,4,4,8,11,7,0,0,0,88,175,101,50,4,12,1256,1629,1162,1258,46,55,0,30258154.04
JACK.RODEWALD,20172018,OTT,29.2,0,0,0,0,0,0,0,2,2,0,3,5,1,0,2,19,23,17,23,0,1,0,30258029.85
JACK.ROSLOVIC,20172018,WPG,485.83333333333337,5,8,4,12,17,13,20,42,22,46,90,30,17,3,2,457,429,385,405,22,12,0.47619047619047616,30258074.380000003
JACOB.DE LA ROSE,20172018,MTL,651.5,4,2,6,8,12,6,206,467,261,53,108,127,32,5,13,548,672,527,568,17,19,0.4411134903640257,30258098.49
JACOB.JOSEFSON,20172018,BUF,443.68333333333334,2,1,1,2,4,3,140,319,179,35,62,26,14,3,3,249,493,226,380,6,8,0.438871473354232,30258081.505000003
JACOB.TROUBA,20172018,WPG,1572.4166666666667,5,11,9,20,25,16,0,0,0,187,364,107,118,18,24,1544,1671,1300,1216,60,49,0,30258141.055
JADEN.SCHWARTZ,20172018,STL,1202.35,24,25,10,35,59,49,30,73,43,157,269,52,51,13,14,1464,924,1001,758,47,29,0.410958904109589,30258119.18
JAKE.DEBRUSK,20172018,BOS,1184.1666666666665,22,16,13,29,51,38,14,36,22,162,280,100,52,24,8,1277,964,1030,883,52,36,0.3888888888888889,30258128.025
JAKE.DOTCHIN,20172018,T.B,791.2666666666667,3,5,3,8,11,8,0,0,0,48,115,94,34,13,16,774,749,733,680,37,25,0,30258091.705
JAKE.GARDINER,20172018,TOR,2004.9666666666667,5,23,25,48,53,28,0,0,0,146,344,60,122,13,17,2134,1833,1622,1645,75,65,0,30258191.104999997
JAKE.GUENTZEL,20172018,PIT,1569.9666666666667,33,20,16,36,69,53,69,139,70,205,345,170,64,19,24,1735,1345,1382,1218,63,59,0.49640287769784175,30258173.700000003
JAKE.MCCABE,20172018,BUF,1033.55,3,4,6,10,13,7,0,1,1,52,106,110,37,7,10,814,991,739,794,29,39,0,30258108.22
JAKE.MUZZIN,20172018,L.A,1642.7666666666667,8,12,19,31,39,20,0,0,0,157,360,171,123,3,22,1701,1561,1282,1138,49,41,0,30258132.604999997
JAKE.VIRTANEN,20172018,VAN,898.9833333333333,10,4,6,10,20,14,7,22,15,130,245,156,47,14,19,832,831,774,799,29,37,0.3181818181818182,30258116.57
JAKOB.CHYCHRUN,20172018,ARI,1012,4,6,4,10,14,10,0,0,0,102,235,74,75,4,7,1011,965,813,892,33,29,0,30258116.54
JAKOB.SILFVERBERG,20172018,ANA,1450.1666666666665,18,12,11,23,41,30,20,56,36,198,370,59,86,13,10,1467,1512,1103,1076,41,30,0.35714285714285715,30258147.355
JAKUB.JERABEK,20172018,MTL,433.66666666666663,1,1,2,3,4,2,0,0,0,22,53,28,17,2,3,431,431,408,399,12,15,0,30258065.07
JAKUB.JERABEK,20172018,WSH,179.66666666666669,0,3,2,5,5,3,0,0,0,13,26,15,6,2,1,152,178,149,177,8,10,0,30258046.619999997
JAKUB.VORACEK,20172018,PHI,1702.2833333333333,20,42,24,66,86,62,17,37,20,240,437,28,114,30,27,1993,1407,1210,1178,56,43,0.4594594594594595,30258173.78
JAKUB.VRANA,20172018,WSH,1172.8,16,13,5,18,34,29,15,30,15,170,284,47,47,19,7,1174,1089,1064,1058,42,38,0.5,30258148.215
JAMES.NEAL,20172018,VGK,1544.0500000000002,31,15,8,23,54,46,0,1,1,264,466,93,110,32,17,1698,1327,1195,1190,55,62,0,30258167.67
JAMES.VAN RIEMSDYK,20172018,TOR,1306,39,11,8,19,58,50,0,1,1,261,452,55,76,6,16,1687,1050,1121,950,46,44,0,30258144.66
JAMIE.BENN,20172018,DAL,1625.4499999999998,36,16,27,43,79,52,381,725,344,241,391,140,87,18,23,1849,1487,1175,1113,64,40,0.5255172413793103,30258177.645
JAMIE.MCGINN,20172018,FLA,1022.5166666666667,13,11,5,16,29,24,7,26,19,117,181,120,31,15,12,1040,979,796,928,39,40,0.2692307692307692,30258140.104999997
JAMIE.OLEKSIAK,20172018,DAL,315.01666666666665,1,1,1,2,3,2,0,0,0,17,38,36,12,5,5,267,335,252,265,7,12,0,30258054.275
JAMIE.OLEKSIAK,20172018,PIT,982.5,5,3,7,10,15,8,0,0,0,76,165,177,48,13,26,876,954,804,785,42,35,0,30258104.555
JAN.RUTTA,20172018,CHI,1097.5833333333335,6,5,8,13,19,11,0,0,0,71,169,24,69,5,12,1035,1223,910,907,41,44,0,30258114
JANNE.KUOKKANEN,20172018,CAR,44.25,0,0,0,0,0,0,0,0,0,6,10,1,2,1,0,58,26,58,26,0,3,0,30258028.009999998
JANNIK.HANSEN,20172018,S.J,553.8833333333333,2,8,5,13,15,10,8,12,4,54,99,38,17,7,6,531,552,514,498,25,23,0.6666666666666666,30258079.665
JARED.BOLL,20172018,ANA,44.25,1,0,0,0,1,1,0,0,0,4,5,9,0,2,5,34,40,34,39,2,2,0,30258032.520000003
JARED.MCCANN,20172018,FLA,901.1833333333334,9,12,7,19,28,21,212,550,338,143,212,43,44,15,11,858,879,731,779,29,20,0.38545454545454544,30258133.505000003
JARED.SPURGEON,20172018,MIN,1606.2833333333333,9,13,14,27,36,22,0,1,1,113,244,67,76,5,4,1534,1590,1112,1132,37,52,0,30258145.1
JAROMIR.JAGR,20172018,CGY,287,1,4,2,6,7,5,0,0,0,32,53,1,12,1,5,317,247,253,233,12,6,0,30258051.11
JASON.CHIMERA,20172018,ANA,125.35,1,1,0,1,2,2,3,4,1,9,19,31,6,1,1,87,139,83,123,5,7,0.75,30258041.53
JASON.CHIMERA,20172018,NYI,650.5999999999999,2,4,3,7,9,6,9,25,16,69,113,107,17,7,16,529,726,515,666,17,29,0.36,30258106.505000003
JASON.DEMERS,20172018,ARI,1458.1333333333332,6,7,7,14,20,13,0,0,0,95,224,66,77,3,16,1356,1391,1152,1090,48,52,0,30258129.905
JASON.DICKINSON,20172018,DAL,230.41666666666666,0,1,1,2,2,1,69,142,73,16,34,45,12,7,7,170,175,168,173,4,6,0.4859154929577465,30258047.655
JASON.GARRISON,20172018,VGK,152.53333333333336,0,0,1,1,1,0,0,0,0,7,15,7,6,0,2,135,161,117,124,3,7,0,30258039.125
JASON.POMINVILLE,20172018,BUF,1222.05,16,10,7,17,33,26,33,57,24,168,278,39,57,7,5,1294,1056,989,957,45,50,0.5789473684210527,30258133.115000002
JASON.SPEZZA,20172018,DAL,1014.4666666666667,8,13,5,18,26,21,417,747,330,138,275,16,74,4,5,1193,812,826,751,25,28,0.5582329317269076,30258116.645
JASON.ZUCKER,20172018,MIN,1473.0333333333333,33,19,12,31,64,52,5,19,14,230,355,83,58,21,21,1544,1331,1134,1169,56,46,0.2631578947368421,30258178.509999998
JAY.BEAGLE,20172018,WSH,1261.9833333333331,9,10,11,21,30,19,757,1288,531,76,137,91,26,7,11,725,1588,643,1038,29,32,0.5877329192546584,30258179.425
JAY.BOUWMEESTER,20172018,STL,704.7833333333333,2,2,3,5,7,4,0,0,0,45,101,29,35,1,8,582,698,545,556,23,19,0,30258080.634999998
JAYCOB.MEGNA,20172018,ANA,219.88333333333333,0,1,0,1,1,1,0,0,0,7,19,6,5,2,1,186,262,171,214,6,10,0,30258049.97
JAYSON.MEGNA,20172018,VAN,4.3,0,0,0,0,0,0,0,2,2,0,0,0,0,0,0,3,3,3,3,0,0,0,15129013.9
JEAN-GABRIEL.PAGEAU,20172018,OTT,1305.6333333333332,14,6,7,13,27,20,580,1133,553,147,241,131,35,25,18,1172,1431,932,1097,35,47,0.5119152691968226,30258180.225
JEAN-SEBASTIEN.DEA,20172018,PIT,27.45,1,0,0,0,1,1,10,21,11,1,1,9,0,1,1,14,30,14,30,1,0,0.47619047619047616,30258032.009999998
JEFF.CARTER,20172018,L.A,571.45,13,6,3,9,22,19,248,461,213,96,168,37,32,6,2,619,549,371,401,16,15,0.5379609544468547,30258087.355
JEFF.PETRY,20172018,MTL,1926.6666666666665,12,20,9,29,41,32,0,1,1,178,378,167,138,11,14,2056,1874,1471,1343,54,68,0,30258157.335
JEFF.SKINNER,20172018,CAR,1370.0333333333333,24,13,10,23,47,37,26,60,34,277,490,35,107,29,17,1686,1109,1254,1023,42,60,0.43333333333333335,30258138.23
JESPER.BRATT,20172018,N.J,1144.3000000000002,13,11,10,21,34,24,7,11,4,104,179,44,36,13,9,1047,1072,760,885,29,44,0.6363636363636364,30258134.71
JESPER.FAST,20172018,NYR,1056.6,13,14,5,19,32,27,14,38,24,80,134,130,21,16,13,819,1191,762,902,39,49,0.3684210526315789,30258139.545
JESSE.PULJUJARVI,20172018,EDM,868.9,12,7,1,8,20,19,0,3,3,136,232,67,47,4,7,939,830,843,803,30,32,0,30258114.115
JIM.O'BRIEN,20172018,OTT,87.55,0,1,0,1,1,1,27,64,37,11,15,10,1,2,0,69,90,66,77,3,4,0.421875,30258037.35
JIMMY.HAYES,20172018,N.J,393.33333333333337,3,3,3,6,9,6,6,15,9,37,64,50,17,2,4,349,355,262,338,11,11,0.4,30258067.235
JIMMY.VESEY,20172018,NYR,1132.1666666666665,17,8,3,11,28,25,15,32,17,136,240,83,53,14,7,1051,1101,842,1025,38,49,0.46875,30258150.215
JOAKIM.NORDSTROM,20172018,CAR,792.8833333333334,2,4,1,5,7,6,36,77,41,97,187,107,49,7,3,654,807,621,575,16,26,0.4675324675324675,30258083.185000002
JOAKIM.RYAN,20172018,S.J,1078.25,3,2,7,9,12,5,0,0,0,82,165,34,58,2,4,1182,1057,1128,1000,37,32,0,30258114.795
JOE.HICKETTS,20172018,DET,86.73333333333333,0,1,2,3,3,1,0,0,0,2,15,9,8,3,1,83,80,61,67,5,1,0,30258033.03
JOE.MORROW,20172018,MTL,675.9666666666667,5,1,4,5,10,6,0,0,0,58,120,63,35,6,13,712,728,601,637,12,18,0,30258094.71
JOE.MORROW,20172018,WPG,360.73333333333335,2,1,2,3,5,3,0,0,0,36,82,28,27,0,3,407,338,396,311,17,10,0,30258051.6
JOE.PAVELSKI,20172018,S.J,1793.0833333333333,25,28,20,48,73,53,579,1059,480,255,430,104,78,25,23,2285,1595,1425,1314,55,51,0.546742209631728,30258201.96
JOE.THORNTON,20172018,S.J,862.2166666666667,13,11,13,24,37,24,229,440,211,75,132,32,28,14,12,1116,711,700,599,23,31,0.5204545454545455,30258104.275
JOEL.ARMIA,20172018,WPG,1135.8333333333335,14,11,6,17,31,25,8,16,8,152,268,106,67,19,12,1131,1026,888,772,33,34,0.5,30258109.61
JOEL.EDMUNDSON,20172018,STL,1431.9,7,5,5,10,17,12,0,0,0,124,265,116,78,13,23,1346,1486,1234,1145,44,49,0,30258136.555
JOEL.ERIKSSON EK,20172018,MIN,1022.3666666666668,6,4,7,11,17,10,201,478,277,134,206,139,39,15,11,819,1065,771,872,25,27,0.4205020920502092,30258136.915
JOEL.HANLEY,20172018,ARI,55.65,0,0,0,0,0,0,0,0,0,2,8,1,1,0,0,59,54,55,53,3,3,0,30258031.7
JOEL.WARD,20172018,S.J,617.45,5,4,3,7,12,9,107,231,124,40,82,35,23,7,10,511,608,464,488,14,20,0.46320346320346323,30258086.075000003
JOHAN.LARSSON,20172018,BUF,1129.0666666666666,4,5,8,13,17,9,348,639,291,86,140,117,18,13,18,758,1258,684,915,17,50,0.5446009389671361,30258149.15
JOHN.CARLSON,20172018,WSH,2622.666666666667,19,31,33,64,83,50,0,1,1,314,618,82,187,13,20,2743,2557,1808,1881,75,67,0,30258231.155
JOHN.GILMOUR,20172018,NYR,480.9333333333333,2,1,2,3,5,3,0,0,0,61,129,27,41,2,7,514,477,419,430,16,22,0,30258068.22
JOHN.HAYDEN,20172018,CHI,508.76666666666665,4,6,3,9,13,10,12,24,12,56,99,118,23,16,15,432,529,405,441,14,19,0.5,30258079.365
JOHN.KLINGBERG,20172018,DAL,1973.85,8,32,25,57,65,40,0,0,0,204,455,44,169,11,11,2275,1662,1521,1334,64,46,0,30258153.134999998
JOHN.MOORE,20172018,N.J,1712.8333333333335,7,5,6,11,18,12,0,0,0,151,283,143,73,3,24,1516,1769,1350,1405,57,60,0,30258170.03
JOHN.QUENNEVILLE,20172018,N.J,26.583333333333332,0,0,0,0,0,0,0,1,1,5,9,4,3,0,0,31,24,31,24,0,3,0,30258028.9
JOHN.TAVARES,20172018,NYI,1633.8000000000002,37,28,18,46,83,65,913,1726,813,258,448,30,105,20,13,1800,1627,1137,1209,58,60,0.5289687137891078,30258216.27
JOHNNY.BOYCHUK,20172018,NYI,1171.1333333333332,6,8,4,12,18,14,0,0,0,140,281,114,82,9,13,996,1388,895,1021,43,51,0,30258134.59
JOHNNY.GAUDREAU,20172018,CGY,1553.9,23,34,23,57,80,57,1,5,4,226,407,15,91,38,9,2016,1271,1294,1094,64,51,0.2,30258152.895
JOHNNY.ODUYA,20172018,OTT,875.9833333333333,4,2,2,4,8,6,0,0,0,58,106,49,30,4,16,746,943,698,729,30,27,0,30258101.84
JOHNNY.ODUYA,20172018,PHI,12.366666666666665,0,0,0,0,0,0,0,0,0,1,3,1,1,0,0,6,15,6,12,0,1,0,15129014.9
JON.MERRILL,20172018,VGK,672.7666666666667,1,1,1,2,3,2,0,0,0,32,74,44,22,1,16,632,620,599,573,22,16,0,30258081.735
JONAS.BRODIN,20172018,MIN,1700.65,6,9,8,17,23,15,0,0,0,86,180,36,60,10,16,1353,1791,1160,1363,67,53,0,30258170.950000003
JONATHAN.DROUIN,20172018,MTL,1355.0833333333335,13,17,16,33,46,30,447,1051,604,164,299,55,78,13,14,1612,1192,1031,998,32,46,0.4253092293054234,30258164.46
JONATHAN.ERICSSON,20172018,DET,1564.0500000000002,3,6,3,9,12,9,1,1,0,86,153,132,50,7,21,1247,1724,1160,1264,50,60,1,30258156.735
JONATHAN.HUBERDEAU,20172018,FLA,1574.9166666666667,27,26,16,42,69,53,21,44,23,204,341,41,74,23,14,1901,1344,1196,1158,56,52,0.4772727272727273,30258169.27
JONATHAN.MARCHESSAULT,20172018,VGK,1718.7333333333331,35,38,21,59,94,73,298,708,410,348,612,146,159,23,24,2077,1397,1421,1236,77,42,0.4209039548022599,30258191.675
JONATHAN.TOEWS,20172018,CHI,1457.1,20,21,10,31,51,41,900,1552,652,211,341,32,75,11,22,1884,1336,1257,982,44,43,0.5798969072164949,30258157.46
JONNY.BRODZINSKI,20172018,L.A,332.68333333333334,4,2,0,2,6,6,4,10,6,53,88,35,18,5,4,287,318,265,314,12,9,0.4,30258063.810000002
JOONAS.DONSKOI,20172018,S.J,1122.3,16,14,5,19,35,30,5,12,7,140,227,31,50,19,12,1263,956,1019,889,42,32,0.4166666666666667,30258124.165
JORDAN.EBERLE,20172018,NYI,1301.5166666666669,25,19,15,34,59,44,12,33,21,183,290,46,50,21,10,1519,1134,1191,1037,64,53,0.36363636363636365,30258146.765
JORDAN.GREENWAY,20172018,MIN,139.64999999999998,1,2,0,2,3,3,0,6,6,7,11,14,1,2,1,114,127,103,122,3,2,0,30258042.17
JORDAN.MARTINOOK,20172018,ARI,1135.4,6,6,2,8,14,12,39,107,68,112,211,128,45,16,21,939,1193,880,896,21,42,0.3644859813084112,30258127.07
JORDAN.NOLAN,20172018,BUF,676.0333333333333,4,2,2,4,8,6,1,4,3,50,94,123,29,16,21,471,633,457,614,12,23,0.25,30258100.1
JORDAN.OESTERLE,20172018,CHI,1128.3333333333335,5,6,4,10,15,11,0,0,0,98,231,62,95,7,5,1188,1060,1032,947,37,49,0,30258110.47
JORDAN.SCHMALTZ,20172018,STL,142.63333333333333,0,1,0,1,1,1,0,0,0,5,13,4,7,1,3,123,115,115,105,3,3,0,30258036.759999998
JORDAN.SCHROEDER,20172018,CBJ,157.01666666666665,1,1,0,1,2,2,39,63,24,20,31,14,3,1,2,142,158,138,157,2,6,0.6190476190476191,30258046.27
JORDAN.STAAL,20172018,CAR,1520.8166666666666,19,14,13,27,46,33,757,1338,581,160,276,181,52,14,11,1691,1309,1162,979,48,49,0.5657698056801196,30258153.994999997
JORDAN.SZWARZ,20172018,BOS,138.11666666666667,0,2,1,3,3,2,28,70,42,19,23,9,2,1,1,107,120,94,113,3,7,0.4,30258042.604999997
JORDAN.WEAL,20172018,PHI,904.4333333333334,8,9,4,13,21,17,54,117,63,103,183,19,30,7,4,873,760,708,713,26,34,0.46153846153846156,30258109.43
JORDIE.BENN,20172018,MTL,1460.7833333333333,4,5,3,8,12,9,0,0,0,106,217,90,75,6,14,1329,1628,1225,1233,31,42,0,30258148.035
JORI.LEHTERA,20172018,PHI,716.5,3,3,4,7,10,6,90,172,82,50,85,60,23,10,7,579,659,502,539,12,21,0.5232558139534884,30258088.4
JOSEPH.BLANDISI,20172018,ANA,35.03333333333334,0,0,0,0,0,0,0,0,0,4,4,2,0,0,1,25,25,24,25,2,0,0,15129016.1
JOSH.ANDERSON,20172018,CBJ,1230.95,20,6,7,13,33,26,26,63,37,197,337,123,69,24,22,1293,1131,1106,947,42,35,0.4126984126984127,30258129.905
JOSH.ARCHIBALD,20172018,ARI,470.6166666666667,5,5,1,6,11,10,25,65,40,39,79,77,20,6,7,386,494,362,414,13,15,0.38461538461538464,30258077.185000002
JOSH.ARCHIBALD,20172018,PIT,31.083333333333336,0,0,0,0,0,0,0,0,0,3,6,9,3,0,0,26,31,26,18,1,1,0,30258027.95
JOSH.BAILEY,20172018,NYI,1359.1833333333334,18,29,22,51,69,47,11,50,39,151,265,12,69,4,7,1484,1297,984,1140,45,57,0.22,30258172.38
JOSH.GORGES,20172018,BUF,507.9666666666667,0,1,1,2,2,1,0,0,0,15,35,69,10,5,7,351,519,331,410,12,16,0,30258071.125
JOSH.JOORIS,20172018,CAR,325.81666666666666,3,1,2,3,6,4,51,113,62,42,65,47,12,9,7,286,331,279,277,7,12,0.45132743362831856,30258060.380000003
JOSH.JOORIS,20172018,PIT,64.8,0,0,0,0,0,0,24,50,26,8,16,4,6,3,0,43,57,40,39,0,0,0.48,30258031.44
JOSH.LEIVO,20172018,TOR,169.08333333333334,1,1,2,3,4,2,6,9,3,25,41,2,4,4,3,175,136,114,126,5,4,0.6666666666666666,30258042.08
JOSH.MANSON,20172018,ANA,1712.7333333333333,7,13,13,26,33,20,0,1,1,123,238,192,61,14,24,1494,1777,1357,1290,72,43,0,30258155.665
JOSH.MORRISSEY,20172018,WPG,1982.5666666666666,8,6,10,16,24,14,1,2,1,128,266,166,88,12,24,1809,2112,1676,1549,73,67,0.5,30258171.21
JOSHUA.HO-SANG,20172018,NYI,314.15000000000003,2,6,3,9,11,8,2,5,3,18,35,3,9,9,3,294,272,222,247,12,15,0.4,30258056.295
JUJHAR.KHAIRA,20172018,EDM,877.7166666666667,11,4,6,10,21,15,174,383,209,73,158,128,46,12,16,741,862,665,659,23,31,0.45430809399477806,30258107.48
JULIUS.HONKA,20172018,DAL,546.4166666666667,1,2,1,3,4,3,0,0,0,42,101,20,42,4,6,567,446,465,424,15,14,0,30258063.715
JUSSI.JOKINEN,20172018,CBJ,140.25,0,0,1,1,1,0,24,51,27,13,29,5,10,2,2,153,136,117,112,1,4,0.47058823529411764,30258038.455
JUSSI.JOKINEN,20172018,EDM,172.36666666666667,0,1,0,1,1,1,15,29,14,22,43,8,8,0,0,207,140,162,116,1,4,0.5172413793103449,30258037.15
JUSSI.JOKINEN,20172018,L.A,202.45,1,2,2,4,5,3,50,83,33,19,29,3,7,2,2,173,204,154,175,5,6,0.6024096385542169,30258048.119999997
JUSSI.JOKINEN,20172018,VAN,179.5,4,3,3,6,10,7,12,24,12,19,37,5,9,2,1,165,157,142,143,8,2,0.5,30258045.075
JUSTIN.ABDELKADER,20172018,DET,1241.3166666666666,13,9,11,20,33,22,47,97,50,110,201,174,33,19,28,1194,1112,843,876,35,41,0.4845360824742268,30258132.845
JUSTIN.AUGER,20172018,L.A,15.983333333333334,0,0,0,0,0,0,0,0,0,1,3,2,1,1,0,10,21,10,21,0,1,0,30258029.560000002
JUSTIN.BAILEY,20172018,BUF,135.33333333333331,3,0,1,1,4,3,0,2,2,19,30,19,5,2,1,97,136,93,118,5,6,0,30258041.945
JUSTIN.BRAUN,20172018,S.J,1953.3666666666668,5,16,13,29,34,21,0,0,0,124,278,164,92,10,16,1534,2259,1397,1679,60,66,0,30258208.175
JUSTIN.FALK,20172018,BUF,740.0666666666666,1,0,1,1,2,1,0,0,0,36,60,121,16,6,10,507,796,486,658,14,31,0,30258101.035
JUSTIN.FAULK,20172018,CAR,1692.35,8,9,14,23,31,17,0,0,0,211,446,128,152,14,24,2034,1370,1454,1183,49,63,0,30258127.490000002
JUSTIN.HOLL,20172018,TOR,34.71666666666667,2,0,0,0,2,2,0,0,0,2,4,2,0,0,0,48,37,48,34,5,0,0,30258030.450000003
JUSTIN.KLOOS,20172018,MIN,8.65,0,0,0,0,0,0,0,0,0,0,0,0,0,0,1,9,6,9,6,0,0,0,15129014.1
JUSTIN.SCHULTZ,20172018,PIT,1492.3,5,20,10,30,35,25,0,0,0,136,288,42,80,4,8,1598,1365,1196,1222,65,42,0,30258152.04
JUSTIN.WILLIAMS,20172018,CAR,1360.2166666666667,16,20,14,34,50,36,52,116,64,198,357,79,83,12,22,1617,1082,1261,1007,47,53,0.4482758620689655,30258134.75
KAILER.YAMAMOTO,20172018,EDM,136.43333333333334,0,1,2,3,3,1,0,1,1,23,41,6,10,4,2,186,115,148,99,1,4,0,30258035.04
KALLE.KOSSILA,20172018,ANA,90.85,1,1,0,1,2,2,26,53,27,9,13,7,0,0,0,74,71,72,70,2,6,0.49056603773584906,30258036.39
KARL.ALZNER,20172018,MTL,1646.6000000000001,1,5,5,10,11,6,0,0,0,84,188,141,66,10,17,1388,1800,1314,1266,46,54,0,30258145.075
KASPERI.KAPANEN,20172018,TOR,506.16666666666663,7,1,1,2,9,8,3,9,6,60,99,67,15,4,1,433,489,406,398,11,17,0.3333333333333333,30258071.485
KEEGAN.LOWE,20172018,EDM,27.799999999999997,0,0,0,0,0,0,0,0,0,4,10,1,5,0,0,28,36,27,30,1,2,0,15129015.95
KEITH.YANDLE,20172018,FLA,2008.1,8,24,21,45,53,32,0,0,0,179,360,26,111,14,16,2135,2053,1390,1509,68,62,0,30258188.865000002
KENNY.AGOSTINO,20172018,BOS,60.21666666666667,0,0,1,1,1,0,0,1,1,11,17,4,1,1,2,66,53,34,45,1,2,0,30258032.735
KERBY.RYCHEL,20172018,MTL,44.11666666666667,1,0,1,1,2,1,2,4,2,7,9,13,0,2,1,43,51,38,50,2,4,0.5,30258033.675
KEVAN.MILLER,20172018,BOS,1570.9,2,10,7,17,19,12,0,0,0,81,192,205,67,15,22,1361,1478,1263,1121,52,49,0,30258129.075000003
KEVIN.BIEKSA,20172018,ANA,1076.2833333333333,0,4,5,9,9,4,0,0,0,67,148,117,37,16,29,867,1227,780,972,20,35,0,30258135.685000002
KEVIN.CONNAUTON,20172018,ARI,1107.8666666666668,11,2,5,7,18,13,0,0,0,101,225,116,78,7,10,1030,1261,965,1128,42,38,0,30258145.745
KEVIN.FIALA,20172018,NSH,1386.9833333333333,26,15,11,26,52,41,0,5,5,217,406,42,114,30,17,1713,1150,1358,1069,50,29,0,30258136.075000003
KEVIN.GRAVEL,20172018,L.A,244.61666666666667,0,1,1,2,2,1,0,0,0,20,46,20,15,1,1,233,250,209,219,6,8,0,30258048.035
KEVIN.HAYES,20172018,NYR,1318.8500000000001,25,10,9,19,44,35,559,1109,550,172,268,40,49,9,10,1138,1433,882,1061,45,42,0.5040577096483319,30258183.725
KEVIN.LABANC,20172018,S.J,1247.8166666666666,12,21,10,31,43,33,5,16,11,171,331,39,84,16,18,1594,1043,1083,939,37,40,0.3125,30258128.16
KEVIN.ROONEY,20172018,N.J,11.766666666666667,0,0,0,0,0,0,1,3,2,3,4,2,0,0,0,10,6,8,6,0,0,0.3333333333333333,15129014.24
KEVIN.ROY,20172018,ANA,341.2166666666667,6,1,0,1,7,7,0,9,9,26,53,11,12,4,3,280,330,241,308,10,8,0,30258064.84
KEVIN.SHATTENKIRK,20172018,NYR,932.4833333333333,5,13,5,18,23,18,0,0,0,94,188,44,65,7,21,975,816,651,740,25,36,0,30258110.895000003
KLAS.DAHLBECK,20172018,CAR,540.0333333333333,1,1,3,4,5,2,0,0,0,43,93,74,32,2,9,473,537,461,473,16,23,0,30258072.695
KORBINIAN.HOLZER,20172018,ANA,185.85,0,0,0,0,0,0,0,0,0,10,18,22,4,1,3,123,199,121,169,4,6,0,30258046.060000002
KRIS.LETANG,20172018,PIT,2303.9833333333336,10,20,31,51,61,30,0,1,1,245,498,132,165,19,34,2426,2009,1736,1448,68,89,0,30258160.365
KRIS.RUSSELL,20172018,EDM,1488.1,4,7,8,15,19,11,0,0,0,90,193,97,60,8,4,1328,1582,1206,1294,44,58,0,30258157.630000003
KRIS.VERSTEEG,20172018,CGY,316.2,3,3,2,5,8,6,46,78,32,49,88,6,27,3,3,380,264,217,239,4,5,0.5897435897435898,30258055.32
KURTIS.MACDERMID,20172018,L.A,394.5333333333333,1,1,2,3,4,2,0,0,0,19,43,77,16,8,17,323,403,303,391,11,13,0,30258071.43
KYLE.BRODZIAK,20172018,STL,1090.4833333333333,10,12,10,22,32,22,504,967,463,113,177,83,35,11,13,894,1163,830,898,38,29,0.5211995863495347,30258149.42
KYLE.CAPOBIANCO,20172018,ARI,13.55,0,0,0,0,0,0,0,0,0,0,1,3,0,0,0,10,17,10,17,1,2,0,15129015.4
KYLE.CLIFFORD,20172018,L.A,562.2,6,2,2,4,10,8,1,9,8,86,146,138,27,11,20,525,478,518,462,12,17,0.1111111111111111,30258077.799999997
KYLE.CONNOR,20172018,WPG,1586.55,34,17,16,33,67,51,2,8,6,228,354,25,68,11,9,1711,1383,1285,1288,61,52,0.25,30258184.09
KYLE.CRISCUOLO,20172018,BUF,72.13333333333333,0,0,0,0,0,0,19,41,22,5,8,13,2,0,2,56,68,54,62,0,4,0.4634146341463415,30258034.759999998
KYLE.OKPOSO,20172018,BUF,1294.1833333333334,15,16,12,28,43,31,23,50,27,161,279,70,68,20,18,1382,1049,806,928,29,48,0.46,30258143.619999997
KYLE.PALMIERI,20172018,N.J,1161.3166666666666,25,9,12,21,46,34,26,76,50,195,346,108,69,32,17,1271,1037,803,838,38,37,0.34210526315789475,30258134.71
KYLE.QUINCEY,20172018,MIN,256.96666666666664,0,0,2,2,2,0,0,0,0,11,18,21,5,3,10,165,302,155,223,5,12,0,30258053.43
KYLE.RAU,20172018,MIN,43.16666666666667,0,0,1,1,1,0,0,0,0,4,8,9,2,1,0,34,44,34,43,1,2,0,30258031.585
KYLE.TURRIS,20172018,NSH,1253.7333333333333,13,15,18,33,46,28,429,879,450,136,263,30,69,17,15,1559,1081,1228,978,52,28,0.4880546075085324,30258140.28
KYLE.TURRIS,20172018,OTT,216.61666666666667,3,3,3,6,9,6,91,149,58,26,46,2,12,2,1,218,193,143,171,4,7,0.610738255033557,30258050.535
LANCE.BOUMA,20172018,CHI,564.4666666666667,3,4,2,6,9,7,14,33,19,56,84,132,12,15,13,499,554,460,454,15,16,0.42424242424242425,30258078.21
LANDON.FERRARO,20172018,MIN,8.833333333333334,1,0,0,0,1,1,0,0,0,3,3,1,0,0,0,5,10,5,9,1,0,0,30258028.8
LARS.ELLER,20172018,WSH,1631.85,25,19,11,30,55,44,633,1273,640,210,392,122,103,27,26,1517,1622,1170,1229,44,55,0.49725058915946585,30258199.915
LAURENT.DAUPHIN,20172018,ARI,14.450000000000001,0,0,0,0,0,0,5,9,4,1,1,1,0,0,0,15,16,15,16,0,1,0.5555555555555556,15129015.35
LAWSON.CROUSE,20172018,ARI,120.33333333333333,1,0,0,0,1,1,3,11,8,13,24,29,5,3,2,108,123,102,111,2,8,0.2727272727272727,30258039.55
LEE.STEMPNIAK,20172018,CAR,461.4666666666667,3,5,1,6,9,8,3,14,11,41,88,40,25,6,2,456,382,436,356,11,18,0.21428571428571427,30258061.055
LEO.KOMAROV,20172018,TOR,1190.7833333333333,7,4,6,10,17,11,113,216,103,116,174,225,15,8,13,969,1395,803,982,25,33,0.5231481481481481,30258147.549999997
LEON.DRAISAITL,20172018,EDM,1506.6166666666668,24,33,11,44,68,57,672,1198,526,193,323,40,58,20,15,1755,1328,1178,1066,59,61,0.5609348914858097,30258177.905
LIAM.O'BRIEN,20172018,WSH,20.75,0,0,0,0,0,0,0,2,2,1,1,4,0,1,1,10,17,10,17,0,0,0,30258029.36
LIAS.ANDERSSON,20172018,NYR,83.61666666666667,1,1,0,1,2,2,19,47,28,5,10,9,2,1,0,70,96,69,89,4,3,0.40425531914893614,30258038.72
LOGAN.BROWN,20172018,OTT,32.516666666666666,0,0,1,1,1,0,4,12,8,4,7,1,1,0,0,35,25,19,21,2,2,0.3333333333333333,15129015.885
LOGAN.COUTURE,20172018,S.J,1648.0166666666664,38,21,13,34,72,59,166,354,188,236,441,47,124,11,11,2013,1574,1180,1159,48,50,0.4689265536723164,30258176.475
LOGAN.SHAW,20172018,ANA,482.8666666666667,2,3,2,5,7,5,4,17,13,59,110,45,24,6,2,363,526,328,368,12,13,0.23529411764705882,30258067.520000003
LOGAN.SHAW,20172018,MTL,372.58333333333337,2,2,2,4,6,4,88,186,98,46,88,65,22,2,4,301,425,279,351,7,13,0.4731182795698925,30258070.939999998
LOUI.ERIKSSON,20172018,VAN,813.4666666666667,10,9,3,12,22,19,6,14,8,101,148,7,23,6,2,730,782,562,580,20,24,0.42857142857142855,30258097.375
LOUIE.BELPEDIO,20172018,MIN,15.783333333333331,0,0,2,2,2,0,0,0,0,0,4,1,2,0,0,21,18,19,16,2,0,0,15129014.5
LUCA.SBISA,20172018,VGK,762,2,6,8,14,16,8,0,0,0,34,81,78,33,5,9,629,902,549,706,32,21,0,30258104.1
LUCAS.WALLMARK,20172018,CAR,104.43333333333334,1,0,0,0,1,1,38,69,31,16,26,13,5,1,1,100,90,99,85,2,6,0.5507246376811594,30258036.58
LUKAS.SEDLAK,20172018,CBJ,498.2166666666667,3,0,4,4,7,3,191,371,180,49,93,76,14,11,8,408,461,384,397,13,18,0.5148247978436657,30258076.55
LUKE.GLENDENING,20172018,DET,910.8666666666666,11,4,2,6,17,15,394,679,285,88,122,137,7,16,7,620,1084,547,685,16,33,0.5802650957290133,30258124.92
LUKE.KUNIN,20172018,MIN,246.58333333333331,2,1,1,2,4,3,24,54,30,32,54,34,14,4,4,197,227,189,202,3,7,0.4444444444444444,30258050.825
LUKE.SCHENN,20172018,ARI,1048.6000000000001,1,1,4,5,6,2,0,0,0,59,157,219,56,9,14,861,1211,817,976,21,36,0,30258127.689999998
LUKE.WITKOWSKI,20172018,DET,213.48333333333335,1,1,1,2,3,2,1,2,1,16,28,57,5,8,18,158,216,156,212,6,7,0.5,30258054.295
MACKENZIE.WEEGAR,20172018,FLA,874.3333333333333,2,2,2,4,6,4,0,0,0,58,133,108,50,12,13,840,757,778,718,25,18,0,30258092.17
MADISON.BOWEY,20172018,WSH,699.2333333333333,0,4,7,11,11,4,0,0,0,46,103,48,31,6,12,569,708,558,675,20,25,0,30258099.585
MAGNUS.PAAJARVI,20172018,OTT,492.84999999999997,6,1,1,2,8,7,1,1,0,68,93,49,16,0,2,431,565,403,471,13,21,1,30258081.665
MAGNUS.PAAJARVI,20172018,STL,490.73333333333335,2,1,1,2,4,3,1,7,6,58,82,55,13,3,3,386,529,365,424,6,9,0.14285714285714285,30258075.195
MARC-EDOUARD.VLASIC,20172018,S.J,2079.8166666666666,11,6,17,23,34,17,0,1,1,176,377,39,135,8,7,1795,2254,1465,1598,62,62,0,30258186.155
MARC.METHOT,20172018,DAL,643.8,1,0,2,2,3,1,0,0,0,25,61,77,18,3,14,526,683,492,530,20,11,0,30258080.43
MARC.STAAL,20172018,NYR,1334.3166666666666,1,4,3,7,8,5,0,0,0,68,147,76,47,7,9,994,1560,922,1190,41,39,0,30258154.145
MARCO.SCANDELLA,20172018,BUF,1911.9833333333333,5,11,5,16,21,16,0,0,0,138,306,91,104,13,16,1641,1996,1280,1425,45,63,0,30258173.755
MARCUS.FOLIGNO,20172018,MIN,890.0999999999999,9,7,8,15,24,16,9,21,12,83,132,200,22,25,29,725,784,680,769,33,33,0.42857142857142855,30258120.11
MARCUS.JOHANSSON,20172018,N.J,516.3333333333333,5,4,5,9,14,9,37,76,39,45,74,13,15,5,6,508,427,341,368,13,21,0.4868421052631579,30258071.805
MARCUS.KRUGER,20172018,CAR,520.1833333333334,1,3,1,4,5,4,159,287,128,30,58,56,12,11,10,467,489,440,370,8,14,0.554006968641115,30258067.845
MARCUS.PETTERSSON,20172018,ANA,349.8,1,1,2,3,4,2,0,0,0,20,38,18,12,2,4,307,376,272,350,11,11,0,30258065.47
MARCUS.SORENSEN,20172018,S.J,428.6,9,3,0,3,12,12,2,10,8,34,68,36,19,10,2,354,431,333,335,13,15,0.2,30258066.23
MAREK.HRIVIK,20172018,CGY,25.516666666666666,0,0,0,0,0,0,0,1,1,2,5,4,1,0,0,23,24,23,24,1,0,0,30258029.3
MARIAN.GABORIK,20172018,L.A,429.7166666666667,7,7,0,7,14,14,0,0,0,53,108,9,27,6,10,439,362,323,326,13,6,0,30258066.71
MARIAN.GABORIK,20172018,OTT,213.05,4,3,0,3,7,7,0,0,0,27,58,3,16,0,3,226,207,177,193,5,13,0,30258050.2
MARIO.KEMPE,20172018,ARI,199.58333333333334,2,1,1,2,4,3,27,70,43,20,29,20,5,2,2,150,191,139,168,4,6,0.38571428571428573,30258049.125
MARK.ALT,20172018,COL,79.30000000000001,0,0,0,0,0,0,0,0,0,6,17,6,8,0,0,71,76,70,71,0,1,0,30258033.25
MARK.ALT,20172018,PHI,107.43333333333334,0,0,0,0,0,0,0,0,0,5,12,11,4,0,1,87,105,86,95,3,3,0,30258036.3
MARK.BARBERIO,20172018,COL,928.6333333333333,3,5,4,9,12,8,0,0,0,63,144,32,45,4,17,796,1006,732,755,22,21,0,30258104.490000002
MARK.BOROWIECKI,20172018,OTT,761.4,3,3,4,7,10,6,0,1,1,66,132,226,34,18,23,646,803,612,705,26,33,0,30258104.18
MARK.GIORDANO,20172018,CGY,2032.5833333333333,13,6,18,24,37,19,0,0,0,214,491,93,182,18,28,2366,1874,1691,1235,57,53,0,30258120.68
MARK.JANKOWSKI,20172018,CGY,961.5999999999999,17,4,4,8,25,21,395,810,415,118,211,35,39,13,15,981,916,826,787,26,33,0.4876543209876543,30258133.479999997
MARK.LETESTU,20172018,CBJ,297.5,1,1,2,3,4,2,157,302,145,18,30,20,9,0,0,198,307,177,225,4,6,0.5198675496688742,30258057.93
MARK.LETESTU,20172018,EDM,785.45,8,5,4,9,17,13,347,649,302,95,162,47,39,1,4,810,746,496,490,14,29,0.5346687211093991,30258093.39
MARK.PYSYK,20172018,FLA,1538.4166666666665,3,9,4,13,16,12,0,0,0,106,205,102,61,13,10,1343,1670,1248,1293,58,66,0,30258154.98
MARK.SCHEIFELE,20172018,WPG,1603.7666666666667,37,29,14,43,80,66,747,1481,734,170,285,82,47,25,14,1766,1460,1217,1132,59,43,0.5043889264010804,30258203.03
MARK.STONE,20172018,OTT,1199.0166666666667,20,26,13,39,59,46,33,61,28,132,239,53,53,13,5,1357,1091,894,845,52,46,0.5409836065573771,30258131.125
MARK.STREIT,20172018,MTL,28.433333333333334,0,0,0,0,0,0,0,0,0,3,4,2,1,0,0,37,21,28,19,0,2,0,15129014.95
MARKO.DANO,20172018,WPG,165.3,2,0,1,1,3,2,1,2,1,22,38,26,5,0,4,150,148,144,146,5,7,0.5,30258043.415
MARKUS.GRANLUND,20172018,VAN,861.5666666666666,8,4,0,4,12,12,73,179,106,93,149,47,32,7,4,705,886,526,612,12,25,0.40782122905027934,30258103.59
MARKUS.HANNIKAINEN,20172018,CBJ,276.28333333333336,3,1,2,3,6,4,3,4,1,31,50,31,12,7,2,214,282,200,246,7,7,0.75,30258055.79
MARKUS.NUTIVAARA,20172018,CBJ,1083.4833333333333,7,10,5,15,22,17,0,0,0,88,171,49,44,5,7,1074,953,1009,918,43,29,0,30258117.475
MARTIN.FRK,20172018,DET,699.5333333333333,11,8,6,14,25,19,0,2,2,100,189,77,46,5,6,778,535,482,482,18,26,0,30258084.2
MARTIN.HANZAL,20172018,DAL,536.1333333333333,5,1,4,5,10,6,239,434,195,62,115,66,19,7,10,478,484,324,346,8,18,0.5506912442396313,30258075.03
MARTIN.MARINCIN,20172018,TOR,33.35,0,0,0,0,0,0,0,0,0,0,3,1,1,0,1,24,32,23,28,0,2,0,15129016.55
MARTIN.NECAS,20172018,CAR,6.9,0,0,0,0,0,0,0,4,4,0,0,0,0,0,0,7,9,7,9,0,0,0,15129014.7
MATHEW.BARZAL,20172018,NYI,1456.7833333333333,22,35,28,63,85,57,355,834,479,170,260,21,53,40,16,1771,1204,1199,1094,63,50,0.42565947242206237,30258182.200000003
MATHIEU.PERREAULT,20172018,WPG,1128.9333333333334,18,9,13,22,40,27,35,65,30,150,251,131,50,26,22,1395,865,1042,792,36,29,0.5384615384615384,30258111.535
MATS.ZUCCARELLO,20172018,NYR,1513.9,16,23,13,36,52,39,21,80,59,177,290,62,52,19,18,1524,1435,1004,1171,44,48,0.2625,30258177.355
MATT.BARTKOWSKI,20172018,CGY,240.2166666666667,0,1,2,3,3,1,0,0,0,21,37,31,11,0,3,203,256,194,228,6,10,0,30258051.15
MATT.BELESKEY,20172018,BOS,152,0,0,0,0,0,0,2,7,5,17,36,27,7,5,4,133,124,119,111,1,8,0.2857142857142857,30258038.229999997
MATT.BELESKEY,20172018,NYR,12.616666666666667,0,0,0,0,0,0,0,2,2,0,2,7,0,1,2,7,15,7,15,0,1,0,15129015.81
MATT.BENNING,20172018,EDM,1260.3333333333335,6,6,8,14,20,12,0,0,0,110,236,149,73,15,20,1331,1199,1149,1081,50,45,0,30258130
MATT.CALVERT,20172018,CBJ,1026.5333333333333,12,9,7,16,28,21,15,44,29,123,194,76,32,8,12,880,1054,798,830,33,41,0.3409090909090909,30258125.055
MATT.CULLEN,20172018,MIN,996,12,9,3,12,24,21,369,737,368,108,177,17,35,10,11,675,1100,650,951,32,37,0.5006784260515604,30258162.535
MATT.DUCHENE,20172018,COL,220.75,4,5,1,6,10,9,113,200,87,23,40,6,13,4,2,229,204,162,166,11,10,0.565,30258050.535
MATT.DUCHENE,20172018,OTT,1282.5,23,17,9,26,49,40,604,1154,550,167,288,54,52,16,7,1355,1183,945,1046,40,50,0.5233968804159446,30258179.995
MATT.DUMBA,20172018,MIN,2087.6833333333334,15,18,17,35,50,33,2,2,0,185,392,149,127,13,20,1892,2046,1436,1623,79,63,1,30258201.784999996
MATT.GRZELCYK,20172018,BOS,1196.4166666666667,3,4,7,11,14,7,0,0,0,90,197,57,61,5,13,1155,938,1020,860,47,23,0,30258100.125
MATT.HENDRICKS,20172018,WPG,609.55,5,7,1,8,13,12,230,463,233,58,91,128,16,7,14,461,735,432,438,19,19,0.49676025917926564,30258087.695
MATT.HUNWICK,20172018,PIT,735.45,4,3,2,5,9,7,0,0,0,52,104,51,33,9,9,618,767,583,619,25,32,0,30258090.64
MATT.IRWIN,20172018,NSH,799.7666666666667,2,2,3,5,7,4,0,0,0,68,163,99,61,4,5,708,746,691,687,27,25,0,30258089.215
MATT.MARTIN,20172018,TOR,399.41666666666663,3,6,3,9,12,9,12,16,4,46,79,147,15,11,16,358,372,353,361,18,19,0.75,30258069.065
MATT.MOULSON,20172018,BUF,144.01666666666668,0,0,0,0,0,0,0,0,0,13,28,8,5,0,1,139,122,92,108,0,8,0,30258038.65
MATT.NIETO,20172018,COL,1195.3333333333333,15,7,7,14,29,22,4,13,9,90,154,35,34,11,8,910,1426,845,1019,36,35,0.3076923076923077,30258148.195
MATT.NISKANEN,20172018,WSH,2122.166666666667,8,17,13,30,38,25,0,0,0,152,353,159,126,8,22,1762,2184,1582,1650,85,65,0,30258190.655
MATT.READ,20172018,PHI,282.9,2,1,0,1,3,3,4,13,9,20,39,34,10,1,2,214,276,198,192,4,7,0.3076923076923077,30258047.47
MATT.STAJAN,20172018,CGY,743.75,4,4,4,8,12,8,248,482,234,65,99,74,13,8,12,653,772,616,564,19,11,0.5145228215767634,30258095.65
MATT.TENNYSON,20172018,BUF,269.5833333333333,0,0,0,0,0,0,0,0,0,25,47,13,16,1,4,242,244,197,225,9,17,0,30258049.009999998
MATTHEW.HIGHMORE,20172018,CHI,157.98333333333335,2,0,0,0,2,2,1,5,4,27,43,9,9,2,0,157,162,151,137,3,8,0.2,30258041.16
MATTHEW.PECA,20172018,T.B,136.7,2,2,2,4,6,4,78,137,59,17,22,11,3,4,0,100,157,94,123,10,4,0.5693430656934306,30258044.51
MATTHEW.TKACHUK,20172018,CGY,1173.0500000000002,24,14,11,25,49,38,7,17,10,188,309,80,39,41,24,1521,900,1076,805,36,39,0.4117647058823529,30258121.865000002
MATTIAS.EKHOLM,20172018,NSH,2213.95,11,19,12,31,42,30,0,1,1,155,335,90,108,22,29,2220,2050,1811,1504,78,65,0,30258165.57
MATTIAS.JANMARK,20172018,DAL,1370.9666666666667,18,11,4,15,33,29,71,180,109,135,227,15,51,12,12,1285,1259,979,1002,28,44,0.39444444444444443,30258148.86
MAX.DOMI,20172018,ARI,1369.3,9,22,14,36,45,31,185,412,227,149,314,49,104,26,31,1529,1278,1034,1137,46,51,0.44902912621359226,30258164.66
MAX.MCCORMICK,20172018,OTT,250.53333333333333,3,1,1,2,5,4,9,21,12,33,50,56,11,9,10,201,239,194,227,7,12,0.42857142857142855,30258055.125
MAX.PACIORETTY,20172018,MTL,1216.85,17,10,8,18,35,27,7,20,13,212,391,118,98,10,15,1426,1123,887,773,30,41,0.35,30258110.93
MAXIM.MAMIN,20172018,FLA,273.5333333333333,3,0,1,1,4,3,0,1,1,28,47,51,10,2,2,234,253,224,243,7,5,0,30258053.645
MELKER.KARLSSON,20172018,S.J,1063.6833333333334,8,6,8,14,22,14,12,21,9,90,166,102,33,13,13,873,1165,814,942,27,35,0.5714285714285714,30258135.01
MICHAEL.AMADIO,20172018,L.A,357.26666666666665,4,1,4,5,9,5,75,175,100,29,59,18,15,3,4,327,308,264,290,8,9,0.42857142857142855,30258063.83
MICHAEL.BOURNIVAL,20172018,T.B,46.733333333333334,0,0,0,0,0,0,0,0,0,5,7,8,0,0,0,34,54,34,52,0,0,0,30258033.35
MICHAEL.CHAPUT,20172018,VAN,88.08333333333333,0,0,0,0,0,0,43,74,31,2,8,16,1,2,1,58,82,55,70,2,5,0.581081081081081,30258035.689999998
MICHAEL.DAL COLLE,20172018,NYI,53.41666666666667,0,0,0,0,0,0,0,0,0,1,2,1,0,0,0,41,50,36,50,1,1,0,30258032.6
MICHAEL.DEL ZOTTO,20172018,VAN,1705.9333333333334,6,7,9,16,22,13,0,0,0,128,243,243,69,13,24,1435,1784,1204,1413,54,63,0,30258179.155
MICHAEL.FROLIK,20172018,CGY,1184.5833333333335,10,7,8,15,25,17,33,72,39,167,281,48,51,11,13,1250,1142,1112,840,30,47,0.4583333333333333,30258108.73
MICHAEL.GRABNER,20172018,N.J,328.9,2,1,2,3,5,3,7,12,5,38,61,16,11,5,2,255,368,226,256,9,10,0.5833333333333334,30258055.63
MICHAEL.GRABNER,20172018,NYR,877.7166666666667,25,4,2,6,31,29,3,12,9,131,202,52,34,8,6,711,1012,635,775,30,23,0.25,30258129.700000003
MICHAEL.MCCARRON,20172018,MTL,157.71666666666667,0,1,0,1,1,1,60,123,63,15,27,61,7,6,13,116,144,112,142,5,6,0.4878048780487805,30258046.759999998
MICHAEL.RAFFL,20172018,PHI,1083.4499999999998,13,4,6,10,23,17,41,71,30,97,159,116,23,16,12,893,991,834,840,35,37,0.5774647887323944,30258122.25
MICHAEL.STONE,20172018,CGY,1373.2333333333333,4,4,1,5,9,8,0,0,0,99,251,105,91,9,14,1219,1471,1090,1105,36,46,0,30258131.415
MICHAL.KEMPNY,20172018,CHI,475.04999999999995,1,4,2,6,7,5,0,0,0,50,98,31,38,3,6,513,467,479,411,22,11,0,30258062.18
MICHAL.KEMPNY,20172018,WSH,772.8833333333332,4,2,1,3,7,6,0,0,0,70,137,56,41,9,11,735,796,709,773,25,24,0,30258106.815
MICHEAL.FERLAND,20172018,CGY,1156.4833333333331,21,16,4,20,41,37,22,57,35,142,263,171,44,12,8,1333,1013,1034,956,51,40,0.38596491228070173,30258138.2
MICHEAL.HALEY,20172018,FLA,584.6666666666667,3,2,4,6,9,5,19,40,21,55,83,124,10,31,49,470,549,463,540,14,28,0.475,30258096.02
MIIKKA.SALOMAKI,20172018,NSH,679.7333333333333,2,4,2,6,8,6,5,13,8,62,128,131,29,11,19,593,577,581,536,20,31,0.38461538461538464,30258081.16
MIKA.ZIBANEJAD,20172018,NYR,1293.2666666666667,27,10,10,20,47,37,654,1286,632,212,367,92,69,17,7,1464,1150,960,908,33,49,0.5085536547433903,30258161.93
MIKAEL.BACKLUND,20172018,CGY,1559.2833333333333,14,19,12,31,45,33,704,1409,705,214,372,54,73,8,28,1700,1462,1248,975,36,56,0.49964513839602553,30258158.84
MIKAEL.GRANLUND,20172018,MIN,1538.0166666666667,22,28,20,48,70,50,71,128,57,199,347,52,68,15,9,1512,1429,1019,1030,51,39,0.5546875,30258158.59
MIKE.BLUNDEN,20172018,OTT,6.516666666666667,0,0,0,0,0,0,0,0,0,1,1,6,0,0,0,5,6,5,6,0,0,0,15129014.2
MIKE.CAMMALLERI,20172018,EDM,719.4000000000001,4,10,7,17,21,14,62,113,51,104,177,33,42,2,8,698,677,574,625,22,28,0.5486725663716814,30258099.625
MIKE.CAMMALLERI,20172018,L.A,189.53333333333333,3,2,2,4,7,5,15,31,16,24,42,10,6,0,2,202,172,127,163,7,5,0.4838709677419355,30258048.65
MIKE.FISHER,20172018,NSH,332.4,3,2,0,2,5,5,185,304,119,27,55,55,13,1,4,251,310,235,245,10,12,0.6085526315789473,30258057.810000002
MIKE.GREEN,20172018,DET,1457.4166666666667,8,7,15,22,30,15,0,0,0,132,279,78,95,5,18,1428,1292,1085,1179,41,47,0,30258149.125
MIKE.HOFFMAN,20172018,OTT,1509.3666666666668,22,19,15,34,56,41,22,40,18,257,449,31,111,19,17,1658,1345,1124,1214,48,60,0.55,30258172.295
MIKE.LIAMBAS,20172018,ANA,37.016666666666666,0,1,0,1,1,1,0,2,2,3,3,15,0,3,6,20,39,20,39,1,1,0,30258033.43
MIKE.MATHESON,20172018,FLA,1728.3166666666666,10,9,8,17,27,19,0,0,0,167,320,53,83,20,26,1642,1787,1367,1414,60,64,0,30258174.3
MIKE.REILLY,20172018,MIN,469.2166666666667,2,6,2,8,10,8,0,0,0,36,71,24,16,2,10,397,444,298,418,12,16,0,30258078.77
MIKE.REILLY,20172018,MTL,383.65,0,3,5,8,8,3,0,0,0,29,54,17,17,1,4,392,386,310,356,16,15,0,30258064.035
MIKHAIL.SERGACHEV,20172018,T.B,1421.9666666666667,11,16,17,33,44,27,0,0,0,167,382,108,123,8,22,1675,1136,1314,1041,60,40,0,30258119.505
MIKKEL.BOEDKER,20172018,S.J,1129.1333333333332,16,16,11,27,43,32,5,19,14,137,228,52,43,20,9,1117,1122,923,1063,42,42,0.2631578947368421,30258157.425
MIKKO.KOIVU,20172018,MIN,1606.65,14,19,16,35,49,33,853,1670,817,183,307,52,55,6,24,1483,1455,967,1018,38,36,0.5107784431137724,30258183.98
MIKKO.RANTANEN,20172018,COL,1653.4833333333331,29,31,28,59,88,60,60,119,59,188,323,38,65,25,17,1893,1424,1252,1237,62,49,0.5042016806722689,30258184.9
MILAN.LUCIC,20172018,EDM,1308.7666666666667,10,11,14,25,35,21,29,52,23,147,282,254,56,6,25,1500,1176,1134,1066,46,50,0.5576923076923077,30258141.020000003
MILES.WOOD,20172018,N.J,995.65,19,5,8,13,32,24,2,3,1,176,272,79,37,30,34,993,933,879,890,36,39,0.6666666666666666,30258136.48
MIRCO.MUELLER,20172018,N.J,518.3833333333333,0,1,3,4,4,1,0,0,0,22,52,22,23,4,2,393,521,357,402,17,17,0,30258065.665
MITCH.MARNER,20172018,TOR,1463.4666666666667,24,32,20,52,76,56,52,100,48,211,428,37,128,19,16,1731,1242,1171,1109,53,46,0.52,30258158.57
MITCH.REINKE,20172018,STL,13.083333333333334,0,0,0,0,0,0,0,0,0,1,3,0,1,0,0,13,9,13,9,0,0,0,15129014.1
MORGAN.KLIMCHUK,20172018,CGY,7.416666666666666,0,0,0,0,0,0,0,0,0,0,1,1,0,0,0,7,5,7,5,0,0,0,15129013.9
MORGAN.RIELLY,20172018,TOR,1786.4333333333334,6,25,24,49,55,31,0,2,2,191,403,57,135,10,9,1994,1728,1419,1431,68,64,0,30258171.1
NAIL.YAKUPOV,20172018,COL,628.6166666666666,9,5,2,7,16,14,0,2,2,94,163,60,32,12,14,593,510,437,470,24,16,0,30258083.47
NATE.PROSSER,20172018,MIN,821.9833333333333,3,4,2,6,9,7,0,0,0,29,80,60,30,11,11,580,908,552,769,25,19,0,30258114.16
NATE.PROSSER,20172018,STL,15.383333333333333,0,0,0,0,0,0,0,0,0,0,0,4,0,0,0,14,13,14,13,0,0,0,15129014.75
NATE.SCHMIDT,20172018,VGK,2156.9666666666667,8,15,17,32,40,23,0,1,1,139,338,57,123,12,10,2164,2131,1628,1604,76,55,0,30258180.095
NATE.THOMPSON,20172018,L.A,389.18333333333334,1,4,1,5,6,5,164,276,112,25,56,58,16,2,5,271,417,253,324,6,8,0.5942028985507246,30258068.605
NATE.THOMPSON,20172018,OTT,536.8833333333333,4,3,4,7,11,7,224,398,174,28,54,79,16,2,5,348,624,314,404,14,19,0.5628140703517588,30258080.78
NATHAN.BEAULIEU,20172018,BUF,940.8833333333332,1,6,2,8,9,7,0,0,0,67,148,45,45,11,12,865,891,745,814,28,38,0,30258110.310000002
NATHAN.GERBE,20172018,CBJ,17.200000000000003,0,0,0,0,0,0,0,0,0,1,1,4,0,0,0,12,13,12,13,0,1,0,30258028.4
NATHAN.MACKINNON,20172018,COL,1602.7833333333333,42,40,21,61,103,82,517,1242,725,312,543,42,116,24,21,1817,1422,1233,1211,68,54,0.41626409017713367,30258222.445
NATHAN.WALKER,20172018,EDM,20.666666666666668,0,0,0,0,0,0,0,0,0,2,5,5,2,1,1,17,29,17,27,0,0,0,30258030.16
NATHAN.WALKER,20172018,WSH,72.83333333333333,1,1,0,1,2,2,0,0,0,5,8,16,3,2,2,55,50,51,50,4,2,0,30258032.72
NAZEM.KADRI,20172018,TOR,1400.3666666666666,33,14,11,25,58,47,562,1133,571,220,380,108,82,29,21,1620,1340,1116,1196,47,45,0.4960282436010591,30258200.245
NEAL.PIONK,20172018,NYR,626.85,1,6,5,11,12,7,0,0,0,54,104,49,35,2,6,495,717,400,555,18,19,0,30258090.295
NIC.DOWD,20172018,L.A,127.29999999999998,0,1,0,1,1,1,27,52,25,11,18,24,6,1,6,93,106,93,106,1,4,0.5192307692307693,30258040.189999998
NIC.DOWD,20172018,VAN,462.7166666666667,3,0,0,0,3,3,175,344,169,40,71,57,12,3,7,371,500,348,399,9,17,0.5087209302325582,30258078.18
NIC.PETAN,20172018,WPG,126.2,2,0,0,0,2,2,12,25,13,16,27,4,8,0,3,99,95,85,94,4,4,0.48,30258038.23
NICHOLAS.BAPTISTE,20172018,BUF,328.9,4,1,1,2,6,5,2,9,7,45,70,16,12,4,7,265,306,227,274,8,11,0.2222222222222222,30258060.845
NICHOLAS.MERKLEY,20172018,ARI,13.5,0,0,0,0,0,0,0,0,0,0,1,0,0,1,1,10,12,4,12,0,0,0,15129015.26
NICK.BJUGSTAD,20172018,FLA,1240,19,20,8,28,47,39,151,297,146,229,359,95,49,17,19,1409,1117,1121,1037,58,48,0.5084175084175084,30258155.61
NICK.BONINO,20172018,NSH,1328.45,14,8,8,16,30,22,614,1133,519,109,182,27,29,14,13,1120,1428,915,1021,42,38,0.5419240953221536,30258165.9
NICK.COUSINS,20172018,ARI,912.6166666666668,12,2,5,7,19,14,84,224,140,119,179,117,33,29,14,873,863,799,815,27,35,0.375,30258124.674999997
NICK.FOLIGNO,20172018,CBJ,1446.15,16,8,11,19,35,24,384,825,441,144,221,200,39,16,21,1467,1298,1055,1011,45,42,0.46545454545454545,30258158.445
NICK.HOLDEN,20172018,BOS,368.31666666666666,1,3,1,4,5,4,0,0,0,26,64,24,19,2,0,352,313,282,254,10,13,0,30258050.395
NICK.HOLDEN,20172018,NYR,1043.9833333333333,3,3,5,8,11,6,0,0,0,54,129,114,52,2,7,821,1157,781,927,42,45,0,30258120.795
NICK.JENSEN,20172018,DET,1316.7,0,7,6,13,13,7,0,0,0,107,197,71,61,11,12,1102,1243,1024,966,40,48,0,30258117.11
NICK.LAPPIN,20172018,N.J,58.56666666666667,1,0,0,0,1,1,0,0,0,7,11,8,2,1,2,43,74,43,74,2,0,0,30258036.71
NICK.LEDDY,20172018,NYI,1792.6,10,15,15,30,40,25,0,0,0,153,311,95,101,8,9,1833,1739,1275,1459,55,80,0,30258184.155
NICK.PAUL,20172018,OTT,86.86666666666667,1,0,0,0,1,1,1,4,3,11,21,16,6,0,0,74,63,67,55,1,4,0.25,30258032.240000002
NICK.RITCHIE,20172018,ANA,1048.6999999999998,10,6,11,17,27,16,6,17,11,125,240,230,43,13,34,1059,1076,967,991,36,32,0.35294117647058826,30258138.545
NICK.SCHMALTZ,20172018,CHI,1422.0333333333333,21,14,16,30,51,35,321,801,480,118,218,13,60,13,9,1518,1333,1094,1026,48,45,0.40074906367041196,30258161.77
NICK.SEELER,20172018,MIN,406.7166666666667,0,3,3,6,6,3,0,0,0,21,47,24,16,6,11,344,414,337,368,17,9,0,30258065.034999996
NICK.SHORE,20172018,CGY,136.25,1,1,1,2,3,2,52,116,64,16,31,9,4,0,2,138,122,112,95,1,2,0.4482758620689655,30258040.005
NICK.SHORE,20172018,L.A,713.75,4,5,6,11,15,9,278,578,300,53,99,39,17,5,6,635,710,585,529,20,25,0.4809688581314879,30258093.37
NICK.SHORE,20172018,OTT,56.78333333333334,0,0,1,1,1,0,22,44,22,6,8,6,1,0,0,56,43,52,40,2,1,0.5,30258031.205
NICKLAS.BACKSTROM,20172018,WSH,1985.2166666666667,25,39,26,65,90,64,864,1680,816,200,358,53,69,20,22,2230,1707,1406,1358,59,43,0.5142857142857142,30258227.759999998
NICO.HISCHIER,20172018,N.J,1420.1,21,21,11,32,53,42,458,1051,593,185,307,65,58,36,13,1456,1306,1101,1115,68,56,0.4357754519505233,30258184.005
NICOLAS.DESLAURIERS,20172018,MTL,672.5,10,2,2,4,14,12,4,6,2,77,127,238,29,12,14,533,709,521,594,20,14,0.6666666666666666,30258097.08
NICOLAS.KERDILES,20172018,ANA,7.5,0,0,0,0,0,0,0,1,1,0,1,1,1,0,0,5,11,5,9,0,0,0,30258028
NICOLAS.ROY,20172018,CAR,10.766666666666666,0,0,0,0,0,0,6,10,4,1,2,2,1,2,0,10,12,10,12,0,1,0.6,15129014.86
NIKITA.KUCHEROV,20172018,T.B,1890.25,46,43,28,71,117,89,3,5,2,340,649,45,142,34,25,2327,1541,1551,1381,78,63,0.6,30258202.71
NIKITA.SCHERBAK,20172018,MTL,347.8166666666667,4,1,1,2,6,5,2,2,0,39,85,18,31,4,6,343,317,260,296,6,12,1,30258059.145
NIKITA.SOSHNIKOV,20172018,STL,133.95,1,1,0,1,2,2,0,0,0,17,26,19,4,4,2,95,121,91,112,4,4,0,30258040.490000002
NIKITA.SOSHNIKOV,20172018,TOR,31.316666666666666,0,0,0,0,0,0,0,1,1,0,1,5,0,1,0,11,49,10,44,0,2,0,30258033.16
NIKITA.ZADOROV,20172018,COL,1623.9166666666665,8,5,6,11,19,13,0,0,0,103,257,306,100,18,49,1409,1832,1315,1455,63,60,0,30258176.53
NIKITA.ZAITSEV,20172018,TOR,1478.65,5,5,5,10,15,10,0,0,0,63,185,138,89,5,15,1245,1670,1141,1239,54,52,0,30258146.425
NIKLAS.HJALMARSSON,20172018,ARI,993.7166666666667,1,4,4,8,9,5,0,0,0,32,84,16,35,8,9,805,1088,738,792,24,30,0,30258106.28
NIKLAS.KRONWALL,20172018,DET,1463.1666666666665,4,8,13,21,25,12,0,0,0,76,151,81,54,5,16,1373,1223,1055,1088,35,44,0,30258138.525
NIKOLAJ.EHLERS,20172018,WPG,1556.55,29,25,12,37,66,54,6,13,7,257,487,46,129,31,14,1829,1318,1417,1203,61,52,0.46153846153846156,30258158.6
NIKOLAY.GOLDOBIN,20172018,VAN,468.66666666666674,8,5,1,6,14,13,1,2,1,50,95,12,16,2,4,473,444,403,427,17,29,0.5,30258077.535
NIKOLAY.KULEMIN,20172018,NYI,155.18333333333334,1,1,1,2,3,2,4,10,6,7,13,16,4,5,0,107,171,101,118,3,4,0.4,30258040.585
NINO.NIEDERREITER,20172018,MIN,1024.9333333333334,18,10,3,13,31,28,18,39,21,142,240,70,43,16,18,1102,828,824,752,38,26,0.46153846153846156,30258115.605
NOAH.HANIFIN,20172018,CAR,1489.9499999999998,10,11,11,22,32,21,0,0,0,164,339,81,123,6,10,1724,1172,1383,1090,48,58,0,30258119.335
NOAH.JUULSEN,20172018,MTL,446,1,1,1,2,3,2,0,0,0,33,69,58,29,3,2,349,486,320,344,9,10,0,30258060.205
NOEL.ACCIARI,20172018,BOS,907.8333333333333,11,1,1,2,13,12,54,123,69,72,127,190,24,11,4,678,930,647,744,19,29,0.43902439024390244,30258115.345
NOLAN.PATRICK,20172018,PHI,1101.6499999999999,14,11,7,18,32,25,401,796,395,143,228,54,41,18,14,1154,1011,871,909,32,31,0.5037688442211056,30258150.395
OLIVER.BJORKSTRAND,20172018,CBJ,1237.85,12,18,13,31,43,30,1,8,7,166,304,68,66,12,5,1283,1066,1054,990,43,38,0.125,30258135.235
OLIVER.EKMAN-LARSSON,20172018,ARI,1939.9666666666667,14,13,11,24,38,27,0,1,1,200,438,160,162,22,23,2042,1711,1391,1338,53,64,0,30258157.395
OLLI.MAATTA,20172018,PIT,1775.6999999999998,7,11,12,23,30,18,0,0,0,175,360,151,126,8,16,1732,1720,1500,1406,59,54,0,30258158.23
ONDREJ.KASE,20172018,ANA,974.9666666666667,20,12,4,16,36,32,7,30,23,154,254,31,54,18,8,1032,835,859,775,36,22,0.23333333333333334,30258117.86
ONDREJ.PALAT,20172018,T.B,1220.85,17,15,13,28,45,32,7,34,27,140,244,116,51,20,4,1277,1126,954,906,54,36,0.20588235294117646,30258129.655
OSCAR.FANTENBERG,20172018,L.A,485.43333333333334,2,3,5,8,10,5,0,0,0,37,87,62,27,4,5,470,422,349,384,14,12,0,30258067.064999998
OSCAR.KLEFBOM,20172018,EDM,1506.6999999999998,5,7,10,17,22,12,0,0,0,203,399,49,123,7,8,1652,1420,1162,1084,44,54,0,30258125.97
OSCAR.LINDBERG,20172018,VGK,775.6833333333334,9,1,2,3,12,10,99,188,89,85,149,81,30,8,7,695,753,648,643,18,23,0.526595744680851,30258099.689999998
OSKAR.LINDBLOM,20172018,PHI,377.98333333333335,2,2,2,4,6,4,0,0,0,39,72,36,18,1,4,394,325,350,310,12,8,0,30258056.71
OSKAR.SUNDQVIST,20172018,STL,439.90000000000003,1,3,1,4,5,4,144,323,179,41,74,47,11,9,7,344,412,315,341,8,13,0.4458204334365325,30258072.675
OWEN.TIPPETT,20172018,FLA,77.81666666666666,1,0,0,0,1,1,0,2,2,17,31,3,10,0,0,91,76,57,72,1,6,0,30258034.950000003
P.K..SUBBAN,20172018,NSH,2323.0166666666664,20,30,18,48,68,50,1,3,2,245,499,140,153,28,35,2395,2105,1702,1550,78,61,0.3333333333333333,30258189.47
PATRIC.HORNQVIST,20172018,PIT,1395.4499999999998,34,17,8,25,59,51,19,36,17,282,425,163,57,29,31,1737,1128,1128,989,51,50,0.5277777777777778,30258156.2
PATRICE.BERGERON,20172018,BOS,1467.2166666666667,36,24,19,43,79,60,935,1636,701,270,471,61,97,8,14,1733,1181,1137,811,55,35,0.5715158924205379,30258150.205
PATRICK.EAVES,20172018,ANA,32.916666666666664,1,0,0,0,1,1,0,1,1,3,8,5,2,1,0,32,36,15,35,1,1,0,30258031.96
PATRICK.KANE,20172018,CHI,1655.3,27,31,18,49,76,58,7,18,11,285,515,18,146,20,16,1983,1410,1345,1261,56,68,0.3888888888888889,30258173.23
PATRICK.MARLEAU,20172018,TOR,1508.3000000000002,31,11,10,21,52,42,167,321,154,218,348,104,55,6,10,1579,1399,1168,1216,56,55,0.5202492211838006,30258181.34
PATRICK.MAROON,20172018,EDM,971.6333333333333,14,8,8,16,30,22,9,19,10,121,212,119,33,13,20,1190,872,932,834,38,34,0.47368421052631576,30258119.240000002
PATRICK.MAROON,20172018,N.J,332.0666666666667,4,7,2,9,13,11,3,12,9,34,52,42,6,5,5,375,267,216,249,11,15,0.25,30258060.72
PATRICK.SHARP,20172018,CHI,901.8499999999999,10,7,3,10,20,17,53,96,43,143,243,46,62,9,8,1004,832,803,779,29,40,0.5520833333333334,30258111.185000002
PATRICK.SIELOFF,20172018,OTT,11.183333333333334,1,0,0,0,1,1,0,0,0,3,4,1,1,0,0,16,14,16,14,1,3,0,15129015.35
PATRIK.BERGLUND,20172018,STL,920.8833333333333,17,7,2,9,26,24,173,314,141,112,183,111,34,6,12,898,761,703,637,24,30,0.5509554140127388,30258107.380000003
PATRIK.LAINE,20172018,WPG,1653.7833333333333,49,16,17,33,82,65,13,49,36,297,592,101,151,18,13,1917,1433,1306,1271,69,47,0.2653061224489796,30258182.375
PATRIK.NEMETH,20172018,COL,1492.4666666666667,3,5,8,13,16,8,0,3,3,81,158,84,48,9,20,1128,1835,1037,1231,50,38,0,30258157.84
PAUL.BYRON,20172018,MTL,1321.4166666666665,20,10,4,14,34,30,40,108,68,115,203,136,32,23,11,1269,1324,989,964,43,42,0.37037037037037035,30258141.33
PAUL.CAREY,20172018,NYR,615.5999999999999,7,5,2,7,14,12,19,41,22,51,93,66,21,5,10,443,673,424,624,16,30,0.4634146341463415,30258106.66
PAUL.LADUE,20172018,L.A,203.88333333333333,4,1,0,1,5,5,0,0,0,17,40,18,17,0,3,218,169,191,153,8,2,0,30258041.3
PAUL.MARTIN,20172018,S.J,302.3,0,2,0,2,2,2,0,0,0,10,27,16,10,2,2,342,305,339,298,10,10,0,30258053.67
PAUL.POSTMA,20172018,BOS,143.16666666666669,0,1,0,1,1,1,0,0,0,14,33,13,10,0,1,153,136,132,131,4,6,0,30258039.35
PAUL.STASTNY,20172018,STL,1177.2166666666667,12,13,15,28,40,25,677,1227,550,135,203,36,25,10,7,1356,1018,939,762,37,33,0.5517522412387939,30258130.355
PAUL.STASTNY,20172018,WPG,619.5333333333333,10,10,8,18,28,20,285,533,248,47,76,20,5,4,2,739,591,531,505,27,16,0.5347091932457786,30258096.740000002
PAVEL.BUCHNEVICH,20172018,NYR,1110.8833333333332,14,18,11,29,43,32,12,46,34,136,266,51,75,16,7,1250,979,849,903,34,31,0.2608695652173913,30258133.765
PAVEL.ZACHA,20172018,N.J,1068.3666666666668,8,11,5,16,24,19,339,784,445,117,201,76,34,8,16,993,1004,791,848,28,33,0.43239795918367346,30258144.565
PETER.CEHLARIK,20172018,BOS,83.6,1,0,1,1,2,1,2,4,2,3,6,3,2,0,1,82,86,70,82,4,2,0.5,30258036.055
PETER.HOLLAND,20172018,NYR,285.23333333333335,1,2,1,3,4,3,107,227,120,30,46,14,9,1,2,199,351,191,287,4,13,0.4713656387665198,30258067.165
PHIL.KESSEL,20172018,PIT,1744.9166666666665,35,45,21,66,101,80,7,21,14,279,502,11,143,9,15,2048,1480,1244,1261,60,64,0.3333333333333333,30258191.244999997
PHILIP.HOLM,20172018,VAN,15.2,0,0,0,0,0,0,0,0,0,0,1,1,0,0,0,17,18,17,18,0,2,0,15129015.35
PHILLIP.DANAULT,20172018,MTL,862.6333333333333,8,11,6,17,25,19,380,720,340,94,151,59,32,21,17,878,883,710,630,24,28,0.5277777777777778,30258110.36
PHILLIP.DI GIUSEPPE,20172018,CAR,514.6,5,6,2,8,13,11,0,1,1,64,123,88,28,4,7,557,452,545,449,20,21,0,30258071.19
PIERRE-EDOUARD.BELLEMARE,20172018,VGK,1110.3833333333332,6,8,4,12,18,14,430,850,420,118,213,74,42,9,10,937,1220,850,781,28,23,0.5058823529411764,30258124.240000002
PIERRE-LUC.DUBOIS,20172018,CBJ,1502.8833333333332,22,13,17,30,52,35,507,1165,658,180,302,147,58,28,22,1758,1221,1390,1113,55,43,0.4351931330472103,30258171.735
PONTUS.ABERG,20172018,EDM,234.23333333333332,2,2,4,6,8,4,0,2,2,31,56,8,15,4,1,203,206,177,189,9,7,0,30258047.54
PONTUS.ABERG,20172018,NSH,410.6333333333333,2,5,1,6,8,7,4,10,6,39,69,16,9,6,4,344,413,340,402,17,10,0.4,30258073.494999997
RADEK.FAKSA,20172018,DAL,1206.4666666666667,17,8,8,16,33,25,556,1077,521,119,189,101,39,14,12,1005,1199,883,885,42,25,0.5162488393686165,30258148.73
RADIM.VRBATA,20172018,FLA,542.0166666666667,5,5,4,9,14,10,7,21,14,88,144,15,28,4,8,531,552,404,524,18,25,0.3333333333333333,30258091.32
RADKO.GUDAS,20172018,PHI,1312.5166666666667,2,10,3,13,15,12,0,0,0,147,272,202,77,15,25,1156,1294,1078,1001,38,46,0,30258124.375
RASMUS.ANDERSSON,20172018,CGY,154.38333333333333,0,0,0,0,0,0,0,0,0,8,23,2,10,3,2,168,122,130,112,4,6,0,30258035.93
RASMUS.RISTOLAINEN,20172018,BUF,1934.4166666666665,6,16,16,32,38,22,1,1,0,182,353,206,100,18,17,1957,1929,1237,1348,42,57,1,30258172.07
REID.BOUCHER,20172018,VAN,227.51666666666665,3,0,2,2,5,3,1,3,2,35,54,13,9,7,0,237,206,210,200,5,16,0.3333333333333333,30258048.560000002
REILLY.SMITH,20172018,VGK,1588.2,26,34,21,55,81,60,4,13,9,206,374,78,90,10,17,1789,1377,1165,993,64,36,0.3076923076923077,30258146.435
REMI.ELIE,20172018,DAL,738.2833333333333,6,7,1,8,14,13,5,14,9,70,131,101,26,18,9,666,642,653,615,24,19,0.35714285714285715,30258092.655
RICHARD.PANIK,20172018,ARI,564.65,8,10,1,11,19,18,3,9,6,66,133,64,41,8,6,651,489,505,419,22,16,0.3333333333333333,30258070.875
RICHARD.PANIK,20172018,CHI,529.3666666666667,6,5,4,9,15,11,1,3,2,70,135,73,33,12,13,671,457,539,423,18,17,0.3333333333333333,30258068.759999998
RICK.NASH,20172018,BOS,379.55,6,2,3,5,11,8,0,2,2,80,129,17,16,11,5,471,316,295,260,7,14,0,30258058.284999996
RICK.NASH,20172018,NYR,1025.5333333333333,18,6,4,10,28,24,4,17,13,189,301,45,48,19,12,1047,1004,730,753,27,35,0.23529411764705882,30258120.450000003
RICKARD.RAKELL,20172018,ANA,1571.3166666666666,35,18,16,34,69,53,107,229,122,241,427,127,86,17,6,1724,1341,1185,1180,62,56,0.4672489082969432,30258176.299999997
RILEY.NASH,20172018,BOS,1292.6833333333334,14,14,14,28,42,28,528,1068,540,119,197,94,38,16,11,1103,1274,966,919,41,33,0.4943820224719101,30258152.73
RILEY.SHEAHAN,20172018,DET,72.48333333333333,0,0,0,0,0,0,8,19,11,5,14,6,3,2,2,69,63,54,58,1,1,0.42105263157894735,30258033.439999998
RILEY.SHEAHAN,20172018,PIT,1302.7833333333333,12,12,10,22,34,24,642,1175,533,115,184,69,31,13,3,988,1386,873,920,41,41,0.5463829787234042,30258152.86
RINAT.VALIEV,20172018,MTL,23.616666666666667,0,0,0,0,0,0,0,0,0,2,6,0,2,0,1,26,19,20,17,0,1,0,15129015
ROB.O'GARA,20172018,BOS,87.83333333333333,0,0,0,0,0,0,0,0,0,2,9,10,5,1,0,79,90,77,79,3,8,0,30258033.91
ROB.O'GARA,20172018,NYR,377.55,0,2,1,3,3,2,0,0,0,19,52,32,21,4,4,287,446,283,379,13,13,0,30258067.365000002
ROBERT.BORTUZZO,20172018,STL,1065.7833333333333,4,3,5,8,12,7,0,0,0,76,164,121,59,5,16,975,1029,941,864,36,28,0,30258106.375
ROBERT.HAGG,20172018,PHI,1292.6833333333334,3,4,2,6,9,7,0,0,0,88,183,242,54,7,16,1032,1420,969,1136,47,43,0,30258145.12
ROCCO.GRIMALDI,20172018,COL,57.85,1,1,1,2,3,2,0,1,1,7,9,3,1,2,0,47,80,46,79,4,5,0,30258037.545
ROLAND.MCKEOWN,20172018,CAR,134.1,0,0,3,3,3,0,0,0,0,7,26,3,14,2,4,148,128,146,127,7,5,0,30258036.795
ROMAN.JOSI,20172018,NSH,2164.5666666666666,14,27,14,41,55,41,0,0,0,300,586,94,194,13,13,2353,2211,1764,1539,77,56,0,30258171.78
ROMAN.POLAK,20172018,TOR,1074.25,2,6,5,11,13,8,0,0,0,55,145,155,53,8,24,916,1229,873,941,34,35,0,30258122.955
RON.HAINSEY,20172018,TOR,1899.2666666666669,4,8,8,16,20,12,0,0,0,77,198,99,77,3,12,1505,2285,1372,1536,70,61,0,30258180.23
ROSS.JOHNSTON,20172018,NYI,224.0333333333333,3,1,2,3,6,4,1,5,4,19,31,46,6,8,13,151,222,147,221,9,9,0.2,30258056.52
RYAN.CALLAHAN,20172018,T.B,1080.6666666666667,7,7,7,14,21,14,31,74,43,119,213,195,44,18,13,992,1080,829,781,27,33,0.4189189189189189,30258111.244999997
RYAN.CARPENTER,20172018,S.J,182.28333333333333,0,0,1,1,1,0,82,161,79,20,34,24,7,1,1,145,201,139,146,4,3,0.5093167701863354,30258044.665
RYAN.CARPENTER,20172018,VGK,697.3166666666667,9,5,5,10,19,14,181,362,181,89,148,81,25,9,6,674,667,573,536,23,22,0.5,30258093.655
RYAN.DONATO,20172018,BOS,211.85,5,3,1,4,9,8,12,17,5,31,52,8,13,2,1,243,169,165,155,8,9,0.7058823529411765,30258045.925
RYAN.DZINGEL,20172018,OTT,1303.1166666666668,23,12,6,18,41,35,24,56,32,136,238,60,54,19,16,1344,1213,1056,1137,47,59,0.42857142857142855,30258163.5
RYAN.ELLIS,20172018,NSH,1351.1999999999998,9,11,14,25,34,20,0,0,0,140,274,39,78,11,8,1487,1334,1179,986,56,36,0,30258117.560000002
RYAN.GETZLAF,20172018,ANA,1285.5166666666667,11,35,17,52,63,46,437,909,472,124,264,105,69,6,25,1407,1119,945,860,48,41,0.4807480748074808,30258148.665
RYAN.HARTMAN,20172018,CHI,729.8166666666666,8,11,6,17,25,19,90,195,105,96,187,94,53,23,19,844,651,742,624,31,25,0.46153846153846156,30258095.229999997
RYAN.HARTMAN,20172018,NSH,396.5666666666667,5,3,1,4,9,8,6,15,9,45,78,31,14,11,12,368,384,344,324,10,15,0.4,30258064.575
RYAN.JOHANSEN,20172018,NSH,1712.85,20,21,25,46,66,41,953,1700,747,151,247,105,47,19,30,2006,1485,1350,1216,61,45,0.5605882352941176,30258193.185000002
RYAN.KESLER,20172018,ANA,867.1166666666667,8,2,6,8,16,10,438,828,390,84,149,78,25,13,20,799,978,625,638,19,24,0.5289855072463768,30258114.45
RYAN.LOMBERG,20172018,CGY,43.75,0,1,0,1,1,1,0,2,2,5,6,11,1,8,3,26,39,26,39,3,3,0,30258032.380000003
RYAN.MCDONAGH,20172018,NYR,1171.75,2,13,11,24,26,15,0,0,0,77,165,53,60,7,10,1024,1218,742,890,41,35,0,30258123.045
RYAN.MCDONAGH,20172018,T.B,679.7333333333333,2,2,3,5,7,4,0,0,0,44,81,44,22,3,3,555,714,501,484,24,20,0,30258073.055
RYAN.MURPHY,20172018,MIN,415.85,2,1,2,3,5,3,0,0,0,27,52,5,13,1,7,353,369,302,339,15,8,0,30258063.06
RYAN.MURRAY,20172018,CBJ,939.9833333333333,1,6,5,11,12,7,0,0,0,36,100,35,38,3,5,770,932,700,719,26,26,0,30258097.205
RYAN.NUGENT-HOPKINS,20172018,EDM,1121.25,24,15,8,23,47,39,373,766,393,151,254,44,59,15,10,1162,1089,830,832,40,34,0.4869451697127937,30258146.22
RYAN.O'REILLY,20172018,BUF,1684.9166666666665,24,26,11,37,61,50,1271,2120,849,230,358,42,44,17,1,1834,1498,1071,1069,37,46,0.5995283018867924,30258195.135
RYAN.PULOCK,20172018,NYI,1251.6,10,10,11,21,31,20,0,0,0,184,358,113,109,5,7,1330,1186,1060,1098,51,48,0,30258138.325000003
RYAN.REAVES,20172018,PIT,391.7,4,2,2,4,8,6,7,15,8,34,62,161,12,12,20,331,355,326,353,14,22,0.4666666666666667,30258068.950000003
RYAN.REAVES,20172018,VGK,280.81666666666666,1,0,2,2,3,1,7,19,12,11,22,109,4,5,10,246,258,233,256,9,5,0.3684210526315789,30258055.28
RYAN.SPOONER,20172018,BOS,565.1166666666667,9,8,8,16,25,17,68,134,66,70,100,38,17,5,1,655,428,432,372,24,12,0.5074626865671642,30258072.67
RYAN.SPOONER,20172018,NYR,337.1,4,6,5,11,15,10,23,76,53,37,61,28,11,3,1,306,364,237,338,13,16,0.3026315789473684,30258073.175
RYAN.SPROUL,20172018,NYR,261.9333333333333,1,3,1,4,5,4,0,0,0,15,46,6,18,1,3,251,262,240,245,10,14,0,30258051.185000002
RYAN.STROME,20172018,EDM,1248.05,13,14,6,20,33,27,297,671,374,146,249,43,55,6,14,1303,1118,952,916,32,36,0.4426229508196721,30258146.19
RYAN.SUTER,20172018,MIN,2088.633333333333,6,24,18,42,48,30,0,0,0,149,323,78,109,6,16,2016,2040,1424,1464,54,59,0,30258179.61
SAM.BENNETT,20172018,CGY,1180.2333333333336,11,9,5,14,25,20,119,219,100,157,293,140,63,20,27,1274,1118,1047,950,29,42,0.54337899543379,30258132.285
SAM.GAGNER,20172018,VAN,1118.2166666666667,10,11,10,21,31,21,220,461,241,164,270,54,58,11,14,1114,1037,841,956,25,42,0.4772234273318872,30258149.96
SAM.REINHART,20172018,BUF,1402.3166666666666,24,14,11,25,49,38,56,142,86,187,298,47,40,21,13,1605,1061,1002,945,34,45,0.39436619718309857,30258148.125
SAMI.NIKU,20172018,WPG,15.216666666666667,1,0,0,0,1,1,0,0,0,2,3,0,1,0,0,14,18,12,17,3,3,0,15129015.65
SAMI.VATANEN,20172018,ANA,316.58333333333337,1,0,3,3,4,1,0,0,0,22,45,24,13,4,4,290,362,187,260,9,12,0,30258056.015
SAMI.VATANEN,20172018,N.J,1370.6833333333334,4,13,9,22,26,17,0,0,0,132,265,75,85,11,16,1297,1295,929,994,48,48,0,30258129.435
SAMMY.BLAIS,20172018,STL,118.5,1,0,2,2,3,1,0,0,0,9,20,15,3,1,3,104,102,71,97,4,2,0,30258038.71
SAMUEL.GIRARD,20172018,COL,1269.7166666666667,3,8,9,17,20,11,0,0,0,82,171,45,52,15,3,1238,1112,950,1032,43,43,0,30258131.925
SAMUEL.GIRARD,20172018,NSH,84.55,1,1,1,2,3,2,0,0,0,8,13,3,4,2,1,77,76,62,65,2,4,0,30258034.645000003
SAMUEL.MORIN,20172018,PHI,31.616666666666667,0,0,0,0,0,0,0,0,0,1,3,7,1,0,2,32,30,30,23,2,1,0,30258028.85
SCOTT.HARRINGTON,20172018,CBJ,425.6166666666667,2,1,1,2,4,3,0,0,0,28,53,35,12,0,4,336,462,323,416,15,15,0,30258073.225
SCOTT.HARTNELL,20172018,NSH,783.25,13,8,2,10,23,21,4,17,13,86,138,91,27,11,22,787,681,671,652,26,27,0.23529411764705882,30258105.270000003
SCOTT.LAUGHTON,20172018,PHI,964.85,11,6,2,8,19,17,323,619,296,112,183,143,31,21,16,815,885,776,715,25,35,0.5218093699515347,30258117.98
SCOTT.MAYFIELD,20172018,NYI,838.7,2,4,6,10,12,6,0,0,0,58,141,77,57,12,21,722,927,691,763,30,34,0,30258104.07
SCOTT.WILSON,20172018,BUF,684.1166666666667,6,7,1,8,14,13,5,10,5,85,136,93,24,5,4,573,728,525,608,20,35,0.5,30258098.575
SCOTT.WILSON,20172018,DET,126.8,0,0,0,0,0,0,3,4,1,10,18,22,4,1,0,102,120,98,119,4,5,0.75,30258039.28
SCOTT.WILSON,20172018,PIT,31.35,0,0,0,0,0,0,2,5,3,3,4,13,0,0,0,31,33,29,26,0,2,0.4,30258029.73
SCOTTIE.UPSHALL,20172018,STL,683.7833333333333,7,7,5,12,19,14,8,15,7,70,119,119,27,16,21,551,725,526,580,22,22,0.5333333333333333,30258096.555
SEAN.COUTURIER,20172018,PHI,1880.5,36,34,14,48,84,70,574,1090,516,241,398,83,68,25,15,2072,1607,1282,1119,82,53,0.5266055045871559,30258187.810000002
SEAN.KURALY,20172018,BOS,1061.8500000000001,8,6,4,10,18,14,373,814,441,154,241,155,39,18,17,883,1040,834,849,26,30,0.4582309582309582,30258140.85
SEAN.MONAHAN,20172018,CGY,1382.4666666666667,30,21,10,31,61,51,709,1407,698,200,350,35,66,10,11,1831,1147,1155,955,59,45,0.503909026297086,30258166.61
SEBASTIAN.AHO,20172018,CAR,1397.6166666666668,29,24,12,36,65,53,78,172,94,200,390,65,100,20,14,1672,1063,1157,953,55,46,0.45348837209302323,30258139.47
SETH.GRIFFITH,20172018,BUF,221.88333333333333,2,1,0,1,3,3,0,3,3,15,21,10,2,2,2,178,168,157,161,2,7,0,30258045.87
SETH.JONES,20172018,CBJ,2102.6,17,25,18,43,60,42,0,0,0,262,521,105,138,21,16,2256,1871,1687,1447,65,51,0,30258171.96
SHANE.GERSICH,20172018,WSH,38.55,0,1,0,1,1,1,0,1,1,6,9,2,2,0,0,36,45,36,45,1,3,0,30258032.4
SHANE.PRINCE,20172018,NYI,168.03333333333336,1,1,0,1,2,2,5,11,6,20,37,10,11,4,3,138,181,121,178,2,5,0.45454545454545453,30258048.689999998
SHAWN.MATTHIAS,20172018,WPG,301.66666666666663,1,2,0,2,3,3,12,28,16,26,39,22,9,1,5,226,357,215,276,9,10,0.42857142857142855,30258059.490000002
SHAYNE.GOSTISBEHERE,20172018,PHI,1796.9333333333334,14,23,27,50,64,37,0,0,0,237,494,63,153,20,13,2051,1427,1288,1230,60,51,0,30258153.625
SHEA.THEODORE,20172018,VGK,1654.9666666666667,9,17,11,28,37,26,0,0,0,181,359,36,114,12,11,1935,1398,1352,1251,53,51,0,30258149.295
SHEA.WEBER,20172018,MTL,658.9666666666667,6,5,5,10,16,11,0,0,0,75,163,66,49,5,7,744,657,521,438,17,23,0,30258068.924999997
SIDNEY.CROSBY,20172018,PIT,1940.1,38,39,32,71,109,77,1176,2217,1041,276,463,87,81,23,19,2410,1582,1591,1305,68,64,0.53044654939106906,30258228.47
SLATER.KOEKKOEK,20172018,T.B,393.23333333333335,4,2,2,4,8,6,0,0,0,43,74,36,21,1,9,355,401,343,367,19,16,0,30258066.46
SONNY.MILANO,20172018,CBJ,660.6333333333333,14,4,4,8,22,18,0,0,0,69,122,29,21,9,5,645,534,510,493,22,27,0,30258085.59
SPENCER.FOO,20172018,CGY,63.416666666666664,2,0,0,0,2,2,1,1,0,16,22,6,2,2,0,76,48,58,46,2,1,1,30258032.61
STEFAN.MATTEAU,20172018,VGK,65.61666666666667,0,1,0,1,1,1,1,2,1,8,19,8,6,2,0,72,53,70,53,1,1,0.5,30258031.409999996
STEFAN.NOESEN,20172018,N.J,1013.9166666666667,14,9,4,13,27,23,20,56,36,136,204,119,27,11,15,923,899,873,811,38,29,0.35714285714285715,30258121.060000002
STEPHEN.JOHNS,20172018,DAL,1315.8833333333332,8,1,5,6,14,9,0,0,0,121,249,201,85,5,15,1123,1297,973,963,38,32,0,30258119.225
STEVE.BERNIER,20172018,NYI,40.21666666666667,0,0,0,0,0,0,2,4,2,4,6,11,1,1,0,30,44,23,41,0,2,0.5,30258032.14
STEVEN.FOGARTY,20172018,NYR,12.266666666666666,0,0,0,0,0,0,0,0,0,1,2,2,0,0,1,10,7,10,7,0,0,0,15129014.25
STEVEN.KAMPFER,20172018,NYR,378.9,0,1,0,1,1,1,0,0,0,31,52,45,9,5,7,303,463,289,384,7,13,0,30258070.950000003
STEVEN.SANTINI,20172018,N.J,729.8666666666667,2,5,2,7,9,7,0,1,1,56,86,113,17,4,9,451,861,405,628,19,20,0,30258104.09
STEVEN.STAMKOS,20172018,T.B,1763.9499999999998,34,37,28,65,99,71,552,1059,507,249,485,89,131,19,27,2120,1441,1354,1219,72,50,0.5212464589235127,30258194.47
SVEN.ANDRIGHETTO,20172018,COL,800.2,9,6,8,14,23,15,7,22,15,123,220,46,57,15,9,812,685,610,614,20,32,0.3181818181818182,30258095.58
SVEN.BAERTSCHI,20172018,VAN,827.1,14,10,5,15,29,24,1,7,6,83,144,19,36,12,9,809,742,581,681,30,26,0.14285714285714285,30258111.785
T.J..OSHIE,20172018,WSH,1829.3833333333334,27,21,18,39,66,48,132,275,143,180,330,181,63,29,24,2035,1516,1264,1260,48,37,0.48,30258186.67
TAGE.THOMPSON,20172018,STL,488.90000000000003,3,3,3,6,9,6,1,10,9,55,113,39,24,8,6,479,447,423,427,9,20,0.1,30258073.095
TANNER.FRITZ,20172018,NYI,425.73333333333335,3,4,0,4,7,7,47,108,61,27,48,59,11,4,3,380,445,345,404,11,13,0.4351851851851852,30258075.770000003
TANNER.GLASS,20172018,CGY,150.08333333333331,0,0,0,0,0,0,2,6,4,14,25,35,2,5,5,136,149,132,127,0,4,0.3333333333333333,30258040.83
TANNER.KERO,20172018,CHI,91.5,1,1,1,2,3,2,35,76,41,7,10,3,1,1,0,71,125,66,81,4,2,0.4605263157894737,30258038.485
TANNER.PEARSON,20172018,L.A,1386.1166666666666,15,12,12,24,39,27,38,76,38,188,338,128,61,29,12,1507,1327,1136,1057,53,42,0.5,30258142.66
TAYLOR.CHORNEY,20172018,CBJ,16.683333333333334,0,0,0,0,0,0,0,0,0,0,1,3,1,0,0,17,18,15,13,1,0,0,15129014.4
TAYLOR.CHORNEY,20172018,WSH,311.76666666666665,1,1,1,2,3,2,0,0,0,14,33,18,11,1,4,215,349,206,263,15,7,0,30258054.884999998
TAYLOR.FEDUN,20172018,BUF,102.78333333333333,0,0,1,1,1,0,0,0,0,8,20,4,11,0,1,95,85,86,76,1,2,0,30258032.925
TAYLOR.HALL,20172018,N.J,1556.0666666666666,40,33,23,56,96,73,72,148,76,297,488,77,96,25,23,1772,1309,1187,1139,69,51,0.4864864864864865,30258183.255
TAYLOR.LEIER,20172018,PHI,409.0333333333333,1,0,4,4,5,1,3,5,2,48,66,10,11,3,3,327,377,300,276,9,15,0.6,30258054.35
TEUVO.TERAVAINEN,20172018,CAR,1384.7,23,23,16,39,62,46,15,49,34,185,352,26,86,7,6,1669,955,1126,865,55,43,0.30612244897959184,30258121.02
THOMAS.CHABOT,20172018,OTT,1103.1833333333334,9,9,6,15,24,18,0,0,0,94,181,44,66,4,7,1126,1027,897,958,38,51,0,30258127.740000002
THOMAS.HICKEY,20172018,NYI,1246.8000000000002,5,10,9,19,24,15,0,0,0,87,210,76,80,11,12,1102,1448,1014,1110,53,36,0,30258138.785
THOMAS.VANEK,20172018,CBJ,365.58333333333337,8,6,3,9,17,14,4,9,5,60,100,9,21,2,4,412,311,318,283,19,11,0.4444444444444444,30258060.505000003
THOMAS.VANEK,20172018,VAN,852.0833333333333,17,17,7,24,41,34,4,19,15,121,186,29,30,5,15,806,775,592,717,30,29,0.21052631578947367,30258126.785
TIM.HEED,20172018,S.J,464.56666666666666,3,4,4,8,11,7,0,0,0,51,127,8,55,1,4,553,367,379,315,15,11,0,30258052.560000002
TIM.SCHALLER,20172018,BOS,1209.5333333333333,12,8,4,12,24,20,77,170,93,141,226,150,40,15,15,953,1252,903,909,27,32,0.45294117647058824,30258134.58
TIMO.MEIER,20172018,S.J,1355.6666666666665,24,8,9,17,41,32,81,169,88,239,411,144,79,36,23,1542,1263,1257,1147,48,45,0.47928994082840237,30258158.375
TJ.BRODIE,20172018,CGY,1728.65,4,8,20,28,32,12,0,0,0,118,260,24,87,8,9,1774,1647,1321,1284,49,56,0,30258149.18
TOBIAS.ENSTROM,20172018,WPG,913.95,1,2,3,5,6,3,0,0,0,39,89,23,26,3,11,798,826,776,749,31,25,0,30258097.655
TOBIAS.RIEDER,20172018,ARI,885.3,8,8,3,11,19,16,22,45,23,80,156,76,38,8,3,769,962,658,791,24,31,0.4888888888888889,30258119.134999998
TOBIAS.RIEDER,20172018,L.A,319.48333333333335,4,2,0,2,6,6,0,1,1,41,68,27,9,2,0,286,335,277,309,9,12,0,30258062.82
TOM.KUHNHACKL,20172018,PIT,819.5166666666667,2,4,2,6,8,6,2,12,10,72,108,175,21,9,5,524,907,483,593,14,25,0.16666666666666666,30258095.22
TOM.PYATT,20172018,OTT,1138.3666666666668,7,8,7,15,22,15,17,51,34,103,157,55,33,10,5,871,1424,810,1078,29,45,0.3333333333333333,30258156.255
TOM.WILSON,20172018,WSH,1602.1333333333332,18,15,15,30,48,33,30,69,39,155,293,341,71,58,71,1459,1662,1371,1335,75,58,0.43478260869565216,30258179.405
TOMAS.HERTL,20172018,S.J,1630.8666666666668,27,16,11,27,54,43,692,1338,646,208,386,101,77,30,18,1922,1579,1220,1166,44,50,0.5171898355754858,30258190.055
TOMAS.HYKA,20172018,VGK,120.53333333333333,1,2,0,2,3,3,0,0,0,15,20,6,3,2,0,130,97,84,91,4,2,0,30258037.97
TOMAS.JURCO,20172018,CHI,365.9,6,2,2,4,10,8,4,16,12,45,85,22,21,5,6,377,357,359,333,11,10,0.25,30258063.41
TOMAS.NOSEK,20172018,VGK,927.35,9,7,3,10,19,16,44,80,36,109,189,68,39,13,11,804,1033,718,738,25,23,0.55,30258111.165
TOMAS.PLEKANEC,20172018,MTL,977.7333333333333,6,13,5,18,24,19,564,1072,508,125,197,38,42,6,18,942,1113,850,791,29,31,0.5261194029850746,30258132.994999997
TOMAS.PLEKANEC,20172018,TOR,287.28333333333336,2,2,2,4,6,4,145,277,132,25,45,29,10,3,4,213,324,199,252,10,12,0.5234657039711191,30258061.53
TOMAS.TATAR,20172018,DET,1037.8666666666668,16,5,7,12,28,21,1,9,8,140,245,45,46,17,9,1056,837,786,791,35,37,0.1111111111111111,30258117.585
TOMAS.TATAR,20172018,VGK,394.83333333333337,5,1,2,3,8,6,2,7,5,41,91,42,28,7,6,444,330,321,312,10,18,0.2857142857142857,30258059.5
TOMMY.WINGELS,20172018,BOS,258.23333333333335,2,2,1,3,5,4,26,53,27,23,47,43,10,2,1,207,270,198,212,10,11,0.49056603773584906,30258050.884999998
TOMMY.WINGELS,20172018,CHI,646.9,7,3,1,4,11,10,185,403,218,67,113,150,18,20,19,575,665,495,528,12,25,0.45905707196029777,30258099.025
TONY.DEANGELO,20172018,NYR,530.5333333333333,0,6,2,8,8,6,1,1,0,68,107,31,25,4,4,565,490,452,463,15,32,1,30258075.33
TOREY.KRUG,20172018,BOS,1773.45,17,29,21,50,67,46,0,0,0,230,478,95,165,15,23,2149,1383,1432,1187,58,57,0,30258144.525
TORREY.MITCHELL,20172018,L.A,617.1833333333334,6,5,0,5,11,11,174,363,189,49,78,55,17,6,14,458,642,431,467,14,21,0.4793388429752066,30258090.12
TORREY.MITCHELL,20172018,MTL,102.21666666666667,0,0,0,0,0,0,26,41,15,8,13,6,2,2,1,88,92,84,70,2,2,0.6341463414634146,30258033.759999998
TRAVIS.BOYD,20172018,WSH,82.8,0,1,0,1,1,1,23,45,22,3,7,3,1,0,1,70,95,70,95,3,1,0.5111111111111111,30258038.87
TRAVIS.DERMOTT,20172018,TOR,686.5666666666666,2,4,6,10,12,6,0,0,0,64,131,59,50,8,5,717,588,684,558,30,17,0,30258072.58
TRAVIS.HAMONIC,20172018,CGY,1531.6666666666665,1,6,4,10,11,7,0,1,1,107,261,83,94,11,21,1373,1636,1276,1206,41,48,0,30258136.81
TRAVIS.KONECNY,20172018,PHI,1290.5500000000002,25,13,11,24,49,38,8,25,17,184,307,109,60,31,26,1285,1174,1025,1076,54,44,0.32,30258159.705
TRAVIS.SANHEIM,20172018,PHI,826.2166666666667,3,5,3,8,11,8,0,0,0,77,160,30,53,2,10,779,699,728,635,25,29,0,30258084.595
TRAVIS.ZAJAC,20172018,N.J,1231.2833333333333,13,8,6,14,27,21,620,1211,591,98,165,68,30,6,11,1094,1230,749,820,27,37,0.5119735755573905,30258147.91
TREVOR.CARRICK,20172018,CAR,7.533333333333333,0,0,0,0,0,0,0,0,0,1,1,0,0,0,1,6,6,6,6,0,0,0,15129014.3
TREVOR.DALEY,20172018,DET,1593.4333333333334,9,3,3,6,15,12,0,0,0,103,197,24,51,6,18,1309,1791,1112,1298,54,63,0,30258166.435000002
TREVOR.LEWIS,20172018,L.A,1104.6666666666665,14,10,2,12,26,24,49,118,69,140,244,144,51,7,13,939,1127,807,835,23,30,0.4152542372881356,30258128.229999997
TREVOR.MURPHY,20172018,ARI,113.88333333333333,1,0,2,2,3,1,0,0,0,5,14,6,5,1,0,95,126,88,122,6,1,0,30258040.36
TREVOR.VAN RIEMSDYK,20172018,CAR,1346.8666666666668,3,5,7,12,15,8,0,0,0,111,195,25,40,5,10,1346,1222,1281,1030,55,46,0,30258115.675
TROY.BROUWER,20172018,CGY,1058.7833333333333,6,11,5,16,22,17,101,217,116,79,170,125,39,15,13,1031,1120,789,769,21,27,0.46543778801843316,30258115.365000002
TROY.STECHER,20172018,VAN,1279.15,1,6,4,10,11,7,0,1,1,94,213,111,76,15,16,1116,1302,1021,1098,44,50,0,30258134.25
TROY.TERRY,20172018,ANA,20.416666666666668,0,0,0,0,0,0,0,0,0,3,3,0,0,0,0,11,16,11,16,0,0,0,15129015.5
TUCKER.POOLMAN,20172018,WPG,322.1166666666667,1,1,0,1,2,2,0,0,0,31,69,21,18,1,0,328,278,326,277,10,7,0,30258050.86
TY.RATTIE,20172018,EDM,216.59999999999997,5,3,1,4,9,8,0,0,0,32,50,11,8,3,1,212,220,176,211,14,14,0,30258053.555
TYLER.BERTUZZI,20172018,DET,691.2,7,9,8,17,24,16,1,8,7,83,153,53,23,21,9,649,643,532,605,26,30,0.125,30258100.299999997
TYLER.BOZAK,20172018,TOR,1368.0500000000002,13,22,12,34,47,35,684,1267,583,169,272,54,55,11,17,1684,1162,1160,1051,47,37,0.5398579321231255,30258166.87
TYLER.ENNIS,20172018,MIN,881.2833333333333,8,7,7,14,22,15,3,12,9,116,203,51,41,13,6,795,829,711,804,28,29,0.25,30258118.924999997
TYLER.GRAOVAC,20172018,WSH,33.7,0,0,0,0,0,0,1,3,2,1,2,5,0,0,1,13,44,13,41,0,3,0.3333333333333333,30258032.79
TYLER.JOHNSON,20172018,T.B,1656.1166666666668,24,18,15,33,57,42,455,893,438,228,380,68,57,18,14,1637,1612,1188,1226,56,48,0.509518477043673,30258193.405
TYLER.MOTTE,20172018,CBJ,308,3,2,0,2,5,5,5,14,9,42,74,46,16,8,1,266,330,261,290,9,13,0.35714285714285715,30258059.630000003
TYLER.MOTTE,20172018,VAN,208.31666666666666,2,0,0,0,2,2,1,8,7,22,39,47,10,2,2,148,228,135,183,4,5,0.125,30258048.759999998
TYLER.MYERS,20172018,WPG,2068.5666666666666,10,18,15,33,43,28,0,0,0,175,365,85,116,18,28,1992,2083,1552,1461,67,62,0,30258172.255000003
TYLER.PITLICK,20172018,DAL,1094.4,14,5,8,13,27,19,13,47,34,129,244,122,63,13,13,895,1157,838,860,37,27,0.2765957446808511,30258122.35
TYLER.SEGUIN,20172018,DAL,1714.4666666666667,40,26,12,38,78,66,790,1440,650,335,568,74,124,23,20,1951,1641,1239,1216,62,49,0.5486111111111112,30258207.33
TYLER.TOFFOLI,20172018,L.A,1393.5,22,9,14,23,45,31,9,25,16,266,463,90,108,23,8,1603,1304,1150,1110,46,38,0.36,30258149.740000002
TYRELL.GOULBOURNE,20172018,PHI,50.25,0,0,0,0,0,0,0,0,0,2,5,15,1,0,1,41,48,41,48,1,3,0,30258032.1
TYSON.BARRIE,20172018,COL,1685.4833333333333,14,24,24,48,62,38,0,0,0,190,425,46,162,10,11,1771,1539,1256,1359,59,55,0,30258170.95
TYSON.JOST,20172018,COL,1037.95,12,7,3,10,22,19,87,238,151,122,208,38,53,21,12,994,917,678,816,20,24,0.36554621848739494,30258131.815
VADIM.SHIPACHYOV,20172018,VGK,31.766666666666666,1,0,0,0,1,1,12,21,9,3,8,1,0,1,1,33,31,27,31,3,0,0.5714285714285714,15129017.69
VALENTIN.ZYKOV,20172018,CAR,137.06666666666666,3,3,1,4,7,6,0,1,1,18,28,3,4,1,1,142,93,129,90,8,4,0,30258037.185
VALTTERI.FILPPULA,20172018,PHI,1431.2166666666667,12,14,10,24,36,26,530,1030,500,77,135,27,25,13,11,1174,1464,890,1099,32,47,0.5145631067961165,30258180.979999997
VICTOR.ANTIPIN,20172018,BUF,718.05,0,4,6,10,10,4,0,0,0,40,79,14,26,2,9,624,603,529,569,19,25,0,30258085.17
VICTOR.EJDSELL,20172018,CHI,79.9,0,0,1,1,1,0,20,60,40,7,16,6,8,0,0,64,78,58,75,3,4,0.3333333333333333,30258035.924999997
VICTOR.HEDMAN,20172018,T.B,2432.95,18,29,27,56,74,47,1,2,1,251,559,159,188,20,33,2544,2275,1772,1646,84,61,0.5,30258192.814999998
VICTOR.METE,20172018,MTL,763.7333333333333,0,5,2,7,7,5,0,0,0,43,97,1,35,4,2,791,704,628,648,32,26,0,30258088.14
VICTOR.RASK,20172018,CAR,1092.05,14,8,9,17,31,22,393,716,323,126,231,62,48,6,6,1268,936,926,879,35,35,0.5488826815642458,30258134.455
VIKTOR.ARVIDSSON,20172018,NSH,1619.5666666666668,34,15,20,35,69,49,11,38,27,292,503,37,98,24,21,1845,1539,1300,1229,62,45,0.2894736842105263,30258175.130000003
VINCE.DUNN,20172018,STL,1292.3166666666666,5,6,12,18,23,11,1,1,0,138,284,29,108,7,10,1452,1048,1146,981,44,44,1,30258110.21
VINCENT.TROCHECK,20172018,FLA,1751.3333333333335,31,22,22,44,75,53,853,1577,724,287,493,145,83,33,27,1976,1753,1197,1288,49,60,0.5409004438807863,30258222.4
VINNI.LETTIERI,20172018,NYR,229.06666666666666,1,2,2,4,5,3,5,12,7,28,57,22,9,3,0,214,227,160,218,4,12,0.4166666666666667,30258053.43
VINNIE.HINOSTROZA,20172018,CHI,690.9833333333333,7,12,6,18,25,19,39,89,50,86,183,26,63,11,5,839,616,689,594,25,23,0.43820224719101125,30258087.67
VLADIMIR.SOBOTKA,20172018,STL,1387.0666666666666,11,14,5,19,30,25,191,352,161,136,229,127,58,18,23,1287,1295,1035,1041,29,37,0.5426136363636364,30258150.695
VLADIMIR.TARASENKO,20172018,STL,1524.5333333333333,33,16,17,33,66,49,1,4,3,306,609,89,173,19,7,1864,1243,1258,1087,60,34,0.25,30258142.055
VLADISLAV.KAMENEV,20172018,COL,26.466666666666665,0,0,0,0,0,0,7,18,11,1,1,3,0,0,0,12,21,12,21,0,2,0.3888888888888889,15129016.58
VLADISLAV.NAMESTNIKOV,20172018,NYR,298.65,2,0,2,2,4,2,58,142,84,28,51,19,12,5,4,306,296,231,267,6,9,0.4084507042253521,30258060.02
VLADISLAV.NAMESTNIKOV,20172018,T.B,1085.45,20,11,13,24,44,31,227,480,253,127,195,60,31,14,16,1305,869,894,799,44,31,0.47291666666666665,30258131.195
WADE.MEGAN,20172018,STL,8.35,0,0,0,0,0,0,1,2,1,1,1,0,0,0,0,1,12,1,9,0,0,0.5,15129014.89
WARREN.FOEGELE,20172018,CAR,23.849999999999998,2,1,0,1,3,3,0,0,0,6,8,5,1,0,0,20,21,19,12,3,0,0,30258029.5
WAYNE.SIMMONDS,20172018,PHI,1444.1666666666665,24,14,9,23,47,38,12,22,10,190,316,149,57,16,21,1593,1292,942,1042,32,42,0.5454545454545454,30258161.215
WILL.BUTCHER,20172018,N.J,1391.9166666666665,6,19,20,39,45,25,0,0,0,95,252,24,89,4,3,1582,1085,1107,988,51,42,0,30258120.240000002
WILL.O'NEILL,20172018,PHI,9.416666666666668,0,0,0,0,0,0,0,0,0,3,3,0,0,0,0,5,11,5,11,0,0,0,15129015.05
WILLIAM.CARRIER,20172018,VGK,406.26666666666665,1,1,1,2,3,2,0,0,0,63,115,168,20,20,12,413,384,402,370,9,13,0,30258064.525
WILLIAM.KARLSSON,20172018,VGK,1948.15,48,17,26,43,91,65,554,1150,596,232,407,78,78,21,7,2221,1714,1444,1256,82,35,0.4817391304347826,30258201.22
WILLIAM.NYLANDER,20172018,TOR,1478.5166666666667,21,29,15,44,65,50,363,698,335,195,408,27,123,22,7,1684,1353,1255,1249,76,50,0.5200573065902578,30258177.665
XAVIER.OUELLET,20172018,DET,623.5999999999999,0,2,3,5,5,2,0,0,0,56,100,36,21,2,3,552,624,523,508,21,24,0,30258075.345
YANNI.GOURDE,20172018,T.B,1576.4166666666665,27,26,17,43,70,53,168,387,219,163,290,79,59,27,25,1611,1377,1247,1128,70,37,0.43410852713178294,30258170.415
YANNICK.WEBER,20172018,NSH,606.7666666666667,3,3,0,3,6,6,0,0,0,43,89,51,27,3,9,485,576,477,560,16,13,0,30258087.98
YOHANN.AUVITU,20172018,EDM,447.33333333333337,3,2,4,6,9,5,0,0,0,69,128,18,45,3,4,474,428,445,406,26,19,0,30258062.58
ZAC.DALPE,20172018,CBJ,89.3,0,0,0,0,0,0,7,24,17,18,25,6,4,1,6,81,69,75,67,1,3,0.2916666666666667,30258035.14
ZAC.RINALDO,20172018,ARI,598.05,5,1,1,2,7,6,4,15,11,56,98,187,24,11,12,449,656,433,575,18,24,0.26666666666666666,30258094.645
ZACH.ASTON-REESE,20172018,PIT,251.61666666666667,5,1,1,2,7,6,2,10,8,28,43,69,10,5,2,190,232,181,201,7,5,0.2,30258051.805
ZACH.BOGOSIAN,20172018,BUF,344.81666666666666,0,1,0,1,1,1,0,0,0,29,48,22,13,3,7,294,319,264,278,5,12,0,30258055.880000003
ZACH.HYMAN,20172018,TOR,1543.3999999999999,16,17,9,26,42,33,85,203,118,159,252,132,38,24,18,1378,1785,1247,1277,69,49,0.4187192118226601,30258177.314999998
ZACH.PARISE,20172018,MIN,768.2666666666667,18,5,3,8,26,23,5,12,7,124,186,27,32,17,8,749,724,521,614,25,24,0.4166666666666667,30258107.945
ZACH.REDMOND,20172018,BUF,43.43333333333334,0,0,0,0,0,0,0,0,0,7,10,4,3,0,1,35,37,34,37,3,2,0,30258030.45
ZACH.TROTMAN,20172018,PIT,38.349999999999994,0,0,0,0,0,0,0,0,0,6,10,1,3,0,0,37,30,33,29,0,3,0,30258029.55
ZACH.WERENSKI,20172018,CBJ,1883.4666666666667,17,14,8,22,39,31,0,0,0,225,421,66,111,16,10,2064,1632,1658,1403,70,53,0,30258160.509999998
ZACH.WHITECLOUD,20172018,VGK,16.7,0,0,0,0,0,0,0,0,0,0,1,0,1,0,0,15,14,15,14,3,0,0,15129014.25
ZACHARY.ASTON-REESE,20172018,PIT,17.183333333333334,0,0,0,0,0,0,1,1,0,2,3,4,1,0,0,14,14,12,13,0,2,1,30258028.29
ZACK.KASSIAN,20172018,EDM,863.5333333333333,7,7,5,12,19,14,5,24,19,85,142,129,28,12,24,721,876,670,713,22,32,0.20833333333333334,30258110.945
ZACK.MITCHELL,20172018,MIN,242.4,3,2,0,2,5,5,15,31,16,17,21,26,3,2,2,139,282,131,254,7,8,0.4838709677419355,30258062.07
ZACK.SMITH,20172018,OTT,1136.9499999999998,5,5,9,14,19,10,297,620,323,124,227,90,47,26,21,1070,1217,843,998,24,52,0.4790322580645161,30258153.615000002
ZDENO.CHARA,20172018,BOS,1955.05,8,6,11,17,25,14,0,0,0,170,368,177,127,13,28,1690,2015,1541,1387,70,56,0,30258151.005
ZEMGUS.GIRGENSONS,20172018,BUF,973.4000000000001,7,4,4,8,15,11,23,63,40,113,168,134,26,17,11,739,968,673,716,21,32,0.36507936507936506,30258110.34
